ID,Флаг дозвона,Флаг продажи,Расходы,PV,NPV
0,1,0,79,0,-79
1,1,0,13,0,-13
2,1,0,13,0,-13
3,0,0,27,0,-27
4,1,1,1385,2256,871
5,1,1,526,2274,1748
6,0,0,41,0,-41
7,0,0,61,0,-61
8,0,0,34,0,-34
9,1,0,14,0,-14
10,1,1,133,1254,1121
11,0,0,58,0,-58
12,0,0,117,0,-117
13,0,0,5,0,-5
14,0,0,16,0,-16
15,1,1,1282,1273,-9
16,1,1,98,1259,1161
17,1,0,61,0,-61
18,1,0,52,0,-52
19,1,0,19,0,-19
20,0,0,91,0,-91
21,1,0,8,0,-8
22,1,0,9,0,-9
23,0,0,14,0,-14
24,1,1,136,1763,1627
25,1,0,111,0,-111
26,1,1,209,2252,2043
27,0,0,10,0,-10
28,1,1,190,1376,1186
29,1,1,917,1243,326
30,1,0,120,0,-120
31,1,0,25,0,-25
32,1,1,92,1651,1559
33,0,0,170,0,-170
34,0,0,0,0,0
35,1,1,406,1624,1218
36,1,1,865,1213,348
37,1,1,745,1369,624
38,1,1,764,1202,438
39,1,1,523,1225,702
40,0,0,114,0,-114
41,0,0,33,0,-33
42,1,1,1467,1328,-139
43,1,0,30,0,-30
44,1,0,61,0,-61
45,1,0,27,0,-27
46,1,1,451,2226,1775
47,1,1,873,1455,582
48,1,0,5,0,-5
49,1,0,33,0,-33
50,0,0,11,0,-11
51,1,1,351,1399,1048
52,1,0,4,0,-4
53,1,0,130,0,-130
54,1,0,55,0,-55
55,0,0,54,0,-54
56,1,0,45,0,-45
57,1,0,11,0,-11
58,0,0,19,0,-19
59,1,1,217,1760,1543
60,0,0,5,0,-5
61,0,0,17,0,-17
62,1,1,38,1534,1496
63,1,0,119,0,-119
64,0,0,7,0,-7
65,0,0,11,0,-11
66,1,1,833,1873,1040
67,0,0,56,0,-56
68,1,0,64,0,-64
69,1,1,824,1406,582
70,1,0,4,0,-4
71,0,0,351,0,-351
72,1,1,341,1845,1504
73,1,1,219,1350,1131
74,1,0,21,0,-21
75,1,1,1029,1389,360
76,0,0,8,0,-8
77,1,0,69,0,-69
78,1,1,293,1549,1256
79,1,1,941,2629,1688
80,1,0,51,0,-51
81,1,1,742,1426,684
82,1,1,190,1364,1174
83,1,1,711,1522,811
84,1,0,9,0,-9
85,0,0,44,0,-44
86,0,0,63,0,-63
87,1,1,524,1284,760
88,1,0,51,0,-51
89,1,1,183,3554,3371
90,1,1,155,2339,2184
91,0,0,14,0,-14
92,0,0,43,0,-43
93,0,0,8,0,-8
94,1,0,107,0,-107
95,0,0,63,0,-63
96,1,0,9,0,-9
97,0,0,0,0,0
98,0,0,64,0,-64
99,1,0,7,0,-7
100,0,0,12,0,-12
101,1,0,3,0,-3
102,1,1,1793,4673,2880
103,0,0,42,0,-42
104,0,0,14,0,-14
105,1,1,328,1224,896
106,0,0,1,0,-1
107,0,0,97,0,-97
108,0,0,3,0,-3
109,1,0,19,0,-19
110,1,1,120,1406,1286
111,0,0,54,0,-54
112,0,0,51,0,-51
113,1,1,800,1392,592
114,1,0,6,0,-6
115,1,1,91,1573,1482
116,1,0,3,0,-3
117,1,0,50,0,-50
118,0,0,70,0,-70
119,0,0,4,0,-4
120,1,1,2215,1505,-710
121,0,0,113,0,-113
122,0,0,13,0,-13
123,1,0,4,0,-4
124,1,0,20,0,-20
125,0,0,61,0,-61
126,0,0,219,0,-219
127,1,1,1012,1346,334
128,1,1,941,1241,300
129,1,1,328,1283,955
130,1,1,278,3382,3104
131,0,0,10,0,-10
132,1,1,732,3210,2478
133,0,0,5,0,-5
134,1,1,390,1533,1143
135,1,0,61,0,-61
136,1,1,270,1471,1201
137,1,0,27,0,-27
138,1,0,54,0,-54
139,1,0,4,0,-4
140,0,0,10,0,-10
141,1,0,51,0,-51
142,1,1,623,1230,607
143,0,0,28,0,-28
144,1,0,46,0,-46
145,0,0,43,0,-43
146,1,0,10,0,-10
147,0,0,21,0,-21
148,0,0,44,0,-44
149,1,1,713,1316,603
150,1,1,322,2466,2144
151,1,0,127,0,-127
152,1,1,715,2251,1536
153,0,0,115,0,-115
154,0,0,47,0,-47
155,1,0,15,0,-15
156,1,0,97,0,-97
157,1,1,169,1275,1106
158,1,1,192,1209,1017
159,1,1,539,1247,708
160,1,1,753,1433,680
161,1,1,345,1625,1280
162,1,1,458,2381,1923
163,1,1,157,1422,1265
164,1,1,454,1365,911
165,0,0,16,0,-16
166,1,1,574,1219,645
167,1,0,14,0,-14
168,1,1,92,1293,1201
169,0,0,5,0,-5
170,1,0,19,0,-19
171,1,0,2,0,-2
172,0,0,4,0,-4
173,0,0,93,0,-93
174,1,0,37,0,-37
175,0,0,120,0,-120
176,1,0,76,0,-76
177,0,0,80,0,-80
178,0,0,94,0,-94
179,1,1,591,1426,835
180,1,1,187,2350,2163
181,0,0,2,0,-2
182,1,0,88,0,-88
183,1,1,161,1286,1125
184,1,0,8,0,-8
185,0,0,58,0,-58
186,0,0,34,0,-34
187,1,0,9,0,-9
188,0,0,30,0,-30
189,1,1,353,1481,1128
190,0,0,30,0,-30
191,0,0,9,0,-9
192,1,0,111,0,-111
193,1,1,738,1362,624
194,0,0,22,0,-22
195,0,0,3,0,-3
196,0,0,48,0,-48
197,1,0,87,0,-87
198,1,0,3,0,-3
199,1,0,5,0,-5
200,1,0,25,0,-25
201,1,1,102,1256,1154
202,1,0,19,0,-19
203,1,1,670,2375,1705
204,0,0,0,0,0
205,1,1,183,1215,1032
206,1,1,110,1224,1114
207,1,0,26,0,-26
208,1,1,577,1515,938
209,0,0,4,0,-4
210,1,0,79,0,-79
211,1,1,60,1256,1196
212,1,0,78,0,-78
213,1,0,50,0,-50
214,0,0,37,0,-37
215,1,1,253,1214,961
216,0,0,13,0,-13
217,1,0,0,0,0
218,0,0,97,0,-97
219,0,0,180,0,-180
220,1,1,208,1252,1044
221,1,0,3,0,-3
222,0,0,6,0,-6
223,0,0,66,0,-66
224,0,0,54,0,-54
225,1,0,42,0,-42
226,1,0,127,0,-127
227,1,1,362,1361,999
228,0,0,63,0,-63
229,1,1,1037,1331,294
230,0,0,0,0,0
231,1,0,1,0,-1
232,0,0,15,0,-15
233,1,0,280,0,-280
234,1,1,393,1764,1371
235,0,0,173,0,-173
236,0,0,7,0,-7
237,1,1,54,1228,1174
238,0,0,40,0,-40
239,1,0,51,0,-51
240,1,0,43,0,-43
241,0,0,14,0,-14
242,1,0,64,0,-64
243,0,0,28,0,-28
244,0,0,39,0,-39
245,0,0,131,0,-131
246,0,0,48,0,-48
247,1,1,343,1368,1025
248,1,1,174,1300,1126
249,1,0,14,0,-14
250,0,0,16,0,-16
251,1,0,19,0,-19
252,1,1,224,1204,980
253,1,1,261,1329,1068
254,0,0,54,0,-54
255,0,0,71,0,-71
256,1,1,248,1277,1029
257,1,0,12,0,-12
258,1,1,1393,1368,-25
259,0,0,24,0,-24
260,1,1,1074,1231,157
261,0,0,28,0,-28
262,1,1,819,1281,462
263,1,1,279,1741,1462
264,1,0,25,0,-25
265,0,0,12,0,-12
266,1,0,8,0,-8
267,0,0,7,0,-7
268,1,1,88,1667,1579
269,0,0,9,0,-9
270,0,0,41,0,-41
271,1,0,71,0,-71
272,1,0,161,0,-161
273,1,1,559,1229,670
274,0,0,57,0,-57
275,0,0,93,0,-93
276,1,0,79,0,-79
277,1,0,31,0,-31
278,0,0,98,0,-98
279,0,0,28,0,-28
280,1,0,59,0,-59
281,0,0,64,0,-64
282,1,0,82,0,-82
283,1,1,342,1208,866
284,0,0,73,0,-73
285,0,0,39,0,-39
286,1,0,54,0,-54
287,1,1,217,1420,1203
288,1,0,67,0,-67
289,1,0,8,0,-8
290,1,1,1075,1794,719
291,1,1,1785,1270,-515
292,1,1,353,1478,1125
293,1,1,97,1632,1535
294,1,0,106,0,-106
295,1,0,40,0,-40
296,0,0,22,0,-22
297,1,0,88,0,-88
298,1,0,29,0,-29
299,0,0,28,0,-28
300,1,0,61,0,-61
301,0,0,114,0,-114
302,1,1,332,1336,1004
303,1,0,39,0,-39
304,1,1,286,1359,1073
305,1,1,532,1259,727
306,1,1,1179,1469,290
307,1,1,48,1335,1287
308,0,0,23,0,-23
309,1,0,37,0,-37
310,1,0,50,0,-50
311,0,0,58,0,-58
312,0,0,31,0,-31
313,0,0,104,0,-104
314,1,0,6,0,-6
315,0,0,14,0,-14
316,0,0,7,0,-7
317,0,0,21,0,-21
318,1,0,32,0,-32
319,1,1,1534,1356,-178
320,1,0,24,0,-24
321,1,0,36,0,-36
322,0,0,10,0,-10
323,0,0,2,0,-2
324,1,0,3,0,-3
325,1,1,505,1840,1335
326,0,0,5,0,-5
327,1,0,3,0,-3
328,0,0,3,0,-3
329,0,0,46,0,-46
330,0,0,20,0,-20
331,1,0,12,0,-12
332,0,0,7,0,-7
333,1,1,384,1267,883
334,1,1,442,1208,766
335,0,0,3,0,-3
336,1,1,160,1303,1143
337,0,0,29,0,-29
338,0,0,116,0,-116
339,0,0,38,0,-38
340,0,0,4,0,-4
341,1,0,22,0,-22
342,1,0,61,0,-61
343,1,1,607,2091,1484
344,0,0,28,0,-28
345,1,1,512,2413,1901
346,0,0,13,0,-13
347,0,0,3,0,-3
348,1,0,189,0,-189
349,1,0,9,0,-9
350,0,0,51,0,-51
351,0,0,39,0,-39
352,1,0,106,0,-106
353,1,1,1272,1280,8
354,1,1,894,1237,343
355,0,0,60,0,-60
356,1,0,31,0,-31
357,1,1,852,1423,571
358,0,0,53,0,-53
359,0,0,44,0,-44
360,0,0,1,0,-1
361,1,0,14,0,-14
362,0,0,5,0,-5
363,1,1,205,1378,1173
364,0,0,38,0,-38
365,0,0,72,0,-72
366,1,0,17,0,-17
367,1,0,119,0,-119
368,1,0,158,0,-158
369,1,1,48,2589,2541
370,1,0,39,0,-39
371,1,1,124,1270,1146
372,0,0,64,0,-64
373,1,1,832,1210,378
374,1,1,250,1354,1104
375,1,1,753,1275,522
376,1,0,100,0,-100
377,1,1,1027,1455,428
378,1,1,876,1243,367
379,0,0,33,0,-33
380,0,0,19,0,-19
381,1,1,262,2236,1974
382,1,0,17,0,-17
383,1,0,5,0,-5
384,0,0,40,0,-40
385,0,0,17,0,-17
386,1,0,250,0,-250
387,1,0,44,0,-44
388,1,1,534,1576,1042
389,1,1,350,1917,1567
390,1,1,89,1311,1222
391,1,1,75,2305,2230
392,1,1,261,1819,1558
393,1,1,2554,1213,-1341
394,0,0,38,0,-38
395,1,1,676,1209,533
396,1,1,75,1417,1342
397,0,0,110,0,-110
398,0,0,60,0,-60
399,1,1,808,1286,478
400,1,1,414,1478,1064
401,1,0,91,0,-91
402,1,0,16,0,-16
403,0,0,13,0,-13
404,1,1,3662,1321,-2341
405,1,0,74,0,-74
406,0,0,5,0,-5
407,1,0,96,0,-96
408,0,0,76,0,-76
409,0,0,16,0,-16
410,1,1,438,1419,981
411,0,0,20,0,-20
412,0,0,109,0,-109
413,0,0,95,0,-95
414,1,1,485,1541,1056
415,0,0,129,0,-129
416,1,1,468,2491,2023
417,1,0,34,0,-34
418,1,1,662,1377,715
419,1,1,436,2007,1571
420,0,0,119,0,-119
421,1,1,580,1430,850
422,0,0,24,0,-24
423,1,0,10,0,-10
424,1,0,23,0,-23
425,1,0,11,0,-11
426,1,1,328,1420,1092
427,1,0,50,0,-50
428,1,0,32,0,-32
429,0,0,11,0,-11
430,0,0,37,0,-37
431,0,0,66,0,-66
432,1,0,39,0,-39
433,1,1,909,1450,541
434,0,0,29,0,-29
435,1,0,9,0,-9
436,1,1,1035,1393,358
437,1,0,69,0,-69
438,1,0,28,0,-28
439,1,0,26,0,-26
440,1,0,100,0,-100
441,1,1,138,1223,1085
442,1,1,400,1345,945
443,1,0,133,0,-133
444,1,1,382,6259,5877
445,1,1,92,1416,1324
446,1,0,82,0,-82
447,0,0,33,0,-33
448,1,1,649,1429,780
449,0,0,28,0,-28
450,1,0,159,0,-159
451,1,0,88,0,-88
452,0,0,70,0,-70
453,1,1,813,1405,592
454,1,1,1554,1215,-339
455,0,0,7,0,-7
456,1,1,20,1470,1450
457,1,1,761,1711,950
458,1,1,366,1274,908
459,1,0,32,0,-32
460,1,0,54,0,-54
461,0,0,62,0,-62
462,0,0,70,0,-70
463,0,0,68,0,-68
464,1,0,176,0,-176
465,1,1,581,1376,795
466,1,1,690,1258,568
467,1,0,175,0,-175
468,1,0,4,0,-4
469,1,1,362,1213,851
470,1,1,580,1683,1103
471,0,0,16,0,-16
472,1,0,67,0,-67
473,1,0,55,0,-55
474,0,0,56,0,-56
475,1,1,368,1317,949
476,1,0,23,0,-23
477,1,1,55,1312,1257
478,0,0,131,0,-131
479,0,0,28,0,-28
480,0,0,61,0,-61
481,1,1,520,1261,741
482,1,0,5,0,-5
483,1,0,19,0,-19
484,1,0,79,0,-79
485,1,1,2179,4036,1857
486,0,0,31,0,-31
487,1,1,248,1329,1081
488,1,1,1087,1969,882
489,0,0,25,0,-25
490,1,0,60,0,-60
491,1,0,29,0,-29
492,1,0,10,0,-10
493,0,0,6,0,-6
494,0,0,70,0,-70
495,1,1,719,1204,485
496,1,1,243,1216,973
497,0,0,20,0,-20
498,0,0,47,0,-47
499,1,0,191,0,-191
500,0,0,20,0,-20
501,1,0,74,0,-74
502,0,0,1,0,-1
503,1,0,56,0,-56
504,0,0,120,0,-120
505,1,1,844,7811,6967
506,0,0,114,0,-114
507,1,0,16,0,-16
508,0,0,62,0,-62
509,1,1,1220,1314,94
510,1,1,1336,1208,-128
511,1,1,255,1873,1618
512,1,1,487,1383,896
513,1,1,749,1291,542
514,0,0,28,0,-28
515,1,1,266,1878,1612
516,0,0,53,0,-53
517,1,0,57,0,-57
518,1,0,71,0,-71
519,1,0,0,0,0
520,0,0,32,0,-32
521,0,0,8,0,-8
522,1,1,316,1246,930
523,1,0,31,0,-31
524,0,0,211,0,-211
525,1,0,44,0,-44
526,0,0,7,0,-7
527,0,0,14,0,-14
528,0,0,16,0,-16
529,1,0,34,0,-34
530,0,0,1,0,-1
531,1,0,3,0,-3
532,1,1,225,1396,1171
533,1,1,313,1235,922
534,0,0,49,0,-49
535,1,0,11,0,-11
536,0,0,19,0,-19
537,1,1,216,1226,1010
538,1,0,39,0,-39
539,0,0,65,0,-65
540,0,0,27,0,-27
541,1,1,562,1933,1371
542,1,1,1471,1765,294
543,0,0,0,0,0
544,1,1,445,1705,1260
545,1,1,105,1626,1521
546,1,1,314,1952,1638
547,0,0,59,0,-59
548,1,0,45,0,-45
549,1,1,590,1376,786
550,1,1,812,1592,780
551,0,0,66,0,-66
552,0,0,24,0,-24
553,0,0,52,0,-52
554,0,0,23,0,-23
555,1,1,368,2269,1901
556,1,1,257,1288,1031
557,1,0,2,0,-2
558,1,1,645,1253,608
559,1,0,43,0,-43
560,1,1,304,2138,1834
561,0,0,26,0,-26
562,0,0,11,0,-11
563,1,1,395,1200,805
564,0,0,77,0,-77
565,0,0,44,0,-44
566,1,1,352,1287,935
567,1,0,11,0,-11
568,0,0,10,0,-10
569,0,0,51,0,-51
570,1,1,71,2010,1939
571,1,1,1222,1302,80
572,1,1,780,1301,521
573,1,0,74,0,-74
574,1,0,50,0,-50
575,0,0,42,0,-42
576,1,0,11,0,-11
577,1,0,233,0,-233
578,1,1,217,1276,1059
579,1,0,7,0,-7
580,1,0,14,0,-14
581,1,1,58,1348,1290
582,1,1,699,1315,616
583,0,0,78,0,-78
584,1,0,0,0,0
585,1,0,71,0,-71
586,1,1,216,1509,1293
587,0,0,11,0,-11
588,1,1,322,1283,961
589,1,0,91,0,-91
590,0,0,0,0,0
591,1,1,315,1804,1489
592,1,0,76,0,-76
593,1,1,222,1447,1225
594,1,0,26,0,-26
595,1,1,1358,1713,355
596,1,1,393,1230,837
597,1,0,59,0,-59
598,1,1,678,1295,617
599,0,0,74,0,-74
600,1,1,187,1331,1144
601,1,1,647,1852,1205
602,1,1,701,1325,624
603,1,1,522,1433,911
604,1,1,1436,1500,64
605,0,0,9,0,-9
606,1,1,1017,1361,344
607,0,0,61,0,-61
608,0,0,10,0,-10
609,0,0,0,0,0
610,1,0,4,0,-4
611,0,0,14,0,-14
612,1,0,121,0,-121
613,0,0,56,0,-56
614,1,0,127,0,-127
615,1,0,78,0,-78
616,0,0,99,0,-99
617,1,1,227,1517,1290
618,1,1,334,1614,1280
619,1,0,46,0,-46
620,1,0,116,0,-116
621,1,1,51,1375,1324
622,1,1,55,1356,1301
623,1,1,208,1409,1201
624,1,1,359,1446,1087
625,1,1,255,2265,2010
626,1,0,26,0,-26
627,1,1,569,1382,813
628,0,0,17,0,-17
629,0,0,21,0,-21
630,1,1,237,1660,1423
631,1,1,793,1541,748
632,0,0,15,0,-15
633,1,0,7,0,-7
634,1,0,52,0,-52
635,1,1,435,1264,829
636,0,0,33,0,-33
637,1,0,2,0,-2
638,1,1,593,1697,1104
639,0,0,18,0,-18
640,0,0,13,0,-13
641,0,0,6,0,-6
642,1,1,119,1209,1090
643,1,0,115,0,-115
644,1,1,67,1228,1161
645,1,1,857,1248,391
646,1,1,666,1407,741
647,1,0,164,0,-164
648,0,0,8,0,-8
649,0,0,28,0,-28
650,1,1,701,1326,625
651,0,0,31,0,-31
652,0,0,104,0,-104
653,1,0,44,0,-44
654,1,0,80,0,-80
655,1,0,121,0,-121
656,1,0,110,0,-110
657,1,1,971,1533,562
658,0,0,49,0,-49
659,0,0,23,0,-23
660,1,1,245,1909,1664
661,1,0,36,0,-36
662,1,0,16,0,-16
663,0,0,24,0,-24
664,0,0,132,0,-132
665,1,1,519,1348,829
666,0,0,23,0,-23
667,0,0,60,0,-60
668,0,0,9,0,-9
669,1,1,105,1715,1610
670,1,0,291,0,-291
671,1,1,1412,1560,148
672,0,0,42,0,-42
673,0,0,123,0,-123
674,0,0,5,0,-5
675,0,0,9,0,-9
676,1,0,38,0,-38
677,0,0,36,0,-36
678,0,0,216,0,-216
679,1,0,22,0,-22
680,1,1,272,1322,1050
681,1,0,2,0,-2
682,0,0,155,0,-155
683,0,0,97,0,-97
684,1,0,22,0,-22
685,1,0,81,0,-81
686,0,0,52,0,-52
687,1,1,141,1349,1208
688,0,0,243,0,-243
689,1,1,232,1466,1234
690,0,0,18,0,-18
691,1,0,16,0,-16
692,0,0,56,0,-56
693,0,0,12,0,-12
694,1,1,93,1442,1349
695,1,1,615,1840,1225
696,1,1,230,1383,1153
697,1,0,0,0,0
698,0,0,105,0,-105
699,0,0,7,0,-7
700,0,0,86,0,-86
701,1,1,220,2320,2100
702,0,0,15,0,-15
703,1,0,26,0,-26
704,1,1,1580,1291,-289
705,1,0,36,0,-36
706,1,0,120,0,-120
707,0,0,46,0,-46
708,0,0,32,0,-32
709,1,1,97,1808,1711
710,1,0,6,0,-6
711,0,0,17,0,-17
712,0,0,12,0,-12
713,1,1,104,1419,1315
714,1,0,8,0,-8
715,0,0,55,0,-55
716,1,1,211,1624,1413
717,0,0,5,0,-5
718,1,1,1765,1380,-385
719,1,0,0,0,0
720,0,0,154,0,-154
721,0,0,22,0,-22
722,1,0,24,0,-24
723,1,0,81,0,-81
724,1,0,70,0,-70
725,1,0,131,0,-131
726,0,0,3,0,-3
727,1,0,60,0,-60
728,0,0,44,0,-44
729,1,1,399,1326,927
730,1,1,607,1400,793
731,0,0,93,0,-93
732,1,0,18,0,-18
733,0,0,31,0,-31
734,1,0,34,0,-34
735,0,0,8,0,-8
736,1,0,34,0,-34
737,0,0,29,0,-29
738,1,0,24,0,-24
739,1,1,1555,1283,-272
740,0,0,5,0,-5
741,1,1,249,1268,1019
742,1,1,59,1277,1218
743,1,0,4,0,-4
744,0,0,62,0,-62
745,1,0,36,0,-36
746,0,0,60,0,-60
747,0,0,17,0,-17
748,1,1,1166,1286,120
749,1,0,30,0,-30
750,1,1,506,1708,1202
751,0,0,162,0,-162
752,1,0,22,0,-22
753,1,0,22,0,-22
754,1,0,23,0,-23
755,0,0,2,0,-2
756,1,1,350,1225,875
757,1,1,359,1315,956
758,1,1,553,1261,708
759,1,0,16,0,-16
760,1,1,487,1280,793
761,0,0,0,0,0
762,1,0,10,0,-10
763,1,1,142,1768,1626
764,0,0,16,0,-16
765,0,0,28,0,-28
766,0,0,59,0,-59
767,0,0,37,0,-37
768,1,0,22,0,-22
769,1,1,411,1393,982
770,1,0,94,0,-94
771,1,1,179,1317,1138
772,0,0,41,0,-41
773,1,0,57,0,-57
774,0,0,0,0,0
775,0,0,12,0,-12
776,1,0,50,0,-50
777,0,0,15,0,-15
778,1,1,850,1331,481
779,1,1,298,1937,1639
780,0,0,39,0,-39
781,1,1,129,1271,1142
782,0,0,118,0,-118
783,0,0,23,0,-23
784,0,0,176,0,-176
785,0,0,152,0,-152
786,0,0,4,0,-4
787,0,0,122,0,-122
788,1,1,451,1348,897
789,1,0,25,0,-25
790,1,1,1134,2073,939
791,1,0,254,0,-254
792,1,0,150,0,-150
793,0,0,16,0,-16
794,1,1,157,1389,1232
795,1,1,61,1272,1211
796,1,1,389,1242,853
797,1,0,47,0,-47
798,1,0,173,0,-173
799,0,0,46,0,-46
800,1,1,126,1456,1330
801,0,0,105,0,-105
802,0,0,16,0,-16
803,0,0,12,0,-12
804,0,0,61,0,-61
805,1,1,1208,2423,1215
806,1,1,951,1229,278
807,1,0,117,0,-117
808,1,1,526,1363,837
809,1,1,1020,1864,844
810,1,0,16,0,-16
811,0,0,27,0,-27
812,1,0,7,0,-7
813,0,0,105,0,-105
814,1,1,255,1548,1293
815,0,0,5,0,-5
816,1,0,220,0,-220
817,0,0,117,0,-117
818,0,0,3,0,-3
819,1,1,693,1210,517
820,1,0,93,0,-93
821,0,0,56,0,-56
822,0,0,144,0,-144
823,1,1,853,1852,999
824,1,1,1994,1498,-496
825,1,1,819,1684,865
826,1,0,11,0,-11
827,1,0,49,0,-49
828,1,0,14,0,-14
829,1,0,34,0,-34
830,0,0,25,0,-25
831,0,0,82,0,-82
832,0,0,65,0,-65
833,0,0,0,0,0
834,0,0,33,0,-33
835,1,1,1432,1592,160
836,1,1,657,1245,588
837,1,1,923,1311,388
838,1,1,119,1425,1306
839,0,0,173,0,-173
840,1,1,476,1312,836
841,1,1,423,1265,842
842,0,0,22,0,-22
843,1,0,53,0,-53
844,1,1,419,1563,1144
845,0,0,3,0,-3
846,1,0,21,0,-21
847,0,0,44,0,-44
848,1,1,877,1487,610
849,1,0,24,0,-24
850,0,0,18,0,-18
851,1,0,26,0,-26
852,0,0,38,0,-38
853,1,1,913,1217,304
854,0,0,6,0,-6
855,1,1,521,1606,1085
856,0,0,38,0,-38
857,1,0,11,0,-11
858,0,0,12,0,-12
859,1,1,1914,1787,-127
860,1,1,442,1364,922
861,0,0,44,0,-44
862,1,1,709,2779,2070
863,1,0,31,0,-31
864,1,1,1106,1294,188
865,0,0,52,0,-52
866,0,0,55,0,-55
867,1,0,12,0,-12
868,1,0,35,0,-35
869,1,1,843,1478,635
870,0,0,211,0,-211
871,1,1,559,1544,985
872,1,1,400,1410,1010
873,0,0,19,0,-19
874,1,1,58,1218,1160
875,1,0,19,0,-19
876,0,0,2,0,-2
877,0,0,10,0,-10
878,0,0,7,0,-7
879,1,0,28,0,-28
880,0,0,14,0,-14
881,0,0,61,0,-61
882,1,1,1787,1394,-393
883,1,1,101,1695,1594
884,0,0,26,0,-26
885,0,0,19,0,-19
886,1,0,35,0,-35
887,1,1,102,2027,1925
888,1,1,75,1640,1565
889,1,1,86,1283,1197
890,0,0,22,0,-22
891,1,0,8,0,-8
892,1,1,156,1252,1096
893,0,0,18,0,-18
894,0,0,42,0,-42
895,1,0,20,0,-20
896,0,0,142,0,-142
897,1,0,20,0,-20
898,0,0,62,0,-62
899,1,0,9,0,-9
900,1,1,240,1284,1044
901,1,1,891,1458,567
902,1,0,101,0,-101
903,0,0,88,0,-88
904,0,0,0,0,0
905,1,1,52,1296,1244
906,0,0,83,0,-83
907,0,0,48,0,-48
908,0,0,47,0,-47
909,0,0,39,0,-39
910,0,0,107,0,-107
911,1,0,33,0,-33
912,0,0,73,0,-73
913,0,0,32,0,-32
914,1,0,8,0,-8
915,1,1,429,1511,1082
916,0,0,13,0,-13
917,1,1,519,1351,832
918,0,0,8,0,-8
919,0,0,22,0,-22
920,1,1,338,1299,961
921,1,1,453,1307,854
922,1,1,1077,1235,158
923,0,0,66,0,-66
924,0,0,139,0,-139
925,0,0,87,0,-87
926,1,0,46,0,-46
927,1,0,3,0,-3
928,1,0,10,0,-10
929,0,0,39,0,-39
930,0,0,64,0,-64
931,0,0,9,0,-9
932,1,0,38,0,-38
933,0,0,142,0,-142
934,1,0,17,0,-17
935,1,1,242,1229,987
936,1,1,675,1324,649
937,1,0,40,0,-40
938,1,1,292,1601,1309
939,0,0,80,0,-80
940,0,0,7,0,-7
941,0,0,0,0,0
942,1,1,161,2750,2589
943,0,0,7,0,-7
944,1,1,29,1256,1227
945,0,0,134,0,-134
946,1,1,686,1821,1135
947,1,1,720,1349,629
948,1,0,38,0,-38
949,1,0,5,0,-5
950,1,0,10,0,-10
951,0,0,2,0,-2
952,1,0,7,0,-7
953,0,0,17,0,-17
954,0,0,58,0,-58
955,1,0,39,0,-39
956,0,0,47,0,-47
957,1,0,32,0,-32
958,0,0,20,0,-20
959,0,0,72,0,-72
960,0,0,34,0,-34
961,1,1,336,1268,932
962,0,0,20,0,-20
963,1,1,248,1359,1111
964,1,0,122,0,-122
965,0,0,46,0,-46
966,0,0,12,0,-12
967,1,0,95,0,-95
968,1,1,149,1470,1321
969,1,1,752,1358,606
970,0,0,44,0,-44
971,1,0,21,0,-21
972,1,0,67,0,-67
973,1,0,106,0,-106
974,0,0,53,0,-53
975,1,1,1000,1946,946
976,0,0,8,0,-8
977,1,1,47,2045,1998
978,1,1,32,1574,1542
979,0,0,102,0,-102
980,1,1,980,1929,949
981,0,0,29,0,-29
982,1,1,394,1428,1034
983,1,1,415,1472,1057
984,0,0,20,0,-20
985,1,0,61,0,-61
986,1,1,833,3151,2318
987,0,0,31,0,-31
988,1,1,1046,1620,574
989,1,1,230,2425,2195
990,1,1,1713,1296,-417
991,1,0,9,0,-9
992,1,0,24,0,-24
993,0,0,76,0,-76
994,0,0,3,0,-3
995,1,1,370,1588,1218
996,1,1,808,1379,571
997,1,1,838,1293,455
998,1,0,42,0,-42
999,1,1,226,1672,1446
1000,0,0,12,0,-12
1001,0,0,72,0,-72
1002,0,0,10,0,-10
1003,0,0,41,0,-41
1004,1,0,21,0,-21
1005,1,1,190,1332,1142
1006,1,1,125,1436,1311
1007,0,0,79,0,-79
1008,1,0,93,0,-93
1009,1,1,758,1445,687
1010,1,0,38,0,-38
1011,1,0,5,0,-5
1012,1,1,91,1369,1278
1013,0,0,57,0,-57
1014,1,0,88,0,-88
1015,0,0,14,0,-14
1016,0,0,66,0,-66
1017,1,0,38,0,-38
1018,0,0,31,0,-31
1019,1,0,56,0,-56
1020,0,0,7,0,-7
1021,1,1,243,1269,1026
1022,0,0,10,0,-10
1023,1,1,238,1844,1606
1024,1,1,619,1683,1064
1025,1,0,109,0,-109
1026,1,1,340,1458,1118
1027,0,0,34,0,-34
1028,1,0,54,0,-54
1029,1,1,392,1958,1566
1030,1,0,17,0,-17
1031,0,0,44,0,-44
1032,0,0,46,0,-46
1033,1,0,64,0,-64
1034,0,0,4,0,-4
1035,1,1,462,1548,1086
1036,1,0,127,0,-127
1037,0,0,194,0,-194
1038,0,0,1,0,-1
1039,1,1,113,1263,1150
1040,0,0,94,0,-94
1041,1,0,85,0,-85
1042,1,1,68,1886,1818
1043,0,0,26,0,-26
1044,1,1,844,1291,447
1045,0,0,25,0,-25
1046,0,0,28,0,-28
1047,1,1,178,1571,1393
1048,0,0,43,0,-43
1049,1,1,192,1229,1037
1050,1,0,10,0,-10
1051,1,0,31,0,-31
1052,1,1,53,1536,1483
1053,1,0,12,0,-12
1054,1,1,183,1244,1061
1055,1,1,315,1402,1087
1056,0,0,132,0,-132
1057,0,0,101,0,-101
1058,1,1,338,1543,1205
1059,0,0,46,0,-46
1060,1,0,46,0,-46
1061,1,1,226,1348,1122
1062,1,0,53,0,-53
1063,0,0,123,0,-123
1064,1,0,16,0,-16
1065,1,0,27,0,-27
1066,1,0,23,0,-23
1067,1,1,393,2101,1708
1068,1,0,12,0,-12
1069,1,1,139,1926,1787
1070,0,0,40,0,-40
1071,1,1,558,1254,696
1072,1,0,12,0,-12
1073,0,0,6,0,-6
1074,1,1,570,2264,1694
1075,1,0,44,0,-44
1076,0,0,81,0,-81
1077,1,0,58,0,-58
1078,0,0,45,0,-45
1079,1,0,57,0,-57
1080,1,0,41,0,-41
1081,0,0,4,0,-4
1082,1,0,26,0,-26
1083,1,0,70,0,-70
1084,1,1,264,1202,938
1085,1,1,159,3881,3722
1086,1,1,1539,1360,-179
1087,0,0,96,0,-96
1088,1,1,659,2973,2314
1089,1,0,16,0,-16
1090,1,1,48,1527,1479
1091,1,0,60,0,-60
1092,1,1,350,1539,1189
1093,1,0,85,0,-85
1094,1,0,144,0,-144
1095,0,0,137,0,-137
1096,0,0,31,0,-31
1097,0,0,18,0,-18
1098,1,0,31,0,-31
1099,0,0,0,0,0
1100,0,0,0,0,0
1101,1,1,893,1508,615
1102,1,1,288,1208,920
1103,1,1,575,1412,837
1104,1,1,245,1204,959
1105,1,0,32,0,-32
1106,1,1,914,1246,332
1107,1,0,47,0,-47
1108,0,0,4,0,-4
1109,1,1,26,3094,3068
1110,0,0,2,0,-2
1111,1,0,50,0,-50
1112,1,1,330,1368,1038
1113,1,0,35,0,-35
1114,1,0,115,0,-115
1115,1,0,9,0,-9
1116,1,1,636,1710,1074
1117,0,0,9,0,-9
1118,0,0,1,0,-1
1119,0,0,60,0,-60
1120,1,0,40,0,-40
1121,0,0,37,0,-37
1122,0,0,82,0,-82
1123,0,0,94,0,-94
1124,0,0,24,0,-24
1125,1,0,28,0,-28
1126,1,1,760,1271,511
1127,1,1,20,1293,1273
1128,1,1,2101,1235,-866
1129,0,0,32,0,-32
1130,0,0,35,0,-35
1131,1,1,841,1580,739
1132,1,1,516,1405,889
1133,0,0,70,0,-70
1134,0,0,120,0,-120
1135,1,0,40,0,-40
1136,0,0,44,0,-44
1137,1,1,660,1776,1116
1138,0,0,38,0,-38
1139,1,0,30,0,-30
1140,1,1,1675,1721,46
1141,0,0,33,0,-33
1142,0,0,26,0,-26
1143,0,0,8,0,-8
1144,0,0,69,0,-69
1145,1,0,29,0,-29
1146,0,0,47,0,-47
1147,0,0,12,0,-12
1148,1,1,37,1787,1750
1149,1,0,11,0,-11
1150,1,1,705,1854,1149
1151,1,0,22,0,-22
1152,0,0,18,0,-18
1153,1,1,280,1204,924
1154,1,1,302,1507,1205
1155,1,1,516,1306,790
1156,1,0,149,0,-149
1157,1,1,696,1366,670
1158,0,0,5,0,-5
1159,1,1,108,1362,1254
1160,1,1,581,2147,1566
1161,1,1,935,2244,1309
1162,1,1,869,1259,390
1163,1,1,772,1204,432
1164,1,1,499,1267,768
1165,0,0,61,0,-61
1166,1,1,1141,1723,582
1167,1,1,98,1256,1158
1168,0,0,13,0,-13
1169,1,0,35,0,-35
1170,1,0,79,0,-79
1171,1,0,22,0,-22
1172,1,1,356,1357,1001
1173,0,0,15,0,-15
1174,1,0,42,0,-42
1175,0,0,18,0,-18
1176,1,1,304,1342,1038
1177,1,0,0,0,0
1178,1,1,289,1819,1530
1179,0,0,17,0,-17
1180,0,0,37,0,-37
1181,1,1,220,1394,1174
1182,0,0,30,0,-30
1183,1,1,280,1270,990
1184,1,0,22,0,-22
1185,1,1,214,2931,2717
1186,0,0,61,0,-61
1187,1,1,168,2059,1891
1188,1,0,105,0,-105
1189,1,1,221,1309,1088
1190,1,0,34,0,-34
1191,1,1,875,1659,784
1192,0,0,11,0,-11
1193,1,0,35,0,-35
1194,0,0,5,0,-5
1195,1,1,1182,1508,326
1196,1,0,46,0,-46
1197,1,0,32,0,-32
1198,1,0,55,0,-55
1199,0,0,18,0,-18
1200,1,1,306,1219,913
1201,0,0,0,0,0
1202,1,1,1463,1784,321
1203,0,0,79,0,-79
1204,1,0,1,0,-1
1205,1,1,433,1889,1456
1206,0,0,66,0,-66
1207,0,0,59,0,-59
1208,0,0,15,0,-15
1209,0,0,26,0,-26
1210,0,0,13,0,-13
1211,1,0,45,0,-45
1212,1,0,39,0,-39
1213,1,1,590,1453,863
1214,1,0,4,0,-4
1215,1,0,17,0,-17
1216,1,0,37,0,-37
1217,0,0,7,0,-7
1218,0,0,40,0,-40
1219,1,0,46,0,-46
1220,1,0,20,0,-20
1221,1,0,85,0,-85
1222,1,0,44,0,-44
1223,1,0,174,0,-174
1224,0,0,50,0,-50
1225,0,0,33,0,-33
1226,1,1,977,3505,2528
1227,0,0,14,0,-14
1228,0,0,14,0,-14
1229,1,1,107,1264,1157
1230,0,0,14,0,-14
1231,0,0,7,0,-7
1232,1,1,13,2149,2136
1233,1,0,42,0,-42
1234,1,1,273,1315,1042
1235,1,0,9,0,-9
1236,1,0,98,0,-98
1237,1,1,1396,1442,46
1238,1,0,2,0,-2
1239,0,0,27,0,-27
1240,0,0,176,0,-176
1241,1,0,31,0,-31
1242,1,0,24,0,-24
1243,0,0,3,0,-3
1244,1,1,310,1302,992
1245,0,0,112,0,-112
1246,1,1,609,1613,1004
1247,1,1,203,1351,1148
1248,1,1,222,1576,1354
1249,0,0,67,0,-67
1250,1,1,83,1272,1189
1251,1,1,214,1231,1017
1252,1,0,60,0,-60
1253,0,0,141,0,-141
1254,1,1,249,2209,1960
1255,0,0,19,0,-19
1256,1,1,344,1273,929
1257,1,0,12,0,-12
1258,0,0,65,0,-65
1259,1,0,22,0,-22
1260,0,0,1,0,-1
1261,1,1,221,1641,1420
1262,0,0,27,0,-27
1263,1,0,2,0,-2
1264,1,0,19,0,-19
1265,0,0,16,0,-16
1266,1,0,37,0,-37
1267,0,0,25,0,-25
1268,1,1,1798,1308,-490
1269,0,0,31,0,-31
1270,1,1,523,1745,1222
1271,1,0,41,0,-41
1272,0,0,15,0,-15
1273,0,0,48,0,-48
1274,1,1,153,1275,1122
1275,1,0,22,0,-22
1276,1,0,74,0,-74
1277,0,0,264,0,-264
1278,0,0,101,0,-101
1279,1,1,51,1498,1447
1280,1,1,118,2625,2507
1281,0,0,24,0,-24
1282,0,0,38,0,-38
1283,1,1,341,1722,1381
1284,0,0,156,0,-156
1285,1,1,568,1788,1220
1286,1,1,281,1375,1094
1287,1,1,1096,3165,2069
1288,1,0,2,0,-2
1289,1,0,136,0,-136
1290,1,0,27,0,-27
1291,0,0,69,0,-69
1292,0,0,61,0,-61
1293,1,0,38,0,-38
1294,1,0,2,0,-2
1295,0,0,1,0,-1
1296,1,1,523,1496,973
1297,1,1,488,2264,1776
1298,1,1,553,1320,767
1299,0,0,9,0,-9
1300,1,1,428,3240,2812
1301,1,0,104,0,-104
1302,1,0,4,0,-4
1303,0,0,14,0,-14
1304,0,0,250,0,-250
1305,1,0,21,0,-21
1306,0,0,5,0,-5
1307,1,1,599,1273,674
1308,0,0,27,0,-27
1309,1,1,1113,1390,277
1310,0,0,5,0,-5
1311,1,1,1565,1658,93
1312,1,0,138,0,-138
1313,0,0,155,0,-155
1314,1,0,31,0,-31
1315,0,0,20,0,-20
1316,0,0,3,0,-3
1317,1,1,1882,1264,-618
1318,0,0,99,0,-99
1319,1,0,7,0,-7
1320,1,0,12,0,-12
1321,1,1,1326,1942,616
1322,1,1,1267,1306,39
1323,1,0,4,0,-4
1324,0,0,74,0,-74
1325,1,0,46,0,-46
1326,1,1,917,2412,1495
1327,0,0,53,0,-53
1328,0,0,65,0,-65
1329,1,0,183,0,-183
1330,1,1,271,2170,1899
1331,1,0,71,0,-71
1332,0,0,16,0,-16
1333,0,0,12,0,-12
1334,0,0,180,0,-180
1335,1,0,24,0,-24
1336,0,0,9,0,-9
1337,1,0,0,0,0
1338,1,1,380,1250,870
1339,0,0,1,0,-1
1340,0,0,15,0,-15
1341,1,0,17,0,-17
1342,1,0,5,0,-5
1343,1,1,306,8530,8224
1344,1,1,545,1326,781
1345,1,1,723,1875,1152
1346,0,0,157,0,-157
1347,1,0,21,0,-21
1348,0,0,54,0,-54
1349,1,0,18,0,-18
1350,1,1,842,1778,936
1351,1,1,294,1602,1308
1352,0,0,60,0,-60
1353,1,1,175,1354,1179
1354,1,0,273,0,-273
1355,1,1,185,1496,1311
1356,1,0,6,0,-6
1357,1,1,775,1625,850
1358,1,0,6,0,-6
1359,1,0,140,0,-140
1360,1,1,1568,1591,23
1361,0,0,216,0,-216
1362,1,0,92,0,-92
1363,0,0,48,0,-48
1364,1,0,13,0,-13
1365,1,1,442,2042,1600
1366,0,0,118,0,-118
1367,0,0,97,0,-97
1368,1,0,171,0,-171
1369,1,1,82,1452,1370
1370,0,0,28,0,-28
1371,0,0,230,0,-230
1372,1,1,167,3093,2926
1373,0,0,4,0,-4
1374,0,0,5,0,-5
1375,1,1,424,1410,986
1376,1,0,33,0,-33
1377,0,0,101,0,-101
1378,0,0,38,0,-38
1379,1,0,21,0,-21
1380,1,1,395,1927,1532
1381,1,0,59,0,-59
1382,1,0,27,0,-27
1383,1,1,190,1518,1328
1384,1,1,159,2082,1923
1385,0,0,313,0,-313
1386,1,0,32,0,-32
1387,0,0,29,0,-29
1388,1,1,311,2231,1920
1389,0,0,194,0,-194
1390,1,1,70,1539,1469
1391,0,0,3,0,-3
1392,1,0,49,0,-49
1393,0,0,8,0,-8
1394,0,0,17,0,-17
1395,0,0,55,0,-55
1396,1,1,339,2688,2349
1397,1,0,4,0,-4
1398,1,0,9,0,-9
1399,1,0,12,0,-12
1400,1,0,10,0,-10
1401,1,0,98,0,-98
1402,0,0,64,0,-64
1403,0,0,55,0,-55
1404,1,1,239,1266,1027
1405,0,0,61,0,-61
1406,1,0,23,0,-23
1407,1,1,496,1856,1360
1408,0,0,41,0,-41
1409,0,0,53,0,-53
1410,1,1,139,1365,1226
1411,1,0,4,0,-4
1412,0,0,90,0,-90
1413,0,0,109,0,-109
1414,0,0,9,0,-9
1415,1,1,822,1253,431
1416,1,1,490,1384,894
1417,0,0,40,0,-40
1418,1,0,27,0,-27
1419,1,1,251,1419,1168
1420,0,0,9,0,-9
1421,1,0,67,0,-67
1422,1,1,161,1538,1377
1423,1,0,31,0,-31
1424,1,1,412,1211,799
1425,0,0,76,0,-76
1426,1,0,41,0,-41
1427,0,0,35,0,-35
1428,0,0,99,0,-99
1429,1,1,116,1313,1197
1430,1,0,51,0,-51
1431,1,0,22,0,-22
1432,1,1,956,1485,529
1433,0,0,45,0,-45
1434,1,1,412,2155,1743
1435,0,0,8,0,-8
1436,0,0,47,0,-47
1437,1,1,3584,1211,-2373
1438,1,1,80,1234,1154
1439,0,0,14,0,-14
1440,0,0,70,0,-70
1441,1,0,24,0,-24
1442,0,0,16,0,-16
1443,1,1,1610,1655,45
1444,0,0,25,0,-25
1445,1,1,752,1738,986
1446,0,0,13,0,-13
1447,0,0,41,0,-41
1448,1,0,7,0,-7
1449,1,0,155,0,-155
1450,1,1,720,1232,512
1451,0,0,44,0,-44
1452,0,0,60,0,-60
1453,0,0,17,0,-17
1454,1,0,94,0,-94
1455,1,0,34,0,-34
1456,1,1,2165,1412,-753
1457,1,0,89,0,-89
1458,0,0,75,0,-75
1459,0,0,47,0,-47
1460,1,0,205,0,-205
1461,0,0,64,0,-64
1462,0,0,9,0,-9
1463,0,0,5,0,-5
1464,1,1,457,1247,790
1465,0,0,23,0,-23
1466,1,0,14,0,-14
1467,1,0,7,0,-7
1468,1,1,1006,1636,630
1469,1,0,17,0,-17
1470,0,0,51,0,-51
1471,0,0,23,0,-23
1472,1,0,3,0,-3
1473,0,0,15,0,-15
1474,1,1,232,1225,993
1475,0,0,250,0,-250
1476,0,0,114,0,-114
1477,0,0,27,0,-27
1478,0,0,4,0,-4
1479,1,0,15,0,-15
1480,0,0,79,0,-79
1481,0,0,24,0,-24
1482,1,0,28,0,-28
1483,0,0,13,0,-13
1484,0,0,11,0,-11
1485,0,0,18,0,-18
1486,0,0,2,0,-2
1487,1,0,35,0,-35
1488,1,0,23,0,-23
1489,1,0,37,0,-37
1490,1,1,674,1319,645
1491,1,0,13,0,-13
1492,0,0,140,0,-140
1493,1,1,2330,2746,416
1494,0,0,36,0,-36
1495,0,0,4,0,-4
1496,1,1,356,1226,870
1497,0,0,17,0,-17
1498,1,0,89,0,-89
1499,1,1,864,1850,986
1500,0,0,108,0,-108
1501,0,0,64,0,-64
1502,1,1,272,1243,971
1503,1,0,70,0,-70
1504,0,0,0,0,0
1505,1,0,36,0,-36
1506,1,0,2,0,-2
1507,1,1,109,2232,2123
1508,0,0,32,0,-32
1509,1,1,1215,1813,598
1510,0,0,83,0,-83
1511,0,0,40,0,-40
1512,0,0,28,0,-28
1513,0,0,3,0,-3
1514,1,0,13,0,-13
1515,1,1,269,1370,1101
1516,0,0,10,0,-10
1517,1,1,750,1480,730
1518,0,0,22,0,-22
1519,1,1,171,1266,1095
1520,1,1,36,1901,1865
1521,1,0,60,0,-60
1522,1,0,8,0,-8
1523,0,0,68,0,-68
1524,1,1,873,1663,790
1525,1,1,967,1221,254
1526,1,1,663,1832,1169
1527,0,0,40,0,-40
1528,1,1,129,1825,1696
1529,0,0,0,0,0
1530,1,0,276,0,-276
1531,1,1,986,1263,277
1532,1,1,283,1211,928
1533,1,0,89,0,-89
1534,0,0,42,0,-42
1535,1,1,191,3088,2897
1536,1,1,309,1448,1139
1537,1,0,75,0,-75
1538,1,1,638,1232,594
1539,0,0,71,0,-71
1540,1,0,2,0,-2
1541,0,0,32,0,-32
1542,1,1,69,2203,2134
1543,0,0,26,0,-26
1544,1,1,169,1933,1764
1545,1,1,152,1322,1170
1546,0,0,4,0,-4
1547,0,0,45,0,-45
1548,1,1,281,1599,1318
1549,1,0,63,0,-63
1550,0,0,19,0,-19
1551,0,0,169,0,-169
1552,0,0,21,0,-21
1553,1,0,47,0,-47
1554,1,1,337,1615,1278
1555,1,0,57,0,-57
1556,1,0,116,0,-116
1557,0,0,33,0,-33
1558,0,0,15,0,-15
1559,1,1,82,3945,3863
1560,0,0,11,0,-11
1561,1,0,6,0,-6
1562,0,0,84,0,-84
1563,1,0,12,0,-12
1564,0,0,21,0,-21
1565,0,0,34,0,-34
1566,1,0,29,0,-29
1567,0,0,40,0,-40
1568,0,0,83,0,-83
1569,1,1,163,1395,1232
1570,1,0,36,0,-36
1571,0,0,87,0,-87
1572,1,1,613,1210,597
1573,1,0,12,0,-12
1574,1,1,320,1202,882
1575,0,0,97,0,-97
1576,1,1,37,2024,1987
1577,1,1,60,1268,1208
1578,0,0,26,0,-26
1579,0,0,5,0,-5
1580,1,1,182,1315,1133
1581,1,0,41,0,-41
1582,1,0,78,0,-78
1583,1,0,17,0,-17
1584,0,0,92,0,-92
1585,0,0,15,0,-15
1586,1,1,2754,1463,-1291
1587,0,0,36,0,-36
1588,0,0,41,0,-41
1589,1,0,57,0,-57
1590,0,0,2,0,-2
1591,0,0,10,0,-10
1592,1,1,414,2396,1982
1593,0,0,1,0,-1
1594,1,1,346,1271,925
1595,1,0,60,0,-60
1596,0,0,64,0,-64
1597,0,0,2,0,-2
1598,1,0,98,0,-98
1599,1,1,412,1443,1031
1600,1,1,1133,1290,157
1601,1,1,1764,1449,-315
1602,0,0,32,0,-32
1603,1,0,112,0,-112
1604,0,0,93,0,-93
1605,1,0,77,0,-77
1606,0,0,16,0,-16
1607,1,0,30,0,-30
1608,0,0,106,0,-106
1609,0,0,49,0,-49
1610,1,0,47,0,-47
1611,1,0,59,0,-59
1612,0,0,29,0,-29
1613,1,1,168,1462,1294
1614,1,0,4,0,-4
1615,1,1,271,2305,2034
1616,1,0,53,0,-53
1617,1,1,28,1381,1353
1618,1,1,400,1640,1240
1619,0,0,53,0,-53
1620,1,0,77,0,-77
1621,0,0,8,0,-8
1622,1,0,209,0,-209
1623,0,0,48,0,-48
1624,1,0,43,0,-43
1625,1,0,48,0,-48
1626,0,0,144,0,-144
1627,0,0,47,0,-47
1628,1,0,33,0,-33
1629,0,0,5,0,-5
1630,0,0,178,0,-178
1631,0,0,62,0,-62
1632,0,0,18,0,-18
1633,0,0,6,0,-6
1634,0,0,114,0,-114
1635,1,0,63,0,-63
1636,1,1,531,1783,1252
1637,1,1,827,1225,398
1638,1,0,70,0,-70
1639,1,1,484,2621,2137
1640,0,0,30,0,-30
1641,1,0,124,0,-124
1642,0,0,27,0,-27
1643,0,0,5,0,-5
1644,1,1,140,1692,1552
1645,0,0,27,0,-27
1646,0,0,117,0,-117
1647,1,0,40,0,-40
1648,0,0,82,0,-82
1649,1,0,8,0,-8
1650,1,1,29,1201,1172
1651,1,0,27,0,-27
1652,0,0,67,0,-67
1653,0,0,11,0,-11
1654,1,1,83,1304,1221
1655,1,1,813,2026,1213
1656,1,1,821,1585,764
1657,1,1,1288,1410,122
1658,1,0,15,0,-15
1659,1,1,331,1200,869
1660,0,0,18,0,-18
1661,1,1,492,2611,2119
1662,0,0,60,0,-60
1663,0,0,2,0,-2
1664,0,0,50,0,-50
1665,1,0,6,0,-6
1666,1,0,64,0,-64
1667,0,0,18,0,-18
1668,1,1,308,1213,905
1669,0,0,15,0,-15
1670,1,0,138,0,-138
1671,0,0,82,0,-82
1672,0,0,50,0,-50
1673,1,1,1442,1254,-188
1674,1,0,9,0,-9
1675,1,0,22,0,-22
1676,0,0,95,0,-95
1677,1,0,44,0,-44
1678,0,0,61,0,-61
1679,0,0,182,0,-182
1680,1,0,105,0,-105
1681,1,0,14,0,-14
1682,1,0,8,0,-8
1683,0,0,66,0,-66
1684,1,0,21,0,-21
1685,1,0,55,0,-55
1686,0,0,46,0,-46
1687,0,0,77,0,-77
1688,1,1,135,1257,1122
1689,1,1,54,1230,1176
1690,0,0,0,0,0
1691,1,1,984,2527,1543
1692,0,0,10,0,-10
1693,1,0,46,0,-46
1694,1,1,1431,1244,-187
1695,1,0,18,0,-18
1696,0,0,115,0,-115
1697,0,0,33,0,-33
1698,0,0,3,0,-3
1699,1,1,543,1496,953
1700,1,0,6,0,-6
1701,1,0,118,0,-118
1702,1,1,973,1300,327
1703,0,0,39,0,-39
1704,1,0,6,0,-6
1705,0,0,186,0,-186
1706,1,1,249,1292,1043
1707,0,0,6,0,-6
1708,0,0,6,0,-6
1709,0,0,14,0,-14
1710,1,1,462,2075,1613
1711,1,1,431,2340,1909
1712,1,0,101,0,-101
1713,0,0,6,0,-6
1714,0,0,9,0,-9
1715,1,0,27,0,-27
1716,1,1,75,1756,1681
1717,0,0,6,0,-6
1718,1,1,503,1278,775
1719,1,1,118,2009,1891
1720,1,1,31,1724,1693
1721,1,0,52,0,-52
1722,1,0,2,0,-2
1723,1,1,176,1356,1180
1724,0,0,43,0,-43
1725,0,0,4,0,-4
1726,1,0,41,0,-41
1727,1,1,653,1419,766
1728,0,0,2,0,-2
1729,1,1,96,1603,1507
1730,0,0,85,0,-85
1731,1,0,305,0,-305
1732,1,0,3,0,-3
1733,1,1,476,1403,927
1734,1,1,1343,2239,896
1735,1,0,279,0,-279
1736,0,0,91,0,-91
1737,0,0,23,0,-23
1738,1,1,299,1285,986
1739,1,0,9,0,-9
1740,0,0,55,0,-55
1741,1,1,312,1392,1080
1742,1,1,516,1384,868
1743,0,0,23,0,-23
1744,1,0,78,0,-78
1745,0,0,51,0,-51
1746,0,0,75,0,-75
1747,1,0,4,0,-4
1748,1,0,25,0,-25
1749,1,0,31,0,-31
1750,0,0,7,0,-7
1751,0,0,32,0,-32
1752,0,0,12,0,-12
1753,1,1,1134,1487,353
1754,1,0,61,0,-61
1755,1,1,821,1247,426
1756,1,1,625,1403,778
1757,1,1,151,1496,1345
1758,1,0,12,0,-12
1759,1,0,3,0,-3
1760,1,0,171,0,-171
1761,1,0,6,0,-6
1762,1,1,8,1242,1234
1763,0,0,7,0,-7
1764,0,0,18,0,-18
1765,1,1,849,1365,516
1766,0,0,55,0,-55
1767,1,0,71,0,-71
1768,1,1,206,1233,1027
1769,1,1,905,1454,549
1770,0,0,79,0,-79
1771,0,0,49,0,-49
1772,0,0,1,0,-1
1773,0,0,166,0,-166
1774,0,0,131,0,-131
1775,1,1,277,1800,1523
1776,0,0,51,0,-51
1777,1,0,83,0,-83
1778,0,0,12,0,-12
1779,1,1,38,1504,1466
1780,1,0,17,0,-17
1781,0,0,26,0,-26
1782,0,0,32,0,-32
1783,0,0,26,0,-26
1784,1,1,364,1234,870
1785,1,0,92,0,-92
1786,1,1,86,1502,1416
1787,0,0,14,0,-14
1788,0,0,91,0,-91
1789,1,0,62,0,-62
1790,1,0,195,0,-195
1791,1,0,14,0,-14
1792,1,0,183,0,-183
1793,1,1,94,1263,1169
1794,0,0,51,0,-51
1795,1,0,110,0,-110
1796,0,0,57,0,-57
1797,0,0,49,0,-49
1798,1,1,449,1857,1408
1799,1,0,124,0,-124
1800,1,0,54,0,-54
1801,1,1,629,1378,749
1802,0,0,2,0,-2
1803,1,1,141,1202,1061
1804,1,1,48,1556,1508
1805,0,0,48,0,-48
1806,1,0,40,0,-40
1807,1,0,1,0,-1
1808,0,0,14,0,-14
1809,0,0,25,0,-25
1810,0,0,11,0,-11
1811,1,1,2025,1315,-710
1812,0,0,8,0,-8
1813,1,1,88,1427,1339
1814,0,0,0,0,0
1815,1,0,128,0,-128
1816,0,0,11,0,-11
1817,0,0,72,0,-72
1818,0,0,67,0,-67
1819,1,0,63,0,-63
1820,1,0,115,0,-115
1821,1,0,49,0,-49
1822,1,0,230,0,-230
1823,0,0,12,0,-12
1824,0,0,107,0,-107
1825,0,0,84,0,-84
1826,1,0,47,0,-47
1827,1,1,756,1200,444
1828,1,1,112,1740,1628
1829,1,1,1447,1278,-169
1830,1,1,592,1349,757
1831,0,0,25,0,-25
1832,1,0,16,0,-16
1833,0,0,43,0,-43
1834,1,1,1251,1349,98
1835,1,1,407,1211,804
1836,1,1,119,1568,1449
1837,1,1,274,1283,1009
1838,0,0,77,0,-77
1839,1,0,91,0,-91
1840,0,0,19,0,-19
1841,1,0,41,0,-41
1842,1,0,210,0,-210
1843,1,0,52,0,-52
1844,0,0,71,0,-71
1845,0,0,8,0,-8
1846,0,0,1,0,-1
1847,1,0,3,0,-3
1848,0,0,65,0,-65
1849,0,0,3,0,-3
1850,1,0,27,0,-27
1851,0,0,28,0,-28
1852,0,0,20,0,-20
1853,1,1,226,3568,3342
1854,0,0,24,0,-24
1855,1,1,1534,1403,-131
1856,1,0,71,0,-71
1857,0,0,87,0,-87
1858,1,1,569,1758,1189
1859,1,0,110,0,-110
1860,1,1,254,1267,1013
1861,0,0,57,0,-57
1862,0,0,22,0,-22
1863,1,1,34,3902,3868
1864,1,0,24,0,-24
1865,1,1,785,1998,1213
1866,1,1,747,1206,459
1867,0,0,4,0,-4
1868,1,0,98,0,-98
1869,1,0,3,0,-3
1870,1,1,70,1229,1159
1871,1,0,13,0,-13
1872,1,0,61,0,-61
1873,0,0,2,0,-2
1874,1,1,548,1249,701
1875,1,0,42,0,-42
1876,1,1,272,1633,1361
1877,1,1,281,1717,1436
1878,1,0,4,0,-4
1879,1,1,165,1304,1139
1880,1,1,71,2012,1941
1881,0,0,38,0,-38
1882,0,0,90,0,-90
1883,0,0,39,0,-39
1884,1,0,1,0,-1
1885,1,1,180,1293,1113
1886,0,0,8,0,-8
1887,1,1,106,1299,1193
1888,1,0,9,0,-9
1889,1,0,90,0,-90
1890,0,0,70,0,-70
1891,0,0,7,0,-7
1892,1,0,55,0,-55
1893,0,0,14,0,-14
1894,1,1,162,1500,1338
1895,1,0,19,0,-19
1896,0,0,60,0,-60
1897,1,0,49,0,-49
1898,1,1,164,1363,1199
1899,0,0,101,0,-101
1900,1,1,402,1210,808
1901,0,0,3,0,-3
1902,0,0,116,0,-116
1903,1,0,46,0,-46
1904,0,0,12,0,-12
1905,0,0,86,0,-86
1906,1,1,268,1542,1274
1907,0,0,0,0,0
1908,1,0,118,0,-118
1909,0,0,7,0,-7
1910,1,1,580,1315,735
1911,1,0,155,0,-155
1912,1,0,52,0,-52
1913,0,0,73,0,-73
1914,1,0,27,0,-27
1915,1,0,22,0,-22
1916,1,0,2,0,-2
1917,1,0,212,0,-212
1918,1,1,310,1276,966
1919,0,0,1,0,-1
1920,1,1,739,1298,559
1921,1,0,24,0,-24
1922,0,0,78,0,-78
1923,1,0,11,0,-11
1924,0,0,69,0,-69
1925,1,1,162,1418,1256
1926,1,0,26,0,-26
1927,1,0,16,0,-16
1928,0,0,42,0,-42
1929,1,1,389,1277,888
1930,1,0,41,0,-41
1931,1,0,23,0,-23
1932,0,0,42,0,-42
1933,1,0,2,0,-2
1934,1,0,36,0,-36
1935,1,1,998,1405,407
1936,1,1,346,1269,923
1937,1,0,150,0,-150
1938,0,0,53,0,-53
1939,1,0,115,0,-115
1940,1,0,31,0,-31
1941,1,0,57,0,-57
1942,1,1,970,1361,391
1943,0,0,38,0,-38
1944,1,0,61,0,-61
1945,0,0,45,0,-45
1946,1,0,24,0,-24
1947,0,0,27,0,-27
1948,0,0,4,0,-4
1949,1,0,17,0,-17
1950,0,0,1,0,-1
1951,1,1,412,1588,1176
1952,1,1,301,1216,915
1953,1,0,0,0,0
1954,1,1,596,1392,796
1955,0,0,11,0,-11
1956,1,1,478,1382,904
1957,1,1,221,1428,1207
1958,0,0,47,0,-47
1959,1,0,34,0,-34
1960,1,1,1626,1508,-118
1961,0,0,46,0,-46
1962,1,1,1172,1209,37
1963,0,0,6,0,-6
1964,1,0,91,0,-91
1965,0,0,30,0,-30
1966,1,0,6,0,-6
1967,0,0,37,0,-37
1968,0,0,9,0,-9
1969,0,0,112,0,-112
1970,1,1,23,1273,1250
1971,0,0,31,0,-31
1972,0,0,131,0,-131
1973,1,0,10,0,-10
1974,1,1,268,1426,1158
1975,0,0,36,0,-36
1976,1,1,605,1208,603
1977,1,1,777,1392,615
1978,1,1,368,1669,1301
1979,0,0,15,0,-15
1980,1,0,96,0,-96
1981,1,0,57,0,-57
1982,0,0,4,0,-4
1983,0,0,14,0,-14
1984,0,0,51,0,-51
1985,0,0,37,0,-37
1986,1,0,48,0,-48
1987,1,0,156,0,-156
1988,0,0,63,0,-63
1989,1,1,638,1478,840
1990,0,0,99,0,-99
1991,1,1,369,2106,1737
1992,0,0,67,0,-67
1993,1,0,19,0,-19
1994,1,0,65,0,-65
1995,1,1,138,1396,1258
1996,0,0,18,0,-18
1997,1,0,94,0,-94
1998,1,0,16,0,-16
1999,1,1,1459,1330,-129
2000,0,0,7,0,-7
2001,1,0,57,0,-57
2002,1,0,5,0,-5
2003,1,1,468,1584,1116
2004,0,0,120,0,-120
2005,1,0,24,0,-24
2006,1,0,112,0,-112
2007,1,0,17,0,-17
2008,0,0,2,0,-2
2009,1,1,59,1415,1356
2010,1,1,1211,3108,1897
2011,1,0,13,0,-13
2012,1,0,14,0,-14
2013,0,0,38,0,-38
2014,0,0,13,0,-13
2015,1,0,34,0,-34
2016,1,1,5,1495,1490
2017,1,0,16,0,-16
2018,1,1,127,2417,2290
2019,0,0,75,0,-75
2020,1,0,12,0,-12
2021,1,0,59,0,-59
2022,1,0,37,0,-37
2023,0,0,8,0,-8
2024,1,1,90,1240,1150
2025,1,1,52,2362,2310
2026,1,1,405,1338,933
2027,1,0,1,0,-1
2028,1,0,3,0,-3
2029,0,0,119,0,-119
2030,1,0,112,0,-112
2031,0,0,43,0,-43
2032,1,1,1532,1432,-100
2033,1,0,42,0,-42
2034,1,0,53,0,-53
2035,0,0,19,0,-19
2036,1,0,41,0,-41
2037,0,0,78,0,-78
2038,1,1,25,1225,1200
2039,1,0,59,0,-59
2040,1,0,41,0,-41
2041,1,0,237,0,-237
2042,1,0,68,0,-68
2043,0,0,56,0,-56
2044,1,0,118,0,-118
2045,0,0,65,0,-65
2046,1,1,472,1326,854
2047,1,1,870,1568,698
2048,0,0,6,0,-6
2049,0,0,1,0,-1
2050,0,0,7,0,-7
2051,1,0,180,0,-180
2052,0,0,31,0,-31
2053,0,0,4,0,-4
2054,0,0,66,0,-66
2055,1,0,51,0,-51
2056,1,1,93,1213,1120
2057,1,0,10,0,-10
2058,0,0,44,0,-44
2059,1,0,12,0,-12
2060,1,0,49,0,-49
2061,1,1,259,4089,3830
2062,1,0,53,0,-53
2063,0,0,18,0,-18
2064,0,0,66,0,-66
2065,0,0,26,0,-26
2066,1,1,75,1352,1277
2067,0,0,117,0,-117
2068,0,0,2,0,-2
2069,0,0,1,0,-1
2070,1,0,22,0,-22
2071,0,0,4,0,-4
2072,0,0,30,0,-30
2073,0,0,43,0,-43
2074,0,0,40,0,-40
2075,0,0,38,0,-38
2076,0,0,13,0,-13
2077,1,0,1,0,-1
2078,0,0,66,0,-66
2079,1,0,31,0,-31
2080,0,0,61,0,-61
2081,1,1,1295,1768,473
2082,1,1,242,1200,958
2083,0,0,44,0,-44
2084,0,0,32,0,-32
2085,0,0,68,0,-68
2086,0,0,41,0,-41
2087,1,0,5,0,-5
2088,0,0,85,0,-85
2089,1,1,208,2018,1810
2090,1,0,13,0,-13
2091,0,0,16,0,-16
2092,0,0,203,0,-203
2093,1,1,1886,1535,-351
2094,0,0,70,0,-70
2095,1,1,588,1212,624
2096,0,0,11,0,-11
2097,1,0,3,0,-3
2098,1,0,268,0,-268
2099,0,0,83,0,-83
2100,1,1,176,1432,1256
2101,0,0,35,0,-35
2102,1,0,39,0,-39
2103,1,0,21,0,-21
2104,0,0,107,0,-107
2105,1,1,899,1409,510
2106,1,1,346,1833,1487
2107,0,0,67,0,-67
2108,1,1,793,1304,511
2109,1,1,731,1272,541
2110,1,1,336,1219,883
2111,1,0,12,0,-12
2112,0,0,21,0,-21
2113,0,0,59,0,-59
2114,0,0,87,0,-87
2115,0,0,51,0,-51
2116,1,0,15,0,-15
2117,1,0,52,0,-52
2118,1,0,36,0,-36
2119,0,0,72,0,-72
2120,0,0,73,0,-73
2121,0,0,1,0,-1
2122,0,0,57,0,-57
2123,1,1,668,1293,625
2124,1,1,72,1202,1130
2125,1,0,118,0,-118
2126,0,0,22,0,-22
2127,1,1,482,1257,775
2128,0,0,0,0,0
2129,1,0,12,0,-12
2130,0,0,219,0,-219
2131,0,0,44,0,-44
2132,1,1,463,1250,787
2133,1,0,26,0,-26
2134,1,0,60,0,-60
2135,1,1,668,1229,561
2136,0,0,92,0,-92
2137,1,0,12,0,-12
2138,1,0,8,0,-8
2139,1,1,1270,1353,83
2140,0,0,9,0,-9
2141,1,1,1013,1204,191
2142,0,0,18,0,-18
2143,1,0,35,0,-35
2144,0,0,2,0,-2
2145,0,0,36,0,-36
2146,0,0,144,0,-144
2147,0,0,52,0,-52
2148,0,0,40,0,-40
2149,1,1,418,1293,875
2150,0,0,60,0,-60
2151,1,0,50,0,-50
2152,0,0,4,0,-4
2153,1,0,140,0,-140
2154,0,0,138,0,-138
2155,0,0,13,0,-13
2156,1,0,101,0,-101
2157,1,0,0,0,0
2158,0,0,9,0,-9
2159,0,0,7,0,-7
2160,0,0,52,0,-52
2161,1,1,363,1284,921
2162,0,0,34,0,-34
2163,0,0,37,0,-37
2164,0,0,84,0,-84
2165,1,1,525,1317,792
2166,0,0,34,0,-34
2167,1,0,36,0,-36
2168,0,0,39,0,-39
2169,1,1,130,1624,1494
2170,0,0,25,0,-25
2171,0,0,24,0,-24
2172,1,1,978,2358,1380
2173,1,1,173,1350,1177
2174,0,0,4,0,-4
2175,1,0,200,0,-200
2176,0,0,48,0,-48
2177,0,0,85,0,-85
2178,1,1,27,2678,2651
2179,0,0,34,0,-34
2180,1,1,606,1266,660
2181,0,0,78,0,-78
2182,1,0,75,0,-75
2183,1,0,19,0,-19
2184,1,1,339,1223,884
2185,1,0,60,0,-60
2186,0,0,44,0,-44
2187,1,0,39,0,-39
2188,1,0,148,0,-148
2189,1,0,31,0,-31
2190,0,0,38,0,-38
2191,1,0,35,0,-35
2192,1,0,143,0,-143
2193,0,0,24,0,-24
2194,0,0,56,0,-56
2195,0,0,103,0,-103
2196,1,0,22,0,-22
2197,1,1,90,1200,1110
2198,0,0,13,0,-13
2199,0,0,1,0,-1
2200,0,0,16,0,-16
2201,0,0,35,0,-35
2202,1,1,643,1566,923
2203,1,1,215,1398,1183
2204,0,0,28,0,-28
2205,1,0,139,0,-139
2206,0,0,158,0,-158
2207,1,1,232,1202,970
2208,1,1,287,1807,1520
2209,0,0,78,0,-78
2210,0,0,12,0,-12
2211,1,1,359,1554,1195
2212,0,0,114,0,-114
2213,1,1,3879,1285,-2594
2214,1,0,10,0,-10
2215,0,0,41,0,-41
2216,0,0,21,0,-21
2217,1,1,1446,1222,-224
2218,0,0,36,0,-36
2219,1,0,16,0,-16
2220,1,1,278,1558,1280
2221,1,1,1430,1457,27
2222,1,0,38,0,-38
2223,1,1,1229,1311,82
2224,1,0,210,0,-210
2225,0,0,56,0,-56
2226,0,0,1,0,-1
2227,1,0,178,0,-178
2228,1,0,10,0,-10
2229,0,0,80,0,-80
2230,1,1,299,2468,2169
2231,0,0,6,0,-6
2232,1,0,30,0,-30
2233,1,1,207,1489,1282
2234,1,0,10,0,-10
2235,0,0,83,0,-83
2236,1,1,1268,1259,-9
2237,1,0,52,0,-52
2238,1,0,5,0,-5
2239,1,1,217,1205,988
2240,1,0,24,0,-24
2241,0,0,2,0,-2
2242,1,1,786,1267,481
2243,1,1,472,1225,753
2244,0,0,50,0,-50
2245,1,0,83,0,-83
2246,1,1,812,1400,588
2247,1,0,3,0,-3
2248,1,1,413,1280,867
2249,1,1,961,2073,1112
2250,0,0,8,0,-8
2251,1,1,179,1258,1079
2252,1,0,84,0,-84
2253,1,1,1039,1297,258
2254,0,0,18,0,-18
2255,1,0,17,0,-17
2256,0,0,18,0,-18
2257,0,0,60,0,-60
2258,0,0,18,0,-18
2259,1,0,72,0,-72
2260,0,0,38,0,-38
2261,1,1,531,1395,864
2262,1,0,81,0,-81
2263,0,0,77,0,-77
2264,1,0,177,0,-177
2265,1,0,56,0,-56
2266,1,1,1106,1393,287
2267,1,0,114,0,-114
2268,1,0,6,0,-6
2269,1,1,187,1932,1745
2270,0,0,89,0,-89
2271,0,0,14,0,-14
2272,1,1,1945,2004,59
2273,1,1,223,1277,1054
2274,0,0,68,0,-68
2275,1,0,2,0,-2
2276,1,0,0,0,0
2277,1,1,2601,1442,-1159
2278,0,0,31,0,-31
2279,0,0,32,0,-32
2280,0,0,29,0,-29
2281,1,0,137,0,-137
2282,0,0,64,0,-64
2283,0,0,34,0,-34
2284,0,0,2,0,-2
2285,1,0,59,0,-59
2286,1,1,1301,1374,73
2287,0,0,51,0,-51
2288,1,1,241,1235,994
2289,0,0,19,0,-19
2290,1,0,40,0,-40
2291,1,1,806,1915,1109
2292,1,0,21,0,-21
2293,0,0,17,0,-17
2294,0,0,56,0,-56
2295,0,0,85,0,-85
2296,0,0,92,0,-92
2297,1,0,72,0,-72
2298,1,0,47,0,-47
2299,1,0,46,0,-46
2300,0,0,0,0,0
2301,0,0,32,0,-32
2302,0,0,23,0,-23
2303,1,1,950,1311,361
2304,0,0,34,0,-34
2305,0,0,66,0,-66
2306,0,0,37,0,-37
2307,0,0,6,0,-6
2308,1,1,329,1796,1467
2309,1,0,22,0,-22
2310,1,1,821,1269,448
2311,1,1,233,2061,1828
2312,1,1,406,1305,899
2313,1,0,17,0,-17
2314,1,1,95,1520,1425
2315,0,0,75,0,-75
2316,1,0,21,0,-21
2317,1,1,101,1379,1278
2318,0,0,34,0,-34
2319,1,0,20,0,-20
2320,1,1,487,1206,719
2321,1,0,11,0,-11
2322,1,1,439,1553,1114
2323,1,1,136,1391,1255
2324,1,1,203,1858,1655
2325,0,0,17,0,-17
2326,0,0,37,0,-37
2327,1,0,7,0,-7
2328,1,0,33,0,-33
2329,1,1,1009,2323,1314
2330,0,0,2,0,-2
2331,1,0,6,0,-6
2332,0,0,157,0,-157
2333,1,1,208,1457,1249
2334,1,1,212,1666,1454
2335,0,0,5,0,-5
2336,1,0,11,0,-11
2337,0,0,61,0,-61
2338,0,0,27,0,-27
2339,0,0,44,0,-44
2340,1,0,50,0,-50
2341,0,0,24,0,-24
2342,0,0,74,0,-74
2343,1,0,2,0,-2
2344,0,0,11,0,-11
2345,1,0,54,0,-54
2346,0,0,140,0,-140
2347,1,1,113,1489,1376
2348,1,1,239,1241,1002
2349,0,0,12,0,-12
2350,0,0,23,0,-23
2351,1,1,127,1509,1382
2352,1,1,593,4295,3702
2353,1,1,574,2083,1509
2354,1,0,78,0,-78
2355,1,1,392,1485,1093
2356,0,0,83,0,-83
2357,0,0,92,0,-92
2358,1,1,65,1244,1179
2359,0,0,89,0,-89
2360,1,0,48,0,-48
2361,1,0,12,0,-12
2362,1,1,552,1239,687
2363,0,0,27,0,-27
2364,1,1,225,1948,1723
2365,0,0,23,0,-23
2366,0,0,18,0,-18
2367,1,0,131,0,-131
2368,1,0,89,0,-89
2369,1,1,858,2573,1715
2370,0,0,35,0,-35
2371,1,1,866,1202,336
2372,1,0,1,0,-1
2373,1,1,376,1238,862
2374,0,0,1,0,-1
2375,0,0,24,0,-24
2376,1,0,78,0,-78
2377,0,0,29,0,-29
2378,1,1,1805,1228,-577
2379,1,1,1406,1756,350
2380,0,0,9,0,-9
2381,1,0,115,0,-115
2382,0,0,161,0,-161
2383,1,1,343,1555,1212
2384,0,0,14,0,-14
2385,1,0,1,0,-1
2386,1,0,1,0,-1
2387,0,0,41,0,-41
2388,1,1,1504,1610,106
2389,1,1,599,1232,633
2390,1,1,1417,1504,87
2391,0,0,32,0,-32
2392,1,0,24,0,-24
2393,0,0,52,0,-52
2394,1,1,250,1268,1018
2395,1,1,367,1539,1172
2396,0,0,94,0,-94
2397,0,0,24,0,-24
2398,1,1,1030,2639,1609
2399,1,1,722,1329,607
2400,0,0,6,0,-6
2401,0,0,14,0,-14
2402,1,0,206,0,-206
2403,0,0,12,0,-12
2404,1,0,2,0,-2
2405,0,0,4,0,-4
2406,0,0,64,0,-64
2407,1,1,141,2510,2369
2408,0,0,25,0,-25
2409,1,1,1582,2333,751
2410,0,0,36,0,-36
2411,0,0,9,0,-9
2412,1,0,106,0,-106
2413,1,1,1443,1738,295
2414,1,0,62,0,-62
2415,1,0,1,0,-1
2416,0,0,2,0,-2
2417,1,0,40,0,-40
2418,1,1,391,1419,1028
2419,0,0,3,0,-3
2420,0,0,51,0,-51
2421,1,0,61,0,-61
2422,1,1,1221,1439,218
2423,1,0,72,0,-72
2424,1,0,22,0,-22
2425,1,0,12,0,-12
2426,1,0,61,0,-61
2427,1,1,179,2289,2110
2428,1,1,962,1265,303
2429,1,1,1017,1934,917
2430,0,0,1,0,-1
2431,0,0,66,0,-66
2432,1,0,31,0,-31
2433,1,1,195,1857,1662
2434,1,0,7,0,-7
2435,0,0,14,0,-14
2436,1,1,433,1206,773
2437,1,0,59,0,-59
2438,0,0,9,0,-9
2439,1,0,19,0,-19
2440,0,0,36,0,-36
2441,1,1,549,1201,652
2442,1,0,11,0,-11
2443,0,0,63,0,-63
2444,1,1,70,1473,1403
2445,1,1,345,1258,913
2446,1,0,32,0,-32
2447,1,1,197,1375,1178
2448,0,0,167,0,-167
2449,1,1,2995,2120,-875
2450,1,0,33,0,-33
2451,1,1,642,1383,741
2452,0,0,98,0,-98
2453,1,1,164,1235,1071
2454,0,0,5,0,-5
2455,1,0,5,0,-5
2456,0,0,14,0,-14
2457,0,0,11,0,-11
2458,0,0,99,0,-99
2459,0,0,50,0,-50
2460,0,0,22,0,-22
2461,1,0,28,0,-28
2462,1,0,16,0,-16
2463,0,0,21,0,-21
2464,1,0,45,0,-45
2465,0,0,46,0,-46
2466,0,0,30,0,-30
2467,1,1,133,1368,1235
2468,0,0,11,0,-11
2469,1,0,49,0,-49
2470,0,0,19,0,-19
2471,1,0,8,0,-8
2472,0,0,26,0,-26
2473,1,0,18,0,-18
2474,1,0,2,0,-2
2475,1,1,209,1611,1402
2476,1,1,308,1644,1336
2477,1,1,34,1322,1288
2478,1,1,314,1207,893
2479,1,0,31,0,-31
2480,0,0,13,0,-13
2481,1,1,325,1360,1035
2482,0,0,43,0,-43
2483,1,0,59,0,-59
2484,0,0,0,0,0
2485,1,0,57,0,-57
2486,1,1,281,1611,1330
2487,0,0,42,0,-42
2488,1,0,63,0,-63
2489,1,0,39,0,-39
2490,1,0,35,0,-35
2491,0,0,75,0,-75
2492,1,1,193,1301,1108
2493,1,1,800,1675,875
2494,0,0,1,0,-1
2495,1,1,397,1545,1148
2496,1,1,602,2527,1925
2497,1,1,240,1291,1051
2498,1,1,577,1585,1008
2499,1,1,323,2195,1872
2500,1,1,495,1679,1184
2501,0,0,195,0,-195
2502,1,0,70,0,-70
2503,0,0,70,0,-70
2504,1,0,34,0,-34
2505,0,0,70,0,-70
2506,1,1,85,1458,1373
2507,1,1,116,2513,2397
2508,1,0,211,0,-211
2509,0,0,21,0,-21
2510,1,0,64,0,-64
2511,0,0,59,0,-59
2512,0,0,8,0,-8
2513,1,1,58,1589,1531
2514,0,0,46,0,-46
2515,1,1,212,2276,2064
2516,1,1,1695,1649,-46
2517,0,0,35,0,-35
2518,0,0,79,0,-79
2519,1,1,697,1566,869
2520,1,0,4,0,-4
2521,1,1,1579,1327,-252
2522,1,0,29,0,-29
2523,1,1,1088,1203,115
2524,1,1,274,1276,1002
2525,0,0,51,0,-51
2526,1,1,101,1665,1564
2527,0,0,15,0,-15
2528,1,1,119,1307,1188
2529,1,0,105,0,-105
2530,1,0,12,0,-12
2531,0,0,33,0,-33
2532,0,0,96,0,-96
2533,1,1,990,1254,264
2534,0,0,0,0,0
2535,1,1,488,1270,782
2536,0,0,163,0,-163
2537,0,0,35,0,-35
2538,0,0,52,0,-52
2539,0,0,26,0,-26
2540,1,1,198,1220,1022
2541,0,0,119,0,-119
2542,1,1,447,1291,844
2543,1,1,1416,1480,64
2544,0,0,49,0,-49
2545,1,0,93,0,-93
2546,1,0,98,0,-98
2547,1,1,164,1976,1812
2548,1,1,1203,2123,920
2549,1,1,452,1338,886
2550,1,1,62,1347,1285
2551,0,0,12,0,-12
2552,1,0,35,0,-35
2553,1,0,62,0,-62
2554,1,1,270,1285,1015
2555,0,0,60,0,-60
2556,1,0,21,0,-21
2557,1,1,935,1577,642
2558,0,0,29,0,-29
2559,0,0,2,0,-2
2560,0,0,74,0,-74
2561,1,1,215,1203,988
2562,1,0,3,0,-3
2563,0,0,7,0,-7
2564,0,0,82,0,-82
2565,1,1,394,1227,833
2566,0,0,56,0,-56
2567,1,1,843,1425,582
2568,0,0,10,0,-10
2569,0,0,15,0,-15
2570,0,0,7,0,-7
2571,1,0,33,0,-33
2572,1,0,34,0,-34
2573,0,0,20,0,-20
2574,0,0,76,0,-76
2575,0,0,45,0,-45
2576,1,0,13,0,-13
2577,0,0,54,0,-54
2578,0,0,10,0,-10
2579,0,0,30,0,-30
2580,1,1,625,1242,617
2581,1,0,99,0,-99
2582,1,0,12,0,-12
2583,0,0,126,0,-126
2584,0,0,20,0,-20
2585,1,1,1916,1232,-684
2586,1,0,58,0,-58
2587,1,1,1067,1391,324
2588,0,0,207,0,-207
2589,1,0,10,0,-10
2590,1,0,43,0,-43
2591,1,0,81,0,-81
2592,0,0,0,0,0
2593,0,0,31,0,-31
2594,0,0,27,0,-27
2595,1,0,15,0,-15
2596,0,0,23,0,-23
2597,0,0,10,0,-10
2598,1,0,37,0,-37
2599,1,0,44,0,-44
2600,0,0,32,0,-32
2601,1,0,225,0,-225
2602,1,0,171,0,-171
2603,1,0,15,0,-15
2604,0,0,24,0,-24
2605,1,1,1001,1225,224
2606,0,0,5,0,-5
2607,1,0,36,0,-36
2608,0,0,3,0,-3
2609,1,1,251,1231,980
2610,1,1,1052,1390,338
2611,1,0,74,0,-74
2612,0,0,59,0,-59
2613,0,0,8,0,-8
2614,1,1,291,1304,1013
2615,1,0,7,0,-7
2616,0,0,247,0,-247
2617,1,1,2346,2280,-66
2618,1,0,237,0,-237
2619,1,0,79,0,-79
2620,1,1,442,1218,776
2621,1,1,538,1216,678
2622,0,0,11,0,-11
2623,0,0,9,0,-9
2624,0,0,23,0,-23
2625,0,0,45,0,-45
2626,1,1,614,1471,857
2627,1,0,41,0,-41
2628,1,0,8,0,-8
2629,0,0,1,0,-1
2630,0,0,28,0,-28
2631,0,0,19,0,-19
2632,0,0,4,0,-4
2633,0,0,25,0,-25
2634,1,1,598,1291,693
2635,1,1,260,1474,1214
2636,0,0,0,0,0
2637,0,0,60,0,-60
2638,0,0,7,0,-7
2639,1,0,25,0,-25
2640,0,0,58,0,-58
2641,1,1,564,1860,1296
2642,1,0,116,0,-116
2643,1,1,970,2263,1293
2644,0,0,14,0,-14
2645,1,1,385,1328,943
2646,1,0,31,0,-31
2647,0,0,37,0,-37
2648,0,0,30,0,-30
2649,0,0,12,0,-12
2650,1,1,1076,1281,205
2651,1,0,95,0,-95
2652,1,0,8,0,-8
2653,1,1,737,2076,1339
2654,1,0,29,0,-29
2655,1,0,35,0,-35
2656,1,0,67,0,-67
2657,0,0,81,0,-81
2658,1,0,91,0,-91
2659,1,1,199,1280,1081
2660,0,0,40,0,-40
2661,1,0,30,0,-30
2662,1,0,24,0,-24
2663,0,0,9,0,-9
2664,1,0,10,0,-10
2665,1,0,68,0,-68
2666,0,0,6,0,-6
2667,0,0,27,0,-27
2668,0,0,57,0,-57
2669,0,0,61,0,-61
2670,1,0,11,0,-11
2671,0,0,46,0,-46
2672,0,0,51,0,-51
2673,1,1,175,1214,1039
2674,0,0,17,0,-17
2675,0,0,36,0,-36
2676,1,1,776,1682,906
2677,1,1,105,1294,1189
2678,0,0,26,0,-26
2679,0,0,71,0,-71
2680,0,0,45,0,-45
2681,0,0,65,0,-65
2682,0,0,39,0,-39
2683,1,0,3,0,-3
2684,1,0,2,0,-2
2685,0,0,3,0,-3
2686,1,0,30,0,-30
2687,0,0,123,0,-123
2688,1,0,28,0,-28
2689,1,1,657,1259,602
2690,1,0,40,0,-40
2691,0,0,87,0,-87
2692,1,0,38,0,-38
2693,0,0,5,0,-5
2694,1,0,97,0,-97
2695,0,0,63,0,-63
2696,0,0,55,0,-55
2697,1,1,165,1270,1105
2698,1,0,16,0,-16
2699,0,0,33,0,-33
2700,1,0,124,0,-124
2701,0,0,10,0,-10
2702,1,1,139,1240,1101
2703,1,0,192,0,-192
2704,0,0,24,0,-24
2705,1,0,209,0,-209
2706,1,0,9,0,-9
2707,1,0,124,0,-124
2708,0,0,18,0,-18
2709,1,0,4,0,-4
2710,1,0,7,0,-7
2711,0,0,106,0,-106
2712,0,0,30,0,-30
2713,0,0,91,0,-91
2714,1,0,11,0,-11
2715,1,1,684,1482,798
2716,0,0,28,0,-28
2717,1,1,211,1566,1355
2718,0,0,3,0,-3
2719,1,0,35,0,-35
2720,1,1,207,2198,1991
2721,0,0,1,0,-1
2722,1,0,41,0,-41
2723,0,0,74,0,-74
2724,1,0,25,0,-25
2725,0,0,25,0,-25
2726,0,0,32,0,-32
2727,1,0,32,0,-32
2728,0,0,19,0,-19
2729,1,0,31,0,-31
2730,0,0,38,0,-38
2731,1,0,125,0,-125
2732,1,0,18,0,-18
2733,0,0,82,0,-82
2734,1,0,150,0,-150
2735,1,0,36,0,-36
2736,1,1,424,1275,851
2737,1,0,33,0,-33
2738,0,0,128,0,-128
2739,1,0,68,0,-68
2740,1,0,25,0,-25
2741,0,0,186,0,-186
2742,1,1,419,1226,807
2743,0,0,1,0,-1
2744,0,0,146,0,-146
2745,1,1,122,1692,1570
2746,1,0,21,0,-21
2747,1,1,647,1299,652
2748,0,0,194,0,-194
2749,0,0,20,0,-20
2750,1,1,285,1364,1079
2751,0,0,99,0,-99
2752,0,0,27,0,-27
2753,0,0,7,0,-7
2754,1,0,115,0,-115
2755,1,0,59,0,-59
2756,1,0,22,0,-22
2757,0,0,34,0,-34
2758,0,0,1,0,-1
2759,0,0,74,0,-74
2760,0,0,125,0,-125
2761,0,0,14,0,-14
2762,1,1,679,1553,874
2763,1,1,335,1205,870
2764,1,0,36,0,-36
2765,1,0,166,0,-166
2766,1,0,50,0,-50
2767,1,0,51,0,-51
2768,0,0,13,0,-13
2769,1,0,5,0,-5
2770,1,1,319,1233,914
2771,1,0,118,0,-118
2772,0,0,70,0,-70
2773,1,1,241,2711,2470
2774,1,1,1017,1359,342
2775,0,0,8,0,-8
2776,1,0,17,0,-17
2777,1,1,103,1306,1203
2778,0,0,28,0,-28
2779,1,0,14,0,-14
2780,0,0,33,0,-33
2781,1,0,25,0,-25
2782,1,1,538,1524,986
2783,1,1,441,1259,818
2784,1,0,20,0,-20
2785,0,0,119,0,-119
2786,0,0,76,0,-76
2787,1,1,204,1286,1082
2788,1,1,197,1802,1605
2789,0,0,17,0,-17
2790,1,0,123,0,-123
2791,1,0,13,0,-13
2792,0,0,23,0,-23
2793,0,0,25,0,-25
2794,0,0,55,0,-55
2795,1,0,23,0,-23
2796,0,0,141,0,-141
2797,1,1,144,1503,1359
2798,1,0,10,0,-10
2799,0,0,23,0,-23
2800,1,1,75,1379,1304
2801,1,0,150,0,-150
2802,1,0,0,0,0
2803,1,0,88,0,-88
2804,0,0,18,0,-18
2805,0,0,59,0,-59
2806,1,0,13,0,-13
2807,1,0,13,0,-13
2808,1,0,6,0,-6
2809,0,0,20,0,-20
2810,0,0,7,0,-7
2811,1,0,32,0,-32
2812,1,1,124,1593,1469
2813,0,0,54,0,-54
2814,1,0,15,0,-15
2815,0,0,33,0,-33
2816,0,0,8,0,-8
2817,1,0,129,0,-129
2818,0,0,74,0,-74
2819,1,1,977,1623,646
2820,0,0,20,0,-20
2821,0,0,44,0,-44
2822,0,0,19,0,-19
2823,1,1,259,1265,1006
2824,0,0,24,0,-24
2825,0,0,122,0,-122
2826,0,0,144,0,-144
2827,0,0,62,0,-62
2828,0,0,12,0,-12
2829,0,0,8,0,-8
2830,1,1,1640,1491,-149
2831,1,1,29,1460,1431
2832,1,0,59,0,-59
2833,1,0,44,0,-44
2834,0,0,23,0,-23
2835,0,0,48,0,-48
2836,0,0,10,0,-10
2837,1,0,11,0,-11
2838,1,0,78,0,-78
2839,0,0,1,0,-1
2840,1,0,113,0,-113
2841,1,0,50,0,-50
2842,1,1,1238,1302,64
2843,1,1,456,1576,1120
2844,1,1,97,1277,1180
2845,1,0,21,0,-21
2846,1,0,42,0,-42
2847,1,0,1,0,-1
2848,0,0,162,0,-162
2849,0,0,78,0,-78
2850,0,0,17,0,-17
2851,1,1,301,1319,1018
2852,0,0,24,0,-24
2853,1,1,2031,1257,-774
2854,1,0,132,0,-132
2855,1,0,12,0,-12
2856,1,0,60,0,-60
2857,1,0,34,0,-34
2858,0,0,36,0,-36
2859,0,0,44,0,-44
2860,0,0,9,0,-9
2861,1,1,316,1435,1119
2862,0,0,19,0,-19
2863,1,0,139,0,-139
2864,1,0,12,0,-12
2865,0,0,180,0,-180
2866,0,0,86,0,-86
2867,1,1,1240,1379,139
2868,1,0,53,0,-53
2869,0,0,84,0,-84
2870,1,0,26,0,-26
2871,0,0,154,0,-154
2872,0,0,9,0,-9
2873,1,1,616,1347,731
2874,0,0,9,0,-9
2875,1,1,268,1694,1426
2876,0,0,11,0,-11
2877,0,0,10,0,-10
2878,1,1,157,2036,1879
2879,0,0,75,0,-75
2880,1,1,293,1454,1161
2881,1,1,163,1248,1085
2882,1,0,30,0,-30
2883,0,0,21,0,-21
2884,1,0,11,0,-11
2885,0,0,70,0,-70
2886,1,0,47,0,-47
2887,0,0,46,0,-46
2888,0,0,27,0,-27
2889,1,1,2274,2044,-230
2890,1,1,1667,1277,-390
2891,0,0,56,0,-56
2892,1,0,17,0,-17
2893,0,0,52,0,-52
2894,1,0,45,0,-45
2895,1,0,41,0,-41
2896,1,0,34,0,-34
2897,1,0,2,0,-2
2898,1,0,3,0,-3
2899,0,0,51,0,-51
2900,0,0,56,0,-56
2901,1,1,95,1398,1303
2902,1,1,183,2423,2240
2903,1,1,869,1312,443
2904,0,0,3,0,-3
2905,0,0,146,0,-146
2906,0,0,30,0,-30
2907,1,1,694,1258,564
2908,1,0,12,0,-12
2909,1,0,2,0,-2
2910,1,1,73,1273,1200
2911,0,0,115,0,-115
2912,1,0,5,0,-5
2913,1,0,63,0,-63
2914,0,0,78,0,-78
2915,1,1,341,1304,963
2916,0,0,50,0,-50
2917,0,0,3,0,-3
2918,1,0,301,0,-301
2919,0,0,39,0,-39
2920,1,0,30,0,-30
2921,1,1,986,1252,266
2922,1,0,6,0,-6
2923,0,0,195,0,-195
2924,0,0,66,0,-66
2925,0,0,22,0,-22
2926,1,0,42,0,-42
2927,1,0,195,0,-195
2928,1,0,83,0,-83
2929,1,0,15,0,-15
2930,0,0,54,0,-54
2931,0,0,23,0,-23
2932,1,1,98,1362,1264
2933,1,0,8,0,-8
2934,1,0,29,0,-29
2935,0,0,2,0,-2
2936,1,1,314,2292,1978
2937,0,0,27,0,-27
2938,1,0,41,0,-41
2939,0,0,5,0,-5
2940,0,0,15,0,-15
2941,0,0,61,0,-61
2942,0,0,7,0,-7
2943,0,0,149,0,-149
2944,0,0,225,0,-225
2945,1,0,135,0,-135
2946,1,0,70,0,-70
2947,1,1,247,1235,988
2948,1,0,72,0,-72
2949,0,0,19,0,-19
2950,1,1,2921,1456,-1465
2951,1,0,18,0,-18
2952,0,0,113,0,-113
2953,0,0,6,0,-6
2954,1,1,784,1244,460
2955,0,0,61,0,-61
2956,0,0,11,0,-11
2957,1,0,117,0,-117
2958,1,1,404,1207,803
2959,1,1,58,1234,1176
2960,0,0,7,0,-7
2961,1,0,33,0,-33
2962,1,1,344,1236,892
2963,1,1,250,1897,1647
2964,1,1,157,1296,1139
2965,0,0,99,0,-99
2966,1,1,699,1201,502
2967,1,1,824,1222,398
2968,1,1,206,1378,1172
2969,0,0,58,0,-58
2970,0,0,9,0,-9
2971,1,1,40,1337,1297
2972,0,0,39,0,-39
2973,0,0,36,0,-36
2974,1,1,133,1452,1319
2975,0,0,50,0,-50
2976,1,1,262,1579,1317
2977,0,0,126,0,-126
2978,0,0,21,0,-21
2979,0,0,27,0,-27
2980,1,0,1,0,-1
2981,0,0,26,0,-26
2982,0,0,19,0,-19
2983,0,0,80,0,-80
2984,0,0,197,0,-197
2985,1,1,54,1387,1333
2986,0,0,92,0,-92
2987,0,0,17,0,-17
2988,0,0,49,0,-49
2989,1,1,562,2063,1501
2990,1,1,582,1516,934
2991,0,0,53,0,-53
2992,1,1,277,1244,967
2993,1,1,177,1238,1061
2994,1,1,222,2331,2109
2995,1,0,48,0,-48
2996,1,1,30,1594,1564
2997,1,0,247,0,-247
2998,1,0,29,0,-29
2999,1,1,279,1727,1448
3000,1,1,83,1212,1129
3001,1,1,875,1628,753
3002,1,0,4,0,-4
3003,1,0,148,0,-148
3004,0,0,92,0,-92
3005,0,0,27,0,-27
3006,0,0,168,0,-168
3007,1,1,1600,1813,213
3008,1,1,563,1487,924
3009,1,1,394,1268,874
3010,1,1,1008,1768,760
3011,0,0,26,0,-26
3012,1,1,258,2014,1756
3013,0,0,8,0,-8
3014,1,0,7,0,-7
3015,1,0,77,0,-77
3016,1,1,648,2784,2136
3017,0,0,124,0,-124
3018,1,0,21,0,-21
3019,1,1,279,1219,940
3020,0,0,48,0,-48
3021,0,0,16,0,-16
3022,1,0,52,0,-52
3023,1,1,1957,1429,-528
3024,1,0,153,0,-153
3025,1,0,9,0,-9
3026,0,0,65,0,-65
3027,1,0,174,0,-174
3028,0,0,31,0,-31
3029,1,0,44,0,-44
3030,0,0,32,0,-32
3031,0,0,7,0,-7
3032,1,0,9,0,-9
3033,1,0,98,0,-98
3034,1,0,4,0,-4
3035,1,1,766,1301,535
3036,1,1,695,2229,1534
3037,1,1,1187,1236,49
3038,0,0,64,0,-64
3039,0,0,37,0,-37
3040,1,0,102,0,-102
3041,1,1,455,1436,981
3042,0,0,44,0,-44
3043,1,1,75,1275,1200
3044,0,0,28,0,-28
3045,0,0,40,0,-40
3046,0,0,29,0,-29
3047,1,0,51,0,-51
3048,1,1,558,1265,707
3049,0,0,20,0,-20
3050,1,1,1242,1248,6
3051,1,1,59,2159,2100
3052,1,1,2114,1212,-902
3053,0,0,41,0,-41
3054,1,1,240,1276,1036
3055,1,0,0,0,0
3056,0,0,43,0,-43
3057,0,0,6,0,-6
3058,0,0,44,0,-44
3059,1,0,22,0,-22
3060,1,1,363,1643,1280
3061,1,1,474,1463,989
3062,1,0,8,0,-8
3063,1,1,754,1645,891
3064,1,1,149,1451,1302
3065,0,0,58,0,-58
3066,1,1,97,1481,1384
3067,1,0,116,0,-116
3068,1,0,21,0,-21
3069,1,0,13,0,-13
3070,1,0,2,0,-2
3071,0,0,95,0,-95
3072,1,0,71,0,-71
3073,0,0,16,0,-16
3074,1,1,431,1243,812
3075,1,0,10,0,-10
3076,1,1,110,1364,1254
3077,1,1,611,1765,1154
3078,0,0,70,0,-70
3079,0,0,23,0,-23
3080,1,1,247,1728,1481
3081,1,0,15,0,-15
3082,1,1,291,1385,1094
3083,0,0,67,0,-67
3084,0,0,97,0,-97
3085,0,0,22,0,-22
3086,1,0,87,0,-87
3087,1,1,279,2538,2259
3088,0,0,26,0,-26
3089,0,0,0,0,0
3090,1,0,13,0,-13
3091,1,0,49,0,-49
3092,0,0,50,0,-50
3093,1,0,85,0,-85
3094,1,0,84,0,-84
3095,0,0,118,0,-118
3096,0,0,114,0,-114
3097,0,0,4,0,-4
3098,0,0,18,0,-18
3099,0,0,51,0,-51
3100,1,1,369,1388,1019
3101,0,0,105,0,-105
3102,1,0,14,0,-14
3103,0,0,9,0,-9
3104,1,1,412,1566,1154
3105,0,0,24,0,-24
3106,1,0,27,0,-27
3107,1,0,31,0,-31
3108,0,0,21,0,-21
3109,0,0,108,0,-108
3110,0,0,10,0,-10
3111,1,1,60,1400,1340
3112,1,1,711,1511,800
3113,1,1,184,1671,1487
3114,1,0,42,0,-42
3115,0,0,67,0,-67
3116,1,1,320,1509,1189
3117,0,0,107,0,-107
3118,0,0,10,0,-10
3119,0,0,16,0,-16
3120,1,0,90,0,-90
3121,1,0,1,0,-1
3122,1,1,358,2180,1822
3123,1,1,307,1248,941
3124,1,0,31,0,-31
3125,0,0,104,0,-104
3126,1,1,856,1526,670
3127,1,0,149,0,-149
3128,1,1,61,2223,2162
3129,1,1,239,1256,1017
3130,1,0,26,0,-26
3131,1,1,423,1430,1007
3132,1,0,62,0,-62
3133,1,0,45,0,-45
3134,1,1,576,1442,866
3135,0,0,355,0,-355
3136,0,0,89,0,-89
3137,0,0,34,0,-34
3138,0,0,16,0,-16
3139,0,0,121,0,-121
3140,0,0,6,0,-6
3141,1,1,524,1268,744
3142,0,0,1,0,-1
3143,1,1,146,1338,1192
3144,1,0,81,0,-81
3145,1,1,535,1866,1331
3146,0,0,90,0,-90
3147,0,0,66,0,-66
3148,1,0,32,0,-32
3149,1,1,230,1566,1336
3150,1,0,25,0,-25
3151,0,0,39,0,-39
3152,1,0,38,0,-38
3153,1,1,172,1205,1033
3154,0,0,69,0,-69
3155,1,1,154,1331,1177
3156,0,0,104,0,-104
3157,1,1,85,1338,1253
3158,1,0,3,0,-3
3159,0,0,10,0,-10
3160,1,1,1022,1382,360
3161,0,0,83,0,-83
3162,1,1,95,1292,1197
3163,0,0,63,0,-63
3164,1,0,40,0,-40
3165,1,0,30,0,-30
3166,0,0,81,0,-81
3167,0,0,149,0,-149
3168,1,1,428,1209,781
3169,0,0,37,0,-37
3170,1,1,346,1332,986
3171,0,0,86,0,-86
3172,0,0,16,0,-16
3173,1,1,105,1465,1360
3174,1,1,53,1287,1234
3175,0,0,122,0,-122
3176,1,0,0,0,0
3177,1,0,37,0,-37
3178,1,1,543,2256,1713
3179,1,1,340,1266,926
3180,0,0,20,0,-20
3181,1,0,145,0,-145
3182,0,0,57,0,-57
3183,1,1,1038,1455,417
3184,0,0,51,0,-51
3185,0,0,7,0,-7
3186,1,1,408,1434,1026
3187,0,0,48,0,-48
3188,1,1,234,2119,1885
3189,1,0,3,0,-3
3190,0,0,123,0,-123
3191,1,0,0,0,0
3192,1,0,43,0,-43
3193,0,0,31,0,-31
3194,0,0,19,0,-19
3195,1,1,423,1300,877
3196,1,0,33,0,-33
3197,0,0,5,0,-5
3198,1,0,6,0,-6
3199,1,0,48,0,-48
3200,1,0,27,0,-27
3201,1,1,1000,1846,846
3202,0,0,11,0,-11
3203,1,0,22,0,-22
3204,0,0,89,0,-89
3205,1,1,70,1755,1685
3206,1,0,17,0,-17
3207,1,0,111,0,-111
3208,1,0,29,0,-29
3209,0,0,96,0,-96
3210,1,0,30,0,-30
3211,1,1,143,3471,3328
3212,1,0,33,0,-33
3213,1,1,752,1666,914
3214,1,1,806,1289,483
3215,0,0,9,0,-9
3216,1,1,206,1318,1112
3217,1,0,14,0,-14
3218,0,0,60,0,-60
3219,1,0,178,0,-178
3220,0,0,13,0,-13
3221,1,1,647,1429,782
3222,1,0,6,0,-6
3223,1,0,65,0,-65
3224,0,0,115,0,-115
3225,1,0,13,0,-13
3226,0,0,113,0,-113
3227,1,0,48,0,-48
3228,1,0,41,0,-41
3229,1,0,5,0,-5
3230,1,0,21,0,-21
3231,1,0,54,0,-54
3232,1,0,10,0,-10
3233,0,0,3,0,-3
3234,1,1,724,1348,624
3235,1,1,101,1736,1635
3236,1,1,2258,1493,-765
3237,1,0,13,0,-13
3238,0,0,69,0,-69
3239,1,1,348,1264,916
3240,1,1,577,1217,640
3241,1,0,1,0,-1
3242,0,0,0,0,0
3243,0,0,3,0,-3
3244,1,1,180,1809,1629
3245,0,0,3,0,-3
3246,1,0,16,0,-16
3247,0,0,52,0,-52
3248,1,1,89,1311,1222
3249,1,1,1312,1212,-100
3250,0,0,50,0,-50
3251,1,0,44,0,-44
3252,1,1,252,1375,1123
3253,0,0,17,0,-17
3254,1,0,56,0,-56
3255,0,0,36,0,-36
3256,1,0,3,0,-3
3257,1,0,2,0,-2
3258,1,1,134,1609,1475
3259,1,0,1,0,-1
3260,0,0,55,0,-55
3261,0,0,21,0,-21
3262,1,1,288,1986,1698
3263,0,0,57,0,-57
3264,0,0,131,0,-131
3265,1,1,338,1954,1616
3266,0,0,79,0,-79
3267,1,1,1495,1262,-233
3268,1,1,129,1451,1322
3269,0,0,50,0,-50
3270,1,0,53,0,-53
3271,0,0,37,0,-37
3272,1,0,16,0,-16
3273,0,0,57,0,-57
3274,0,0,15,0,-15
3275,1,1,473,2068,1595
3276,1,0,31,0,-31
3277,1,1,355,1405,1050
3278,0,0,99,0,-99
3279,0,0,174,0,-174
3280,1,1,206,2095,1889
3281,0,0,11,0,-11
3282,0,0,33,0,-33
3283,1,0,51,0,-51
3284,1,1,148,1213,1065
3285,0,0,61,0,-61
3286,1,1,170,1553,1383
3287,0,0,13,0,-13
3288,1,1,394,1677,1283
3289,0,0,41,0,-41
3290,1,1,151,2447,2296
3291,1,1,565,2094,1529
3292,1,1,423,1415,992
3293,1,1,173,1322,1149
3294,1,1,856,1487,631
3295,1,0,10,0,-10
3296,0,0,68,0,-68
3297,1,0,88,0,-88
3298,0,0,48,0,-48
3299,0,0,9,0,-9
3300,0,0,16,0,-16
3301,0,0,137,0,-137
3302,0,0,64,0,-64
3303,0,0,52,0,-52
3304,1,0,13,0,-13
3305,1,0,60,0,-60
3306,0,0,30,0,-30
3307,1,0,57,0,-57
3308,1,0,170,0,-170
3309,0,0,11,0,-11
3310,0,0,18,0,-18
3311,0,0,3,0,-3
3312,1,1,1288,1261,-27
3313,1,1,537,1521,984
3314,1,1,256,1348,1092
3315,1,1,1082,1561,479
3316,0,0,58,0,-58
3317,0,0,11,0,-11
3318,1,1,410,1378,968
3319,1,0,76,0,-76
3320,1,0,78,0,-78
3321,0,0,54,0,-54
3322,1,1,57,1985,1928
3323,1,1,2675,1498,-1177
3324,1,1,143,2230,2087
3325,0,0,111,0,-111
3326,1,0,38,0,-38
3327,0,0,4,0,-4
3328,0,0,8,0,-8
3329,1,0,27,0,-27
3330,1,0,75,0,-75
3331,1,1,271,1830,1559
3332,0,0,68,0,-68
3333,1,0,33,0,-33
3334,0,0,50,0,-50
3335,0,0,46,0,-46
3336,0,0,136,0,-136
3337,1,0,37,0,-37
3338,1,1,626,1228,602
3339,0,0,59,0,-59
3340,0,0,76,0,-76
3341,0,0,37,0,-37
3342,1,1,1369,1387,18
3343,0,0,46,0,-46
3344,1,0,27,0,-27
3345,0,0,14,0,-14
3346,0,0,90,0,-90
3347,0,0,81,0,-81
3348,0,0,86,0,-86
3349,0,0,4,0,-4
3350,1,0,74,0,-74
3351,0,0,18,0,-18
3352,1,1,83,1998,1915
3353,0,0,80,0,-80
3354,1,0,133,0,-133
3355,1,0,5,0,-5
3356,0,0,43,0,-43
3357,1,0,4,0,-4
3358,0,0,59,0,-59
3359,1,1,788,1300,512
3360,0,0,6,0,-6
3361,1,0,39,0,-39
3362,1,1,1807,1604,-203
3363,0,0,11,0,-11
3364,1,0,29,0,-29
3365,0,0,2,0,-2
3366,1,1,819,1280,461
3367,0,0,28,0,-28
3368,1,1,2014,1267,-747
3369,1,0,71,0,-71
3370,1,1,900,1267,367
3371,1,1,218,1271,1053
3372,1,1,1259,2773,1514
3373,1,1,595,1201,606
3374,0,0,29,0,-29
3375,1,1,176,1300,1124
3376,1,0,79,0,-79
3377,1,1,2834,1498,-1336
3378,0,0,71,0,-71
3379,1,0,9,0,-9
3380,0,0,65,0,-65
3381,0,0,84,0,-84
3382,0,0,307,0,-307
3383,0,0,175,0,-175
3384,0,0,1,0,-1
3385,1,1,123,1222,1099
3386,0,0,31,0,-31
3387,0,0,132,0,-132
3388,0,0,58,0,-58
3389,1,1,115,1277,1162
3390,0,0,103,0,-103
3391,1,1,25,1203,1178
3392,1,0,119,0,-119
3393,1,0,2,0,-2
3394,0,0,12,0,-12
3395,0,0,112,0,-112
3396,0,0,22,0,-22
3397,1,1,189,1502,1313
3398,1,0,0,0,0
3399,0,0,0,0,0
3400,1,1,1162,1372,210
3401,1,0,21,0,-21
3402,1,1,925,2622,1697
3403,0,0,0,0,0
3404,1,0,79,0,-79
3405,0,0,69,0,-69
3406,1,1,168,1519,1351
3407,1,1,403,1671,1268
3408,1,0,64,0,-64
3409,0,0,19,0,-19
3410,1,0,97,0,-97
3411,0,0,44,0,-44
3412,1,0,38,0,-38
3413,1,0,37,0,-37
3414,1,0,18,0,-18
3415,0,0,101,0,-101
3416,1,1,363,1405,1042
3417,1,0,17,0,-17
3418,0,0,51,0,-51
3419,1,0,10,0,-10
3420,0,0,31,0,-31
3421,0,0,86,0,-86
3422,1,0,9,0,-9
3423,1,1,778,1217,439
3424,1,0,15,0,-15
3425,0,0,2,0,-2
3426,1,1,706,1205,499
3427,0,0,103,0,-103
3428,1,0,10,0,-10
3429,0,0,53,0,-53
3430,0,0,24,0,-24
3431,0,0,180,0,-180
3432,1,1,1046,1477,431
3433,0,0,3,0,-3
3434,1,1,668,3102,2434
3435,1,0,5,0,-5
3436,1,0,2,0,-2
3437,0,0,53,0,-53
3438,1,1,100,1434,1334
3439,0,0,75,0,-75
3440,0,0,44,0,-44
3441,1,0,8,0,-8
3442,1,0,293,0,-293
3443,0,0,5,0,-5
3444,0,0,138,0,-138
3445,1,0,118,0,-118
3446,1,1,163,1225,1062
3447,0,0,78,0,-78
3448,1,0,37,0,-37
3449,0,0,54,0,-54
3450,1,1,638,1399,761
3451,1,1,778,1391,613
3452,0,0,15,0,-15
3453,1,1,219,1673,1454
3454,1,1,831,1509,678
3455,0,0,12,0,-12
3456,1,1,99,1212,1113
3457,1,1,2440,1382,-1058
3458,0,0,94,0,-94
3459,1,0,24,0,-24
3460,1,1,525,1265,740
3461,0,0,4,0,-4
3462,1,0,25,0,-25
3463,1,0,12,0,-12
3464,0,0,28,0,-28
3465,1,0,10,0,-10
3466,1,1,201,1321,1120
3467,0,0,57,0,-57
3468,1,1,592,1504,912
3469,1,0,182,0,-182
3470,1,1,510,1641,1131
3471,1,1,109,1244,1135
3472,0,0,63,0,-63
3473,0,0,49,0,-49
3474,1,1,347,1988,1641
3475,0,0,7,0,-7
3476,1,0,26,0,-26
3477,1,0,39,0,-39
3478,0,0,10,0,-10
3479,1,0,10,0,-10
3480,1,0,29,0,-29
3481,1,0,9,0,-9
3482,0,0,125,0,-125
3483,0,0,50,0,-50
3484,0,0,7,0,-7
3485,1,1,28,1560,1532
3486,1,1,555,1336,781
3487,1,0,38,0,-38
3488,1,0,21,0,-21
3489,0,0,95,0,-95
3490,0,0,93,0,-93
3491,0,0,25,0,-25
3492,1,1,994,1967,973
3493,1,1,170,1697,1527
3494,0,0,0,0,0
3495,1,0,74,0,-74
3496,0,0,3,0,-3
3497,1,0,0,0,0
3498,1,0,0,0,0
3499,0,0,58,0,-58
3500,1,0,23,0,-23
3501,1,1,905,1355,450
3502,1,0,44,0,-44
3503,1,1,163,1637,1474
3504,1,0,26,0,-26
3505,0,0,21,0,-21
3506,0,0,53,0,-53
3507,0,0,77,0,-77
3508,0,0,40,0,-40
3509,0,0,18,0,-18
3510,1,0,146,0,-146
3511,1,0,63,0,-63
3512,1,1,413,1417,1004
3513,0,0,166,0,-166
3514,0,0,46,0,-46
3515,1,0,15,0,-15
3516,1,0,2,0,-2
3517,0,0,165,0,-165
3518,1,0,52,0,-52
3519,0,0,20,0,-20
3520,0,0,62,0,-62
3521,1,1,199,1571,1372
3522,1,1,563,1453,890
3523,1,0,162,0,-162
3524,0,0,1,0,-1
3525,0,0,1,0,-1
3526,0,0,48,0,-48
3527,0,0,70,0,-70
3528,1,1,503,1404,901
3529,1,0,38,0,-38
3530,1,0,39,0,-39
3531,0,0,89,0,-89
3532,1,0,17,0,-17
3533,1,0,85,0,-85
3534,1,1,712,2401,1689
3535,0,0,24,0,-24
3536,1,1,272,1240,968
3537,1,1,245,1233,988
3538,0,0,177,0,-177
3539,0,0,20,0,-20
3540,0,0,51,0,-51
3541,1,1,332,1227,895
3542,1,0,87,0,-87
3543,0,0,15,0,-15
3544,1,0,74,0,-74
3545,1,1,250,1593,1343
3546,0,0,171,0,-171
3547,1,1,2538,1355,-1183
3548,0,0,24,0,-24
3549,1,0,37,0,-37
3550,1,1,332,1230,898
3551,1,1,252,1473,1221
3552,0,0,169,0,-169
3553,1,1,93,1357,1264
3554,1,0,37,0,-37
3555,1,1,960,3185,2225
3556,0,0,6,0,-6
3557,1,0,64,0,-64
3558,1,0,46,0,-46
3559,0,0,56,0,-56
3560,1,0,44,0,-44
3561,0,0,51,0,-51
3562,0,0,38,0,-38
3563,0,0,107,0,-107
3564,0,0,35,0,-35
3565,1,1,289,1887,1598
3566,1,0,22,0,-22
3567,1,1,754,1219,465
3568,1,1,53,1400,1347
3569,1,0,1,0,-1
3570,0,0,107,0,-107
3571,1,1,501,1262,761
3572,0,0,42,0,-42
3573,1,1,500,1371,871
3574,1,1,261,1418,1157
3575,1,0,47,0,-47
3576,1,1,205,1390,1185
3577,0,0,32,0,-32
3578,1,0,126,0,-126
3579,1,1,674,1744,1070
3580,1,1,135,2645,2510
3581,0,0,55,0,-55
3582,1,1,514,4022,3508
3583,1,0,2,0,-2
3584,0,0,10,0,-10
3585,0,0,123,0,-123
3586,0,0,0,0,0
3587,0,0,90,0,-90
3588,1,0,59,0,-59
3589,1,0,81,0,-81
3590,0,0,26,0,-26
3591,0,0,139,0,-139
3592,0,0,15,0,-15
3593,1,0,15,0,-15
3594,1,1,276,1311,1035
3595,1,1,1050,1248,198
3596,1,1,1182,2667,1485
3597,1,1,705,1359,654
3598,0,0,20,0,-20
3599,0,0,13,0,-13
3600,0,0,11,0,-11
3601,1,1,348,1390,1042
3602,1,1,102,1364,1262
3603,0,0,15,0,-15
3604,1,0,30,0,-30
3605,1,1,1155,1392,237
3606,1,0,32,0,-32
3607,1,0,91,0,-91
3608,1,0,29,0,-29
3609,0,0,49,0,-49
3610,1,0,103,0,-103
3611,0,0,23,0,-23
3612,1,1,360,1439,1079
3613,1,1,54,1451,1397
3614,0,0,8,0,-8
3615,0,0,109,0,-109
3616,0,0,22,0,-22
3617,0,0,29,0,-29
3618,1,1,381,1455,1074
3619,0,0,14,0,-14
3620,0,0,19,0,-19
3621,0,0,5,0,-5
3622,0,0,72,0,-72
3623,1,1,29,1219,1190
3624,1,1,585,1485,900
3625,1,1,440,1370,930
3626,1,0,34,0,-34
3627,1,0,72,0,-72
3628,1,0,39,0,-39
3629,1,1,894,1220,326
3630,1,1,109,1625,1516
3631,0,0,42,0,-42
3632,1,0,28,0,-28
3633,0,0,38,0,-38
3634,0,0,9,0,-9
3635,1,1,376,1487,1111
3636,1,0,6,0,-6
3637,1,1,61,1930,1869
3638,0,0,14,0,-14
3639,1,0,1,0,-1
3640,0,0,64,0,-64
3641,1,1,219,1257,1038
3642,1,1,1418,1205,-213
3643,1,0,182,0,-182
3644,0,0,84,0,-84
3645,0,0,8,0,-8
3646,1,0,4,0,-4
3647,1,0,97,0,-97
3648,0,0,19,0,-19
3649,0,0,20,0,-20
3650,0,0,21,0,-21
3651,0,0,13,0,-13
3652,1,0,27,0,-27
3653,0,0,27,0,-27
3654,0,0,42,0,-42
3655,1,0,0,0,0
3656,1,0,24,0,-24
3657,1,1,323,1690,1367
3658,0,0,0,0,0
3659,1,1,259,2371,2112
3660,1,1,513,1402,889
3661,1,0,34,0,-34
3662,0,0,64,0,-64
3663,0,0,20,0,-20
3664,1,0,19,0,-19
3665,1,0,34,0,-34
3666,1,0,31,0,-31
3667,1,1,912,1247,335
3668,0,0,0,0,0
3669,0,0,180,0,-180
3670,0,0,4,0,-4
3671,0,0,12,0,-12
3672,1,0,36,0,-36
3673,1,0,1,0,-1
3674,1,1,307,1468,1161
3675,1,0,14,0,-14
3676,0,0,53,0,-53
3677,0,0,61,0,-61
3678,1,0,0,0,0
3679,0,0,33,0,-33
3680,0,0,12,0,-12
3681,1,0,20,0,-20
3682,1,0,170,0,-170
3683,1,1,63,1301,1238
3684,0,0,57,0,-57
3685,0,0,57,0,-57
3686,1,0,9,0,-9
3687,1,0,13,0,-13
3688,0,0,70,0,-70
3689,1,1,263,1215,952
3690,1,1,135,1350,1215
3691,0,0,35,0,-35
3692,1,1,553,1632,1079
3693,1,1,259,1468,1209
3694,1,1,97,1461,1364
3695,1,0,83,0,-83
3696,1,0,127,0,-127
3697,1,1,317,2378,2061
3698,1,0,92,0,-92
3699,1,1,153,1258,1105
3700,0,0,11,0,-11
3701,0,0,4,0,-4
3702,0,0,1,0,-1
3703,0,0,141,0,-141
3704,1,0,30,0,-30
3705,1,0,10,0,-10
3706,1,1,44,1232,1188
3707,1,1,198,1271,1073
3708,1,0,18,0,-18
3709,1,0,59,0,-59
3710,0,0,37,0,-37
3711,1,1,515,1333,818
3712,0,0,131,0,-131
3713,0,0,49,0,-49
3714,0,0,75,0,-75
3715,1,0,29,0,-29
3716,1,1,74,1239,1165
3717,1,1,1031,1301,270
3718,0,0,196,0,-196
3719,1,1,591,1232,641
3720,0,0,55,0,-55
3721,0,0,135,0,-135
3722,1,1,2890,1303,-1587
3723,1,1,360,1234,874
3724,0,0,29,0,-29
3725,1,1,233,1356,1123
3726,1,0,5,0,-5
3727,0,0,8,0,-8
3728,1,1,290,1228,938
3729,0,0,16,0,-16
3730,0,0,18,0,-18
3731,1,0,4,0,-4
3732,1,1,195,1519,1324
3733,1,0,50,0,-50
3734,0,0,28,0,-28
3735,1,0,20,0,-20
3736,1,0,20,0,-20
3737,0,0,32,0,-32
3738,1,0,32,0,-32
3739,0,0,25,0,-25
3740,1,0,39,0,-39
3741,1,0,33,0,-33
3742,1,1,61,1412,1351
3743,1,0,64,0,-64
3744,0,0,115,0,-115
3745,1,0,14,0,-14
3746,0,0,2,0,-2
3747,0,0,68,0,-68
3748,0,0,9,0,-9
3749,0,0,92,0,-92
3750,1,1,918,1539,621
3751,1,0,66,0,-66
3752,1,1,557,1224,667
3753,0,0,57,0,-57
3754,1,1,276,1257,981
3755,1,1,593,1248,655
3756,1,1,189,1238,1049
3757,1,0,9,0,-9
3758,1,0,22,0,-22
3759,1,1,205,1384,1179
3760,1,1,205,1212,1007
3761,1,1,80,2752,2672
3762,1,1,57,1322,1265
3763,1,1,103,1243,1140
3764,0,0,28,0,-28
3765,1,1,2877,1719,-1158
3766,1,1,164,1240,1076
3767,0,0,17,0,-17
3768,1,0,251,0,-251
3769,1,1,731,1333,602
3770,0,0,48,0,-48
3771,1,0,107,0,-107
3772,1,0,39,0,-39
3773,1,0,16,0,-16
3774,1,0,87,0,-87
3775,1,1,545,1229,684
3776,1,0,191,0,-191
3777,0,0,32,0,-32
3778,1,0,44,0,-44
3779,1,0,91,0,-91
3780,1,1,555,1374,819
3781,0,0,106,0,-106
3782,1,1,847,1240,393
3783,0,0,42,0,-42
3784,1,0,23,0,-23
3785,1,0,7,0,-7
3786,1,1,175,1386,1211
3787,1,1,61,1350,1289
3788,1,0,17,0,-17
3789,1,1,475,2340,1865
3790,1,0,169,0,-169
3791,0,0,12,0,-12
3792,1,0,149,0,-149
3793,0,0,8,0,-8
3794,0,0,105,0,-105
3795,1,0,129,0,-129
3796,0,0,26,0,-26
3797,1,0,77,0,-77
3798,0,0,116,0,-116
3799,1,1,66,1294,1228
3800,1,0,12,0,-12
3801,0,0,21,0,-21
3802,1,0,58,0,-58
3803,0,0,48,0,-48
3804,1,1,968,1758,790
3805,1,0,36,0,-36
3806,0,0,17,0,-17
3807,1,1,469,1245,776
3808,0,0,40,0,-40
3809,1,0,20,0,-20
3810,0,0,52,0,-52
3811,0,0,34,0,-34
3812,1,1,332,1428,1096
3813,1,0,7,0,-7
3814,1,1,1083,1213,130
3815,0,0,41,0,-41
3816,1,0,52,0,-52
3817,1,1,480,1450,970
3818,1,0,48,0,-48
3819,0,0,24,0,-24
3820,1,1,888,1983,1095
3821,0,0,21,0,-21
3822,1,0,22,0,-22
3823,0,0,32,0,-32
3824,1,0,45,0,-45
3825,1,1,466,1339,873
3826,0,0,9,0,-9
3827,1,0,24,0,-24
3828,1,0,2,0,-2
3829,1,0,65,0,-65
3830,1,0,128,0,-128
3831,1,0,91,0,-91
3832,0,0,99,0,-99
3833,0,0,88,0,-88
3834,0,0,31,0,-31
3835,0,0,35,0,-35
3836,1,1,993,1349,356
3837,0,0,58,0,-58
3838,0,0,113,0,-113
3839,1,1,498,1277,779
3840,1,0,42,0,-42
3841,1,0,144,0,-144
3842,0,0,114,0,-114
3843,1,0,29,0,-29
3844,0,0,65,0,-65
3845,1,0,97,0,-97
3846,1,0,68,0,-68
3847,0,0,30,0,-30
3848,0,0,11,0,-11
3849,1,1,1902,1580,-322
3850,1,1,340,1230,890
3851,0,0,41,0,-41
3852,0,0,105,0,-105
3853,1,1,256,1466,1210
3854,1,0,12,0,-12
3855,1,0,161,0,-161
3856,0,0,8,0,-8
3857,0,0,64,0,-64
3858,1,1,857,1212,355
3859,1,0,44,0,-44
3860,0,0,52,0,-52
3861,1,0,28,0,-28
3862,1,1,86,1264,1178
3863,1,0,19,0,-19
3864,1,0,154,0,-154
3865,0,0,1,0,-1
3866,0,0,51,0,-51
3867,1,0,79,0,-79
3868,1,0,38,0,-38
3869,1,0,43,0,-43
3870,0,0,5,0,-5
3871,1,0,58,0,-58
3872,1,1,82,2178,2096
3873,1,1,803,1526,723
3874,0,0,376,0,-376
3875,1,0,9,0,-9
3876,1,1,202,1385,1183
3877,0,0,75,0,-75
3878,1,0,144,0,-144
3879,1,0,1,0,-1
3880,0,0,8,0,-8
3881,1,0,59,0,-59
3882,1,1,412,1220,808
3883,0,0,30,0,-30
3884,1,1,527,1595,1068
3885,1,1,1195,1268,73
3886,1,0,16,0,-16
3887,1,0,65,0,-65
3888,1,0,8,0,-8
3889,1,1,399,1426,1027
3890,1,0,75,0,-75
3891,0,0,3,0,-3
3892,0,0,106,0,-106
3893,1,0,2,0,-2
3894,1,0,34,0,-34
3895,1,0,35,0,-35
3896,1,1,71,1969,1898
3897,1,1,765,1277,512
3898,0,0,20,0,-20
3899,0,0,126,0,-126
3900,0,0,101,0,-101
3901,0,0,20,0,-20
3902,0,0,11,0,-11
3903,1,0,170,0,-170
3904,1,0,26,0,-26
3905,0,0,42,0,-42
3906,1,1,274,1214,940
3907,1,0,41,0,-41
3908,1,0,14,0,-14
3909,1,1,23,1497,1474
3910,1,0,31,0,-31
3911,1,1,167,1577,1410
3912,1,0,115,0,-115
3913,1,0,9,0,-9
3914,0,0,106,0,-106
3915,1,1,183,1577,1394
3916,1,1,1358,1257,-101
3917,0,0,120,0,-120
3918,1,0,64,0,-64
3919,1,1,1224,1377,153
3920,1,0,31,0,-31
3921,0,0,57,0,-57
3922,1,0,23,0,-23
3923,1,0,18,0,-18
3924,1,1,855,1280,425
3925,1,0,7,0,-7
3926,1,1,192,1262,1070
3927,0,0,12,0,-12
3928,1,1,422,1210,788
3929,1,1,581,2515,1934
3930,1,0,37,0,-37
3931,1,1,602,1485,883
3932,1,0,27,0,-27
3933,1,0,47,0,-47
3934,1,1,325,1694,1369
3935,1,1,165,1363,1198
3936,1,0,30,0,-30
3937,0,0,48,0,-48
3938,0,0,27,0,-27
3939,1,1,51,3427,3376
3940,1,0,13,0,-13
3941,0,0,17,0,-17
3942,0,0,35,0,-35
3943,0,0,69,0,-69
3944,1,0,129,0,-129
3945,0,0,32,0,-32
3946,0,0,69,0,-69
3947,1,0,51,0,-51
3948,1,1,406,1229,823
3949,0,0,67,0,-67
3950,0,0,14,0,-14
3951,1,0,22,0,-22
3952,0,0,0,0,0
3953,1,0,42,0,-42
3954,0,0,79,0,-79
3955,0,0,24,0,-24
3956,1,1,532,1204,672
3957,1,1,71,1313,1242
3958,0,0,32,0,-32
3959,1,0,23,0,-23
3960,0,0,94,0,-94
3961,1,1,255,1229,974
3962,1,0,66,0,-66
3963,1,0,92,0,-92
3964,1,1,106,2120,2014
3965,1,1,594,1838,1244
3966,1,0,23,0,-23
3967,1,1,651,2040,1389
3968,1,0,10,0,-10
3969,0,0,158,0,-158
3970,1,0,69,0,-69
3971,0,0,6,0,-6
3972,1,0,96,0,-96
3973,0,0,22,0,-22
3974,1,0,100,0,-100
3975,1,0,13,0,-13
3976,1,0,102,0,-102
3977,1,0,3,0,-3
3978,0,0,137,0,-137
3979,1,0,19,0,-19
3980,0,0,45,0,-45
3981,0,0,34,0,-34
3982,0,0,71,0,-71
3983,1,0,0,0,0
3984,1,0,0,0,0
3985,0,0,105,0,-105
3986,0,0,65,0,-65
3987,0,0,15,0,-15
3988,1,1,1873,1236,-637
3989,1,1,6,1494,1488
3990,1,1,719,2271,1552
3991,1,0,20,0,-20
3992,1,1,135,1290,1155
3993,1,0,26,0,-26
3994,1,0,23,0,-23
3995,0,0,235,0,-235
3996,1,0,3,0,-3
3997,0,0,4,0,-4
3998,0,0,3,0,-3
3999,1,1,271,1552,1281
4000,0,0,89,0,-89
4001,1,1,771,1477,706
4002,1,1,314,1700,1386
4003,0,0,47,0,-47
4004,0,0,47,0,-47
4005,0,0,1,0,-1
4006,1,1,1342,1369,27
4007,1,0,29,0,-29
4008,1,0,42,0,-42
4009,1,1,614,1960,1346
4010,1,1,286,1454,1168
4011,0,0,89,0,-89
4012,0,0,64,0,-64
4013,1,1,780,1787,1007
4014,1,0,15,0,-15
4015,1,0,193,0,-193
4016,1,0,35,0,-35
4017,0,0,97,0,-97
4018,0,0,58,0,-58
4019,1,0,13,0,-13
4020,0,0,85,0,-85
4021,1,0,18,0,-18
4022,1,0,71,0,-71
4023,0,0,12,0,-12
4024,0,0,14,0,-14
4025,0,0,15,0,-15
4026,0,0,9,0,-9
4027,1,1,23,1208,1185
4028,1,0,43,0,-43
4029,0,0,73,0,-73
4030,0,0,27,0,-27
4031,0,0,88,0,-88
4032,0,0,120,0,-120
4033,0,0,14,0,-14
4034,1,0,25,0,-25
4035,1,0,59,0,-59
4036,1,0,6,0,-6
4037,0,0,28,0,-28
4038,1,0,69,0,-69
4039,1,0,12,0,-12
4040,0,0,3,0,-3
4041,0,0,0,0,0
4042,0,0,66,0,-66
4043,0,0,12,0,-12
4044,1,1,224,2283,2059
4045,0,0,21,0,-21
4046,1,1,78,2753,2675
4047,0,0,33,0,-33
4048,1,1,574,1239,665
4049,0,0,20,0,-20
4050,1,0,31,0,-31
4051,1,0,41,0,-41
4052,1,1,254,1299,1045
4053,1,1,687,1208,521
4054,1,0,77,0,-77
4055,1,0,13,0,-13
4056,1,0,6,0,-6
4057,1,1,13,1249,1236
4058,1,1,1105,1353,248
4059,0,0,23,0,-23
4060,0,0,5,0,-5
4061,1,1,538,1454,916
4062,0,0,132,0,-132
4063,0,0,0,0,0
4064,1,0,1,0,-1
4065,0,0,49,0,-49
4066,1,1,109,1724,1615
4067,1,0,32,0,-32
4068,0,0,43,0,-43
4069,1,1,91,1215,1124
4070,1,0,12,0,-12
4071,1,1,289,1228,939
4072,1,1,742,1345,603
4073,0,0,112,0,-112
4074,0,0,36,0,-36
4075,1,1,354,1765,1411
4076,1,0,20,0,-20
4077,0,0,123,0,-123
4078,0,0,15,0,-15
4079,0,0,35,0,-35
4080,1,0,21,0,-21
4081,0,0,22,0,-22
4082,1,1,414,1496,1082
4083,1,1,1048,1225,177
4084,1,1,1705,8231,6526
4085,1,0,11,0,-11
4086,1,0,26,0,-26
4087,1,0,103,0,-103
4088,1,1,447,1260,813
4089,0,0,62,0,-62
4090,1,1,966,1314,348
4091,1,0,22,0,-22
4092,1,0,9,0,-9
4093,0,0,21,0,-21
4094,1,1,248,1658,1410
4095,1,1,916,1519,603
4096,0,0,36,0,-36
4097,0,0,6,0,-6
4098,1,1,622,2290,1668
4099,0,0,38,0,-38
4100,0,0,41,0,-41
4101,1,0,46,0,-46
4102,1,1,902,1530,628
4103,1,1,178,1838,1660
4104,1,0,137,0,-137
4105,1,1,377,1533,1156
4106,1,1,166,1378,1212
4107,0,0,86,0,-86
4108,1,0,5,0,-5
4109,1,1,396,1292,896
4110,1,1,1735,1324,-411
4111,1,0,86,0,-86
4112,0,0,103,0,-103
4113,0,0,150,0,-150
4114,1,1,432,1497,1065
4115,1,1,228,1360,1132
4116,1,1,310,1291,981
4117,1,0,31,0,-31
4118,0,0,43,0,-43
4119,0,0,31,0,-31
4120,1,0,48,0,-48
4121,1,1,106,1861,1755
4122,1,1,365,1456,1091
4123,0,0,19,0,-19
4124,0,0,129,0,-129
4125,1,0,76,0,-76
4126,0,0,4,0,-4
4127,1,1,161,1497,1336
4128,1,1,423,1291,868
4129,1,1,1155,1246,91
4130,1,1,296,1249,953
4131,1,1,583,1376,793
4132,1,0,56,0,-56
4133,0,0,34,0,-34
4134,1,1,3845,1586,-2259
4135,0,0,28,0,-28
4136,1,0,135,0,-135
4137,1,0,10,0,-10
4138,1,0,120,0,-120
4139,1,1,378,1739,1361
4140,1,1,214,1358,1144
4141,1,0,83,0,-83
4142,1,1,219,1224,1005
4143,1,0,72,0,-72
4144,0,0,4,0,-4
4145,1,0,82,0,-82
4146,0,0,67,0,-67
4147,1,1,277,1943,1666
4148,1,0,17,0,-17
4149,1,0,1,0,-1
4150,1,0,86,0,-86
4151,1,1,231,1339,1108
4152,1,1,190,2120,1930
4153,0,0,0,0,0
4154,0,0,30,0,-30
4155,0,0,87,0,-87
4156,1,0,2,0,-2
4157,1,0,43,0,-43
4158,1,0,24,0,-24
4159,1,0,136,0,-136
4160,0,0,22,0,-22
4161,0,0,114,0,-114
4162,1,1,1075,1500,425
4163,0,0,54,0,-54
4164,0,0,29,0,-29
4165,1,1,82,1229,1147
4166,0,0,68,0,-68
4167,1,1,538,1515,977
4168,1,0,24,0,-24
4169,1,1,1006,1702,696
4170,1,0,6,0,-6
4171,0,0,44,0,-44
4172,1,1,860,1335,475
4173,1,0,23,0,-23
4174,1,0,3,0,-3
4175,0,0,6,0,-6
4176,1,0,103,0,-103
4177,1,1,702,1207,505
4178,1,1,659,2039,1380
4179,1,1,249,1204,955
4180,0,0,38,0,-38
4181,0,0,0,0,0
4182,0,0,78,0,-78
4183,0,0,6,0,-6
4184,0,0,82,0,-82
4185,0,0,76,0,-76
4186,1,0,31,0,-31
4187,1,1,1417,2622,1205
4188,0,0,0,0,0
4189,1,1,1079,1335,256
4190,0,0,80,0,-80
4191,1,0,59,0,-59
4192,0,0,83,0,-83
4193,0,0,5,0,-5
4194,1,1,281,1727,1446
4195,1,1,664,1294,630
4196,0,0,23,0,-23
4197,1,1,51,1364,1313
4198,0,0,128,0,-128
4199,0,0,41,0,-41
4200,1,0,4,0,-4
4201,0,0,6,0,-6
4202,0,0,55,0,-55
4203,1,1,689,1421,732
4204,1,0,55,0,-55
4205,1,1,934,1420,486
4206,0,0,21,0,-21
4207,0,0,71,0,-71
4208,1,0,1,0,-1
4209,0,0,126,0,-126
4210,0,0,95,0,-95
4211,0,0,75,0,-75
4212,1,1,994,1943,949
4213,1,0,92,0,-92
4214,0,0,10,0,-10
4215,0,0,40,0,-40
4216,1,0,3,0,-3
4217,0,0,230,0,-230
4218,1,0,3,0,-3
4219,1,0,7,0,-7
4220,0,0,17,0,-17
4221,0,0,51,0,-51
4222,1,0,2,0,-2
4223,1,0,25,0,-25
4224,1,0,20,0,-20
4225,1,0,108,0,-108
4226,0,0,24,0,-24
4227,1,0,29,0,-29
4228,1,1,65,1589,1524
4229,1,0,22,0,-22
4230,0,0,115,0,-115
4231,0,0,6,0,-6
4232,1,0,0,0,0
4233,1,0,27,0,-27
4234,1,0,55,0,-55
4235,0,0,32,0,-32
4236,1,0,16,0,-16
4237,0,0,5,0,-5
4238,1,0,55,0,-55
4239,1,1,205,2057,1852
4240,1,0,30,0,-30
4241,1,0,106,0,-106
4242,1,1,627,1533,906
4243,1,1,53,2065,2012
4244,1,1,188,2307,2119
4245,1,1,243,1999,1756
4246,0,0,107,0,-107
4247,1,0,34,0,-34
4248,1,1,1965,2032,67
4249,0,0,45,0,-45
4250,0,0,0,0,0
4251,1,1,217,1280,1063
4252,1,1,421,1360,939
4253,0,0,4,0,-4
4254,0,0,0,0,0
4255,1,1,386,1383,997
4256,1,1,323,1234,911
4257,0,0,8,0,-8
4258,0,0,206,0,-206
4259,0,0,27,0,-27
4260,0,0,127,0,-127
4261,0,0,12,0,-12
4262,1,0,25,0,-25
4263,1,1,128,1838,1710
4264,1,1,340,2188,1848
4265,0,0,130,0,-130
4266,0,0,72,0,-72
4267,1,0,103,0,-103
4268,0,0,99,0,-99
4269,1,0,58,0,-58
4270,1,1,215,1531,1316
4271,1,0,319,0,-319
4272,1,0,53,0,-53
4273,0,0,46,0,-46
4274,1,1,524,1502,978
4275,0,0,114,0,-114
4276,1,1,222,1334,1112
4277,1,1,718,1299,581
4278,1,1,145,1296,1151
4279,0,0,21,0,-21
4280,0,0,4,0,-4
4281,0,0,72,0,-72
4282,1,1,459,1506,1047
4283,0,0,105,0,-105
4284,0,0,12,0,-12
4285,0,0,2,0,-2
4286,0,0,112,0,-112
4287,0,0,59,0,-59
4288,1,1,179,1790,1611
4289,0,0,30,0,-30
4290,0,0,35,0,-35
4291,0,0,9,0,-9
4292,1,0,45,0,-45
4293,0,0,13,0,-13
4294,1,1,2172,1450,-722
4295,1,1,649,1273,624
4296,0,0,46,0,-46
4297,0,0,16,0,-16
4298,1,1,550,1239,689
4299,0,0,11,0,-11
4300,0,0,35,0,-35
4301,0,0,8,0,-8
4302,0,0,25,0,-25
4303,0,0,19,0,-19
4304,1,1,79,1609,1530
4305,0,0,42,0,-42
4306,1,1,378,1200,822
4307,0,0,20,0,-20
4308,0,0,15,0,-15
4309,0,0,107,0,-107
4310,1,0,30,0,-30
4311,1,1,575,1324,749
4312,1,1,864,1454,590
4313,0,0,20,0,-20
4314,0,0,18,0,-18
4315,1,0,127,0,-127
4316,1,0,4,0,-4
4317,1,0,37,0,-37
4318,0,0,33,0,-33
4319,1,1,176,2286,2110
4320,0,0,3,0,-3
4321,1,0,39,0,-39
4322,1,0,130,0,-130
4323,0,0,24,0,-24
4324,0,0,158,0,-158
4325,0,0,13,0,-13
4326,1,0,24,0,-24
4327,1,0,6,0,-6
4328,0,0,158,0,-158
4329,1,1,176,3305,3129
4330,1,1,401,1224,823
4331,1,1,1697,1252,-445
4332,1,0,80,0,-80
4333,0,0,12,0,-12
4334,1,0,258,0,-258
4335,1,0,0,0,0
4336,1,1,49,1620,1571
4337,1,0,25,0,-25
4338,1,0,60,0,-60
4339,1,0,2,0,-2
4340,0,0,39,0,-39
4341,0,0,21,0,-21
4342,1,0,78,0,-78
4343,1,1,901,1249,348
4344,0,0,25,0,-25
4345,1,0,0,0,0
4346,1,0,32,0,-32
4347,1,0,15,0,-15
4348,1,1,111,1313,1202
4349,1,0,4,0,-4
4350,1,1,1269,1413,144
4351,1,0,12,0,-12
4352,1,1,468,1362,894
4353,1,1,1005,1283,278
4354,0,0,33,0,-33
4355,1,0,27,0,-27
4356,1,0,39,0,-39
4357,1,1,797,1239,442
4358,1,1,1412,1793,381
4359,1,1,154,1488,1334
4360,0,0,2,0,-2
4361,0,0,40,0,-40
4362,0,0,71,0,-71
4363,0,0,125,0,-125
4364,0,0,29,0,-29
4365,0,0,37,0,-37
4366,1,0,48,0,-48
4367,1,0,0,0,0
4368,1,0,22,0,-22
4369,0,0,78,0,-78
4370,0,0,3,0,-3
4371,0,0,26,0,-26
4372,1,0,21,0,-21
4373,1,0,2,0,-2
4374,0,0,4,0,-4
4375,0,0,11,0,-11
4376,1,1,488,1535,1047
4377,1,0,26,0,-26
4378,0,0,22,0,-22
4379,1,0,21,0,-21
4380,1,0,83,0,-83
4381,0,0,16,0,-16
4382,0,0,18,0,-18
4383,1,0,8,0,-8
4384,1,0,4,0,-4
4385,1,0,130,0,-130
4386,0,0,122,0,-122
4387,1,1,682,1726,1044
4388,0,0,106,0,-106
4389,0,0,67,0,-67
4390,1,0,61,0,-61
4391,1,1,1616,1200,-416
4392,1,0,61,0,-61
4393,0,0,93,0,-93
4394,0,0,1,0,-1
4395,1,0,94,0,-94
4396,0,0,14,0,-14
4397,0,0,11,0,-11
4398,0,0,20,0,-20
4399,1,0,12,0,-12
4400,1,0,12,0,-12
4401,0,0,81,0,-81
4402,1,0,42,0,-42
4403,1,0,51,0,-51
4404,0,0,90,0,-90
4405,0,0,115,0,-115
4406,1,0,90,0,-90
4407,0,0,205,0,-205
4408,1,0,38,0,-38
4409,1,1,288,1352,1064
4410,1,0,11,0,-11
4411,0,0,14,0,-14
4412,0,0,67,0,-67
4413,1,1,2060,1578,-482
4414,1,0,118,0,-118
4415,1,0,100,0,-100
4416,1,0,36,0,-36
4417,1,0,22,0,-22
4418,1,1,114,1201,1087
4419,0,0,99,0,-99
4420,0,0,4,0,-4
4421,1,0,159,0,-159
4422,0,0,19,0,-19
4423,1,0,25,0,-25
4424,1,1,175,1225,1050
4425,0,0,12,0,-12
4426,1,0,57,0,-57
4427,1,0,35,0,-35
4428,0,0,45,0,-45
4429,0,0,95,0,-95
4430,1,0,7,0,-7
4431,0,0,27,0,-27
4432,1,0,27,0,-27
4433,0,0,24,0,-24
4434,1,0,3,0,-3
4435,0,0,19,0,-19
4436,0,0,12,0,-12
4437,1,0,8,0,-8
4438,0,0,22,0,-22
4439,1,0,6,0,-6
4440,1,0,10,0,-10
4441,1,0,13,0,-13
4442,1,1,616,1286,670
4443,1,1,695,1532,837
4444,1,1,382,1334,952
4445,1,1,338,1234,896
4446,0,0,48,0,-48
4447,0,0,75,0,-75
4448,0,0,4,0,-4
4449,1,1,297,1627,1330
4450,0,0,1,0,-1
4451,1,1,1129,1322,193
4452,1,1,76,1376,1300
4453,0,0,10,0,-10
4454,0,0,27,0,-27
4455,1,1,28,1280,1252
4456,1,1,290,2126,1836
4457,1,0,8,0,-8
4458,1,0,57,0,-57
4459,0,0,115,0,-115
4460,0,0,9,0,-9
4461,1,0,1,0,-1
4462,0,0,32,0,-32
4463,1,1,286,1304,1018
4464,1,0,29,0,-29
4465,0,0,29,0,-29
4466,1,1,361,1497,1136
4467,0,0,56,0,-56
4468,1,0,10,0,-10
4469,1,1,105,1837,1732
4470,0,0,66,0,-66
4471,1,0,24,0,-24
4472,1,1,1732,1258,-474
4473,1,1,662,2508,1846
4474,1,0,72,0,-72
4475,0,0,46,0,-46
4476,0,0,5,0,-5
4477,1,0,65,0,-65
4478,0,0,115,0,-115
4479,0,0,10,0,-10
4480,1,0,3,0,-3
4481,1,1,129,1786,1657
4482,0,0,87,0,-87
4483,1,1,895,1272,377
4484,1,1,239,1286,1047
4485,1,1,1047,1231,184
4486,0,0,1,0,-1
4487,1,0,36,0,-36
4488,1,0,24,0,-24
4489,1,1,765,1403,638
4490,0,0,26,0,-26
4491,1,1,398,1712,1314
4492,1,0,2,0,-2
4493,1,0,104,0,-104
4494,0,0,6,0,-6
4495,0,0,42,0,-42
4496,0,0,22,0,-22
4497,1,1,857,1659,802
4498,0,0,131,0,-131
4499,1,1,269,1213,944
4500,1,1,1387,1341,-46
4501,1,1,411,2283,1872
4502,0,0,51,0,-51
4503,1,0,14,0,-14
4504,0,0,11,0,-11
4505,1,1,732,1241,509
4506,0,0,6,0,-6
4507,0,0,13,0,-13
4508,1,1,441,1851,1410
4509,1,1,475,1369,894
4510,0,0,171,0,-171
4511,1,1,335,1220,885
4512,1,0,67,0,-67
4513,1,1,584,2468,1884
4514,0,0,109,0,-109
4515,1,0,328,0,-328
4516,0,0,113,0,-113
4517,1,0,74,0,-74
4518,1,0,29,0,-29
4519,0,0,17,0,-17
4520,1,1,260,3041,2781
4521,1,0,14,0,-14
4522,0,0,36,0,-36
4523,1,0,65,0,-65
4524,0,0,31,0,-31
4525,1,1,1403,1779,376
4526,1,1,471,1342,871
4527,1,1,598,1750,1152
4528,1,0,38,0,-38
4529,0,0,4,0,-4
4530,0,0,28,0,-28
4531,1,1,896,1455,559
4532,0,0,80,0,-80
4533,1,1,924,1938,1014
4534,1,1,192,2123,1931
4535,1,0,7,0,-7
4536,1,1,318,1351,1033
4537,1,0,78,0,-78
4538,0,0,79,0,-79
4539,1,0,38,0,-38
4540,0,0,44,0,-44
4541,1,0,6,0,-6
4542,1,0,43,0,-43
4543,1,0,86,0,-86
4544,0,0,22,0,-22
4545,1,0,37,0,-37
4546,0,0,108,0,-108
4547,0,0,15,0,-15
4548,0,0,7,0,-7
4549,0,0,49,0,-49
4550,1,1,82,1202,1120
4551,1,0,64,0,-64
4552,1,1,295,1296,1001
4553,1,1,303,1210,907
4554,1,1,893,1831,938
4555,0,0,93,0,-93
4556,0,0,16,0,-16
4557,0,0,131,0,-131
4558,1,0,3,0,-3
4559,1,0,28,0,-28
4560,1,0,54,0,-54
4561,0,0,179,0,-179
4562,1,1,799,1317,518
4563,0,0,25,0,-25
4564,0,0,13,0,-13
4565,1,1,524,1940,1416
4566,1,1,919,1346,427
4567,1,0,1,0,-1
4568,0,0,33,0,-33
4569,1,0,0,0,0
4570,1,0,17,0,-17
4571,1,1,28,1625,1597
4572,0,0,48,0,-48
4573,1,0,15,0,-15
4574,0,0,4,0,-4
4575,1,0,44,0,-44
4576,1,0,20,0,-20
4577,1,0,86,0,-86
4578,1,1,621,1748,1127
4579,0,0,75,0,-75
4580,1,1,215,1319,1104
4581,0,0,64,0,-64
4582,0,0,6,0,-6
4583,1,1,870,1214,344
4584,1,0,61,0,-61
4585,0,0,84,0,-84
4586,0,0,18,0,-18
4587,1,0,41,0,-41
4588,1,1,254,1595,1341
4589,1,1,593,1695,1102
4590,0,0,2,0,-2
4591,0,0,8,0,-8
4592,0,0,18,0,-18
4593,1,0,105,0,-105
4594,0,0,125,0,-125
4595,0,0,18,0,-18
4596,0,0,10,0,-10
4597,0,0,14,0,-14
4598,0,0,63,0,-63
4599,0,0,17,0,-17
4600,1,1,937,1236,299
4601,1,0,40,0,-40
4602,0,0,14,0,-14
4603,1,1,859,1312,453
4604,1,1,92,1338,1246
4605,1,0,32,0,-32
4606,1,1,346,1346,1000
4607,0,0,53,0,-53
4608,0,0,23,0,-23
4609,1,0,28,0,-28
4610,1,0,126,0,-126
4611,1,1,762,1296,534
4612,1,0,125,0,-125
4613,1,0,99,0,-99
4614,0,0,8,0,-8
4615,0,0,97,0,-97
4616,0,0,37,0,-37
4617,0,0,80,0,-80
4618,0,0,204,0,-204
4619,0,0,1,0,-1
4620,0,0,17,0,-17
4621,0,0,100,0,-100
4622,1,1,234,1603,1369
4623,1,0,13,0,-13
4624,0,0,77,0,-77
4625,0,0,25,0,-25
4626,0,0,91,0,-91
4627,0,0,23,0,-23
4628,0,0,42,0,-42
4629,0,0,24,0,-24
4630,1,0,13,0,-13
4631,1,1,1100,1265,165
4632,1,0,98,0,-98
4633,0,0,37,0,-37
4634,0,0,59,0,-59
4635,1,1,38,1448,1410
4636,1,1,680,1471,791
4637,0,0,21,0,-21
4638,0,0,5,0,-5
4639,0,0,14,0,-14
4640,0,0,3,0,-3
4641,1,1,396,1225,829
4642,0,0,119,0,-119
4643,1,1,640,1745,1105
4644,1,0,5,0,-5
4645,0,0,24,0,-24
4646,1,0,22,0,-22
4647,1,1,163,1374,1211
4648,1,1,250,1214,964
4649,0,0,31,0,-31
4650,0,0,17,0,-17
4651,0,0,121,0,-121
4652,0,0,21,0,-21
4653,1,1,224,1303,1079
4654,1,1,174,1685,1511
4655,1,1,428,1410,982
4656,1,1,656,2275,1619
4657,1,1,996,1394,398
4658,0,0,52,0,-52
4659,0,0,8,0,-8
4660,0,0,61,0,-61
4661,1,0,18,0,-18
4662,1,1,713,1211,498
4663,1,1,105,1225,1120
4664,0,0,61,0,-61
4665,0,0,22,0,-22
4666,1,1,501,1754,1253
4667,0,0,15,0,-15
4668,1,0,21,0,-21
4669,1,1,393,1329,936
4670,1,0,31,0,-31
4671,0,0,56,0,-56
4672,1,1,797,2035,1238
4673,0,0,10,0,-10
4674,1,0,60,0,-60
4675,1,0,11,0,-11
4676,0,0,40,0,-40
4677,0,0,14,0,-14
4678,1,1,1590,1285,-305
4679,1,1,187,4276,4089
4680,1,1,155,1378,1223
4681,0,0,59,0,-59
4682,0,0,13,0,-13
4683,1,1,117,1596,1479
4684,1,1,543,1655,1112
4685,0,0,56,0,-56
4686,1,0,25,0,-25
4687,1,1,95,1711,1616
4688,1,1,533,1367,834
4689,1,1,188,1555,1367
4690,1,1,427,1203,776
4691,0,0,29,0,-29
4692,0,0,35,0,-35
4693,1,1,869,1516,647
4694,0,0,78,0,-78
4695,0,0,24,0,-24
4696,1,0,34,0,-34
4697,1,0,43,0,-43
4698,0,0,48,0,-48
4699,1,0,26,0,-26
4700,0,0,62,0,-62
4701,0,0,165,0,-165
4702,1,0,29,0,-29
4703,1,0,41,0,-41
4704,0,0,37,0,-37
4705,0,0,38,0,-38
4706,0,0,65,0,-65
4707,1,1,109,1219,1110
4708,1,1,1027,1239,212
4709,1,0,72,0,-72
4710,1,1,101,1256,1155
4711,0,0,122,0,-122
4712,1,1,1366,1592,226
4713,1,0,67,0,-67
4714,0,0,31,0,-31
4715,0,0,26,0,-26
4716,1,0,15,0,-15
4717,1,0,32,0,-32
4718,1,0,0,0,0
4719,1,0,10,0,-10
4720,0,0,25,0,-25
4721,0,0,19,0,-19
4722,0,0,81,0,-81
4723,0,0,136,0,-136
4724,1,1,60,1236,1176
4725,0,0,50,0,-50
4726,1,0,28,0,-28
4727,1,0,4,0,-4
4728,0,0,3,0,-3
4729,1,0,141,0,-141
4730,1,1,512,1396,884
4731,0,0,3,0,-3
4732,0,0,24,0,-24
4733,1,0,41,0,-41
4734,0,0,175,0,-175
4735,1,1,236,1309,1073
4736,0,0,13,0,-13
4737,1,1,33,1343,1310
4738,0,0,24,0,-24
4739,0,0,6,0,-6
4740,1,0,4,0,-4
4741,1,0,25,0,-25
4742,0,0,82,0,-82
4743,0,0,34,0,-34
4744,1,1,471,1572,1101
4745,1,1,224,1306,1082
4746,1,0,31,0,-31
4747,1,1,483,1208,725
4748,1,1,107,1503,1396
4749,1,1,415,2942,2527
4750,1,1,124,1785,1661
4751,0,0,26,0,-26
4752,0,0,83,0,-83
4753,0,0,45,0,-45
4754,0,0,10,0,-10
4755,1,1,301,1432,1131
4756,0,0,8,0,-8
4757,0,0,12,0,-12
4758,1,1,277,1593,1316
4759,1,0,32,0,-32
4760,0,0,70,0,-70
4761,1,1,710,1898,1188
4762,1,1,460,1207,747
4763,1,1,482,1295,813
4764,0,0,2,0,-2
4765,0,0,15,0,-15
4766,1,1,1313,1697,384
4767,1,0,0,0,0
4768,1,0,67,0,-67
4769,0,0,4,0,-4
4770,0,0,4,0,-4
4771,0,0,4,0,-4
4772,0,0,1,0,-1
4773,0,0,108,0,-108
4774,1,0,4,0,-4
4775,1,0,48,0,-48
4776,1,0,97,0,-97
4777,1,0,6,0,-6
4778,0,0,114,0,-114
4779,0,0,44,0,-44
4780,0,0,170,0,-170
4781,1,1,637,1358,721
4782,1,0,98,0,-98
4783,1,0,15,0,-15
4784,0,0,20,0,-20
4785,1,1,378,1229,851
4786,1,0,56,0,-56
4787,1,1,226,1443,1217
4788,0,0,27,0,-27
4789,0,0,113,0,-113
4790,0,0,10,0,-10
4791,0,0,0,0,0
4792,1,1,311,1583,1272
4793,1,1,642,2902,2260
4794,0,0,18,0,-18
4795,1,1,355,1733,1378
4796,1,0,19,0,-19
4797,0,0,8,0,-8
4798,0,0,37,0,-37
4799,1,0,20,0,-20
4800,0,0,67,0,-67
4801,1,1,728,1432,704
4802,1,0,38,0,-38
4803,1,0,20,0,-20
4804,1,1,429,1339,910
4805,1,0,8,0,-8
4806,1,0,112,0,-112
4807,0,0,6,0,-6
4808,0,0,73,0,-73
4809,1,0,34,0,-34
4810,1,1,179,2113,1934
4811,1,0,99,0,-99
4812,0,0,16,0,-16
4813,1,1,697,1819,1122
4814,1,1,118,1237,1119
4815,0,0,21,0,-21
4816,1,1,933,1413,480
4817,1,1,653,1255,602
4818,1,1,415,2754,2339
4819,0,0,12,0,-12
4820,1,1,717,1562,845
4821,1,0,42,0,-42
4822,1,1,75,2926,2851
4823,1,1,322,1255,933
4824,1,1,453,1331,878
4825,1,1,604,2896,2292
4826,1,1,1008,1350,342
4827,1,0,4,0,-4
4828,1,0,35,0,-35
4829,0,0,16,0,-16
4830,0,0,1,0,-1
4831,1,0,164,0,-164
4832,1,1,347,1399,1052
4833,1,0,11,0,-11
4834,1,1,715,1316,601
4835,0,0,81,0,-81
4836,0,0,40,0,-40
4837,1,1,282,1590,1308
4838,1,0,84,0,-84
4839,0,0,107,0,-107
4840,0,0,37,0,-37
4841,1,1,1527,1597,70
4842,0,0,6,0,-6
4843,0,0,63,0,-63
4844,1,0,92,0,-92
4845,0,0,3,0,-3
4846,0,0,12,0,-12
4847,1,0,23,0,-23
4848,0,0,82,0,-82
4849,0,0,0,0,0
4850,1,1,182,1365,1183
4851,0,0,10,0,-10
4852,1,1,143,1243,1100
4853,0,0,46,0,-46
4854,1,1,504,1700,1196
4855,1,0,49,0,-49
4856,1,0,89,0,-89
4857,1,0,64,0,-64
4858,0,0,42,0,-42
4859,1,1,1218,1205,-13
4860,1,0,51,0,-51
4861,1,0,34,0,-34
4862,1,1,950,1274,324
4863,0,0,41,0,-41
4864,1,1,589,1206,617
4865,1,0,18,0,-18
4866,1,1,630,1212,582
4867,0,0,15,0,-15
4868,1,0,67,0,-67
4869,1,1,682,1512,830
4870,1,1,208,1706,1498
4871,1,0,3,0,-3
4872,0,0,25,0,-25
4873,1,0,109,0,-109
4874,1,1,211,1845,1634
4875,1,1,1040,1549,509
4876,1,1,552,1326,774
4877,0,0,34,0,-34
4878,1,1,210,1238,1028
4879,1,1,1059,1446,387
4880,1,1,231,1803,1572
4881,1,1,742,1235,493
4882,0,0,15,0,-15
4883,1,1,246,1316,1070
4884,1,0,54,0,-54
4885,1,0,77,0,-77
4886,1,1,111,1441,1330
4887,0,0,26,0,-26
4888,1,1,1225,1448,223
4889,1,1,45,2440,2395
4890,1,1,866,1339,473
4891,1,1,66,1302,1236
4892,1,0,12,0,-12
4893,0,0,104,0,-104
4894,0,0,2,0,-2
4895,1,1,76,1303,1227
4896,0,0,1,0,-1
4897,1,0,6,0,-6
4898,0,0,67,0,-67
4899,1,1,163,1467,1304
4900,1,0,11,0,-11
4901,0,0,115,0,-115
4902,1,0,94,0,-94
4903,0,0,15,0,-15
4904,0,0,20,0,-20
4905,0,0,162,0,-162
4906,1,0,6,0,-6
4907,0,0,36,0,-36
4908,1,1,658,1599,941
4909,1,1,160,1862,1702
4910,0,0,5,0,-5
4911,1,0,11,0,-11
4912,1,1,439,1400,961
4913,1,0,114,0,-114
4914,0,0,12,0,-12
4915,1,1,205,1376,1171
4916,0,0,4,0,-4
4917,1,1,1042,1542,500
4918,1,0,92,0,-92
4919,0,0,35,0,-35
4920,1,1,1154,1756,602
4921,0,0,58,0,-58
4922,1,1,925,1756,831
4923,1,1,1353,1232,-121
4924,0,0,102,0,-102
4925,1,1,1311,1254,-57
4926,1,0,10,0,-10
4927,1,0,58,0,-58
4928,1,0,59,0,-59
4929,1,0,45,0,-45
4930,1,1,356,1286,930
4931,0,0,54,0,-54
4932,1,0,26,0,-26
4933,1,0,58,0,-58
4934,1,0,61,0,-61
4935,0,0,22,0,-22
4936,0,0,131,0,-131
4937,0,0,58,0,-58
4938,0,0,34,0,-34
4939,1,1,545,1327,782
4940,1,1,3322,1887,-1435
4941,0,0,18,0,-18
4942,0,0,31,0,-31
4943,0,0,70,0,-70
4944,1,0,42,0,-42
4945,0,0,40,0,-40
4946,0,0,30,0,-30
4947,1,0,5,0,-5
4948,1,0,31,0,-31
4949,0,0,68,0,-68
4950,0,0,51,0,-51
4951,0,0,5,0,-5
4952,1,1,73,1383,1310
4953,0,0,127,0,-127
4954,0,0,76,0,-76
4955,0,0,71,0,-71
4956,0,0,105,0,-105
4957,0,0,10,0,-10
4958,0,0,13,0,-13
4959,0,0,28,0,-28
4960,0,0,55,0,-55
4961,1,0,11,0,-11
4962,1,0,31,0,-31
4963,0,0,24,0,-24
4964,0,0,8,0,-8
4965,0,0,3,0,-3
4966,0,0,43,0,-43
4967,1,1,254,1412,1158
4968,1,1,167,1212,1045
4969,0,0,66,0,-66
4970,1,0,6,0,-6
4971,0,0,44,0,-44
4972,1,0,29,0,-29
4973,0,0,48,0,-48
4974,1,0,42,0,-42
4975,0,0,1,0,-1
4976,0,0,4,0,-4
4977,0,0,48,0,-48
4978,0,0,85,0,-85
4979,1,0,153,0,-153
4980,1,1,319,1316,997
4981,0,0,48,0,-48
4982,1,0,16,0,-16
4983,0,0,53,0,-53
4984,1,0,3,0,-3
4985,1,0,43,0,-43
4986,1,0,21,0,-21
4987,1,1,104,1301,1197
4988,1,1,1365,1236,-129
4989,1,0,2,0,-2
4990,0,0,15,0,-15
4991,0,0,14,0,-14
4992,0,0,4,0,-4
4993,0,0,27,0,-27
4994,0,0,49,0,-49
4995,1,1,170,1255,1085
4996,0,0,3,0,-3
4997,1,1,132,1289,1157
4998,0,0,164,0,-164
4999,1,1,450,1246,796
5000,1,0,42,0,-42
5001,0,0,8,0,-8
5002,1,0,4,0,-4
5003,1,0,1,0,-1
5004,1,0,12,0,-12
5005,0,0,36,0,-36
5006,1,1,675,1226,551
5007,1,1,94,2347,2253
5008,1,1,156,1567,1411
5009,0,0,46,0,-46
5010,1,0,11,0,-11
5011,1,1,235,3318,3083
5012,1,1,649,1290,641
5013,1,0,69,0,-69
5014,0,0,109,0,-109
5015,1,1,169,1637,1468
5016,1,1,245,1955,1710
5017,0,0,30,0,-30
5018,1,0,89,0,-89
5019,0,0,72,0,-72
5020,0,0,59,0,-59
5021,1,0,65,0,-65
5022,1,0,11,0,-11
5023,0,0,85,0,-85
5024,1,0,28,0,-28
5025,1,1,324,1694,1370
5026,1,1,285,1925,1640
5027,1,0,27,0,-27
5028,1,0,0,0,0
5029,1,0,57,0,-57
5030,0,0,6,0,-6
5031,0,0,8,0,-8
5032,1,0,122,0,-122
5033,0,0,32,0,-32
5034,1,1,384,2397,2013
5035,0,0,47,0,-47
5036,1,0,88,0,-88
5037,1,0,41,0,-41
5038,1,1,515,1792,1277
5039,1,1,1708,1916,208
5040,1,1,257,3810,3553
5041,1,1,1102,1318,216
5042,0,0,3,0,-3
5043,0,0,3,0,-3
5044,1,0,186,0,-186
5045,1,0,56,0,-56
5046,1,1,436,1474,1038
5047,1,1,234,1497,1263
5048,1,0,7,0,-7
5049,1,0,60,0,-60
5050,0,0,61,0,-61
5051,1,1,299,1330,1031
5052,1,1,874,1349,475
5053,1,1,182,1220,1038
5054,1,1,306,1219,913
5055,1,0,3,0,-3
5056,0,0,74,0,-74
5057,1,1,427,1825,1398
5058,1,0,31,0,-31
5059,0,0,82,0,-82
5060,0,0,71,0,-71
5061,1,1,70,3021,2951
5062,1,0,37,0,-37
5063,1,0,9,0,-9
5064,1,1,489,2553,2064
5065,1,1,990,1387,397
5066,0,0,4,0,-4
5067,1,1,140,1226,1086
5068,1,0,219,0,-219
5069,0,0,175,0,-175
5070,1,0,157,0,-157
5071,1,0,36,0,-36
5072,1,0,43,0,-43
5073,0,0,43,0,-43
5074,1,0,122,0,-122
5075,1,0,45,0,-45
5076,1,0,234,0,-234
5077,0,0,73,0,-73
5078,0,0,28,0,-28
5079,0,0,19,0,-19
5080,1,1,237,1491,1254
5081,0,0,11,0,-11
5082,1,0,47,0,-47
5083,1,1,549,1254,705
5084,1,0,82,0,-82
5085,0,0,3,0,-3
5086,0,0,8,0,-8
5087,1,1,1727,1206,-521
5088,0,0,51,0,-51
5089,1,0,12,0,-12
5090,1,0,112,0,-112
5091,0,0,9,0,-9
5092,1,1,533,1290,757
5093,1,1,193,1786,1593
5094,1,1,529,1491,962
5095,0,0,90,0,-90
5096,0,0,25,0,-25
5097,0,0,6,0,-6
5098,1,0,48,0,-48
5099,1,0,9,0,-9
5100,1,1,627,2659,2032
5101,0,0,56,0,-56
5102,1,0,43,0,-43
5103,1,1,1524,2938,1414
5104,0,0,123,0,-123
5105,1,0,18,0,-18
5106,1,1,304,1323,1019
5107,1,1,702,1330,628
5108,1,0,42,0,-42
5109,1,0,28,0,-28
5110,0,0,53,0,-53
5111,1,0,5,0,-5
5112,1,0,12,0,-12
5113,0,0,47,0,-47
5114,1,0,1,0,-1
5115,1,1,220,1622,1402
5116,1,0,56,0,-56
5117,1,1,67,1485,1418
5118,0,0,0,0,0
5119,0,0,16,0,-16
5120,1,0,98,0,-98
5121,1,1,564,1576,1012
5122,1,0,27,0,-27
5123,1,1,689,1533,844
5124,1,1,130,1638,1508
5125,1,1,433,1545,1112
5126,1,1,1253,1206,-47
5127,0,0,10,0,-10
5128,0,0,1,0,-1
5129,1,1,826,2356,1530
5130,1,1,123,1578,1455
5131,1,1,929,1490,561
5132,1,1,378,1594,1216
5133,0,0,65,0,-65
5134,0,0,10,0,-10
5135,1,1,2367,1368,-999
5136,0,0,27,0,-27
5137,0,0,19,0,-19
5138,1,1,233,2293,2060
5139,1,0,4,0,-4
5140,1,1,816,1713,897
5141,1,1,395,1553,1158
5142,0,0,22,0,-22
5143,0,0,100,0,-100
5144,0,0,134,0,-134
5145,1,1,90,1224,1134
5146,1,0,134,0,-134
5147,1,1,278,1568,1290
5148,0,0,81,0,-81
5149,0,0,38,0,-38
5150,0,0,11,0,-11
5151,1,1,243,3001,2758
5152,1,1,1428,1470,42
5153,1,1,1184,1292,108
5154,0,0,1,0,-1
5155,1,1,772,1902,1130
5156,0,0,3,0,-3
5157,1,0,11,0,-11
5158,0,0,34,0,-34
5159,0,0,46,0,-46
5160,0,0,149,0,-149
5161,0,0,34,0,-34
5162,0,0,242,0,-242
5163,1,0,0,0,0
5164,0,0,55,0,-55
5165,1,0,63,0,-63
5166,0,0,31,0,-31
5167,1,0,71,0,-71
5168,0,0,62,0,-62
5169,1,0,4,0,-4
5170,0,0,126,0,-126
5171,0,0,55,0,-55
5172,1,0,89,0,-89
5173,1,1,353,1228,875
5174,1,1,350,1377,1027
5175,1,1,693,1639,946
5176,0,0,35,0,-35
5177,0,0,23,0,-23
5178,1,1,298,1293,995
5179,1,0,75,0,-75
5180,0,0,19,0,-19
5181,1,1,1337,1349,12
5182,0,0,22,0,-22
5183,1,0,52,0,-52
5184,1,0,136,0,-136
5185,1,1,335,1241,906
5186,1,1,569,1294,725
5187,1,1,483,1326,843
5188,1,1,930,1711,781
5189,0,0,16,0,-16
5190,1,1,636,2303,1667
5191,1,0,80,0,-80
5192,0,0,6,0,-6
5193,1,0,77,0,-77
5194,1,1,1348,1417,69
5195,1,0,57,0,-57
5196,1,1,135,1585,1450
5197,0,0,41,0,-41
5198,0,0,3,0,-3
5199,1,1,954,1273,319
5200,1,0,67,0,-67
5201,0,0,34,0,-34
5202,0,0,78,0,-78
5203,1,1,145,1216,1071
5204,0,0,55,0,-55
5205,1,1,462,1203,741
5206,1,0,56,0,-56
5207,1,1,1034,1208,174
5208,1,0,42,0,-42
5209,1,0,27,0,-27
5210,1,0,69,0,-69
5211,1,1,466,1425,959
5212,0,0,26,0,-26
5213,0,0,63,0,-63
5214,0,0,20,0,-20
5215,1,1,2169,2948,779
5216,0,0,76,0,-76
5217,0,0,2,0,-2
5218,1,0,194,0,-194
5219,0,0,13,0,-13
5220,1,1,693,1234,541
5221,1,0,4,0,-4
5222,1,1,1430,3044,1614
5223,0,0,145,0,-145
5224,0,0,38,0,-38
5225,1,1,1029,1257,228
5226,1,1,581,1310,729
5227,0,0,43,0,-43
5228,1,1,290,1285,995
5229,1,0,81,0,-81
5230,0,0,12,0,-12
5231,1,1,556,1298,742
5232,1,0,8,0,-8
5233,1,0,91,0,-91
5234,1,0,10,0,-10
5235,0,0,150,0,-150
5236,1,1,238,1511,1273
5237,1,0,84,0,-84
5238,0,0,26,0,-26
5239,0,0,0,0,0
5240,0,0,38,0,-38
5241,1,0,44,0,-44
5242,0,0,101,0,-101
5243,1,1,568,1373,805
5244,1,1,1111,1315,204
5245,0,0,29,0,-29
5246,0,0,44,0,-44
5247,1,0,7,0,-7
5248,0,0,17,0,-17
5249,0,0,21,0,-21
5250,1,1,1115,1215,100
5251,1,1,892,1755,863
5252,0,0,55,0,-55
5253,1,1,464,1208,744
5254,1,1,121,1768,1647
5255,1,1,228,1344,1116
5256,0,0,15,0,-15
5257,1,1,110,1490,1380
5258,1,0,75,0,-75
5259,1,0,42,0,-42
5260,0,0,96,0,-96
5261,0,0,4,0,-4
5262,1,1,568,1910,1342
5263,1,0,109,0,-109
5264,0,0,172,0,-172
5265,1,0,0,0,0
5266,1,1,1396,1531,135
5267,0,0,25,0,-25
5268,1,0,33,0,-33
5269,1,1,1559,1245,-314
5270,1,1,127,1242,1115
5271,0,0,46,0,-46
5272,1,1,740,1351,611
5273,0,0,19,0,-19
5274,0,0,10,0,-10
5275,1,1,1338,2703,1365
5276,1,1,49,1656,1607
5277,1,1,331,1909,1578
5278,1,1,677,1433,756
5279,1,1,882,1429,547
5280,1,1,339,1333,994
5281,1,0,8,0,-8
5282,0,0,47,0,-47
5283,0,0,3,0,-3
5284,1,1,9,1456,1447
5285,1,0,73,0,-73
5286,1,1,317,1309,992
5287,0,0,20,0,-20
5288,1,0,33,0,-33
5289,0,0,52,0,-52
5290,1,0,97,0,-97
5291,1,0,10,0,-10
5292,1,1,206,1216,1010
5293,0,0,6,0,-6
5294,0,0,39,0,-39
5295,0,0,1,0,-1
5296,1,0,65,0,-65
5297,1,1,120,2487,2367
5298,1,0,14,0,-14
5299,1,0,14,0,-14
5300,1,1,878,1510,632
5301,1,0,23,0,-23
5302,0,0,115,0,-115
5303,1,1,439,1248,809
5304,1,1,976,1997,1021
5305,1,0,34,0,-34
5306,1,0,147,0,-147
5307,0,0,35,0,-35
5308,0,0,31,0,-31
5309,1,1,286,1292,1006
5310,1,0,13,0,-13
5311,1,0,114,0,-114
5312,0,0,85,0,-85
5313,1,0,127,0,-127
5314,0,0,44,0,-44
5315,1,0,5,0,-5
5316,1,0,19,0,-19
5317,1,0,114,0,-114
5318,1,1,2314,2813,499
5319,0,0,108,0,-108
5320,1,0,36,0,-36
5321,0,0,40,0,-40
5322,1,0,156,0,-156
5323,1,1,139,1428,1289
5324,1,0,16,0,-16
5325,0,0,1,0,-1
5326,0,0,12,0,-12
5327,1,1,123,1501,1378
5328,1,1,976,2609,1633
5329,0,0,5,0,-5
5330,1,0,40,0,-40
5331,0,0,54,0,-54
5332,1,0,13,0,-13
5333,1,1,414,2020,1606
5334,1,0,50,0,-50
5335,1,1,33,1205,1172
5336,0,0,39,0,-39
5337,1,0,58,0,-58
5338,1,0,98,0,-98
5339,0,0,17,0,-17
5340,1,1,326,1390,1064
5341,0,0,21,0,-21
5342,1,1,82,1500,1418
5343,1,0,13,0,-13
5344,1,1,823,1376,553
5345,0,0,56,0,-56
5346,0,0,28,0,-28
5347,1,1,114,1317,1203
5348,0,0,6,0,-6
5349,1,0,10,0,-10
5350,0,0,76,0,-76
5351,1,1,399,1383,984
5352,1,1,1027,1608,581
5353,1,0,43,0,-43
5354,0,0,14,0,-14
5355,1,0,82,0,-82
5356,0,0,6,0,-6
5357,1,0,18,0,-18
5358,1,1,1128,1205,77
5359,0,0,148,0,-148
5360,1,1,106,1210,1104
5361,1,0,9,0,-9
5362,1,0,13,0,-13
5363,1,1,131,1265,1134
5364,0,0,46,0,-46
5365,1,1,589,1394,805
5366,1,0,113,0,-113
5367,0,0,39,0,-39
5368,1,0,50,0,-50
5369,0,0,3,0,-3
5370,1,0,13,0,-13
5371,1,1,494,1476,982
5372,1,1,539,2323,1784
5373,1,1,349,2517,2168
5374,1,1,14,1523,1509
5375,0,0,11,0,-11
5376,0,0,12,0,-12
5377,0,0,130,0,-130
5378,1,0,59,0,-59
5379,0,0,22,0,-22
5380,1,0,37,0,-37
5381,1,1,418,2319,1901
5382,0,0,94,0,-94
5383,0,0,9,0,-9
5384,1,0,23,0,-23
5385,0,0,39,0,-39
5386,1,0,84,0,-84
5387,1,0,1,0,-1
5388,1,0,6,0,-6
5389,0,0,7,0,-7
5390,1,0,94,0,-94
5391,1,0,8,0,-8
5392,1,1,1561,1532,-29
5393,1,1,908,1770,862
5394,1,0,17,0,-17
5395,0,0,47,0,-47
5396,1,1,416,1488,1072
5397,0,0,4,0,-4
5398,0,0,80,0,-80
5399,1,0,19,0,-19
5400,0,0,21,0,-21
5401,0,0,47,0,-47
5402,1,1,233,1497,1264
5403,1,0,28,0,-28
5404,1,0,22,0,-22
5405,1,0,13,0,-13
5406,1,0,92,0,-92
5407,1,0,74,0,-74
5408,1,1,585,1342,757
5409,0,0,19,0,-19
5410,1,1,1099,1202,103
5411,1,0,184,0,-184
5412,0,0,12,0,-12
5413,0,0,75,0,-75
5414,0,0,190,0,-190
5415,0,0,6,0,-6
5416,1,1,148,1713,1565
5417,1,1,178,1253,1075
5418,1,1,243,1358,1115
5419,1,0,65,0,-65
5420,1,0,48,0,-48
5421,1,0,71,0,-71
5422,0,0,69,0,-69
5423,1,1,1025,1291,266
5424,1,0,44,0,-44
5425,1,0,73,0,-73
5426,1,1,1062,1283,221
5427,1,1,1157,2213,1056
5428,1,0,141,0,-141
5429,1,1,468,2183,1715
5430,0,0,132,0,-132
5431,0,0,9,0,-9
5432,0,0,59,0,-59
5433,0,0,27,0,-27
5434,0,0,7,0,-7
5435,1,0,51,0,-51
5436,1,1,174,1224,1050
5437,0,0,11,0,-11
5438,1,1,1151,1781,630
5439,1,1,462,1825,1363
5440,1,0,28,0,-28
5441,1,0,138,0,-138
5442,0,0,26,0,-26
5443,0,0,51,0,-51
5444,1,1,62,1287,1225
5445,1,1,308,3028,2720
5446,1,0,107,0,-107
5447,1,1,1624,1267,-357
5448,1,0,5,0,-5
5449,1,1,581,1235,654
5450,1,1,357,1637,1280
5451,0,0,47,0,-47
5452,0,0,7,0,-7
5453,0,0,23,0,-23
5454,0,0,61,0,-61
5455,1,0,111,0,-111
5456,1,0,12,0,-12
5457,1,0,41,0,-41
5458,1,0,8,0,-8
5459,1,1,310,1694,1384
5460,0,0,4,0,-4
5461,1,0,43,0,-43
5462,0,0,43,0,-43
5463,1,1,1470,2335,865
5464,0,0,30,0,-30
5465,1,0,7,0,-7
5466,1,1,240,1413,1173
5467,0,0,105,0,-105
5468,0,0,66,0,-66
5469,1,0,53,0,-53
5470,1,0,52,0,-52
5471,1,1,755,1385,630
5472,1,1,196,1283,1087
5473,1,0,19,0,-19
5474,1,1,1102,1371,269
5475,1,0,33,0,-33
5476,1,0,68,0,-68
5477,1,0,35,0,-35
5478,1,0,26,0,-26
5479,0,0,7,0,-7
5480,1,1,344,2364,2020
5481,0,0,46,0,-46
5482,1,0,4,0,-4
5483,0,0,34,0,-34
5484,1,1,2472,1205,-1267
5485,0,0,2,0,-2
5486,0,0,8,0,-8
5487,1,0,121,0,-121
5488,0,0,138,0,-138
5489,1,1,1145,1220,75
5490,1,1,334,1937,1603
5491,1,0,1,0,-1
5492,1,1,391,1268,877
5493,0,0,15,0,-15
5494,1,1,127,1253,1126
5495,0,0,7,0,-7
5496,0,0,171,0,-171
5497,0,0,161,0,-161
5498,0,0,56,0,-56
5499,1,1,613,1212,599
5500,1,0,176,0,-176
5501,0,0,47,0,-47
5502,0,0,33,0,-33
5503,0,0,93,0,-93
5504,0,0,57,0,-57
5505,0,0,14,0,-14
5506,0,0,69,0,-69
5507,0,0,5,0,-5
5508,1,0,2,0,-2
5509,0,0,14,0,-14
5510,1,1,1308,1589,281
5511,0,0,5,0,-5
5512,0,0,60,0,-60
5513,1,0,77,0,-77
5514,1,0,14,0,-14
5515,0,0,20,0,-20
5516,0,0,41,0,-41
5517,0,0,5,0,-5
5518,1,1,481,1874,1393
5519,0,0,90,0,-90
5520,1,1,143,1789,1646
5521,0,0,18,0,-18
5522,0,0,0,0,0
5523,1,0,31,0,-31
5524,1,1,690,1493,803
5525,1,0,30,0,-30
5526,0,0,100,0,-100
5527,0,0,116,0,-116
5528,1,1,14,1349,1335
5529,0,0,68,0,-68
5530,1,0,21,0,-21
5531,1,0,88,0,-88
5532,0,0,121,0,-121
5533,0,0,24,0,-24
5534,0,0,70,0,-70
5535,0,0,38,0,-38
5536,1,0,30,0,-30
5537,0,0,3,0,-3
5538,0,0,5,0,-5
5539,1,0,17,0,-17
5540,0,0,10,0,-10
5541,1,0,53,0,-53
5542,0,0,16,0,-16
5543,1,1,465,1332,867
5544,0,0,87,0,-87
5545,1,1,256,1541,1285
5546,1,0,14,0,-14
5547,1,0,4,0,-4
5548,1,0,87,0,-87
5549,0,0,87,0,-87
5550,1,0,46,0,-46
5551,1,1,390,1410,1020
5552,1,1,103,1359,1256
5553,0,0,151,0,-151
5554,1,0,69,0,-69
5555,1,1,306,1248,942
5556,0,0,13,0,-13
5557,0,0,22,0,-22
5558,0,0,19,0,-19
5559,0,0,67,0,-67
5560,1,0,55,0,-55
5561,1,0,210,0,-210
5562,1,1,582,1226,644
5563,1,1,373,1593,1220
5564,1,1,486,1703,1217
5565,1,1,693,1361,668
5566,1,1,430,2208,1778
5567,1,1,558,1671,1113
5568,1,1,371,1329,958
5569,0,0,107,0,-107
5570,1,0,16,0,-16
5571,1,0,55,0,-55
5572,1,1,570,1628,1058
5573,1,0,38,0,-38
5574,1,1,515,1255,740
5575,0,0,20,0,-20
5576,1,0,65,0,-65
5577,0,0,5,0,-5
5578,0,0,22,0,-22
5579,0,0,57,0,-57
5580,1,1,90,1355,1265
5581,1,1,433,1734,1301
5582,1,0,91,0,-91
5583,0,0,142,0,-142
5584,0,0,20,0,-20
5585,0,0,37,0,-37
5586,1,0,26,0,-26
5587,0,0,73,0,-73
5588,0,0,29,0,-29
5589,1,0,90,0,-90
5590,1,1,675,1464,789
5591,1,0,19,0,-19
5592,0,0,52,0,-52
5593,1,1,864,1514,650
5594,1,0,90,0,-90
5595,0,0,172,0,-172
5596,1,0,164,0,-164
5597,1,1,850,2499,1649
5598,1,0,17,0,-17
5599,1,1,3324,1244,-2080
5600,1,1,255,2026,1771
5601,1,1,860,2047,1187
5602,0,0,104,0,-104
5603,1,1,349,1560,1211
5604,0,0,51,0,-51
5605,1,1,1789,1523,-266
5606,1,1,861,2239,1378
5607,1,0,63,0,-63
5608,1,0,20,0,-20
5609,1,0,11,0,-11
5610,0,0,79,0,-79
5611,1,1,151,1273,1122
5612,1,1,1438,1580,142
5613,1,1,322,1286,964
5614,1,1,101,1280,1179
5615,0,0,33,0,-33
5616,1,0,55,0,-55
5617,0,0,12,0,-12
5618,1,1,21,1326,1305
5619,1,0,5,0,-5
5620,1,0,124,0,-124
5621,1,0,32,0,-32
5622,0,0,59,0,-59
5623,0,0,32,0,-32
5624,1,0,72,0,-72
5625,1,1,261,1366,1105
5626,1,0,4,0,-4
5627,1,1,136,1398,1262
5628,1,1,444,1201,757
5629,0,0,13,0,-13
5630,1,0,7,0,-7
5631,1,1,529,1220,691
5632,1,1,128,1458,1330
5633,0,0,103,0,-103
5634,0,0,72,0,-72
5635,0,0,164,0,-164
5636,1,0,39,0,-39
5637,1,1,482,1339,857
5638,1,1,1271,1883,612
5639,0,0,92,0,-92
5640,1,0,11,0,-11
5641,1,1,567,1325,758
5642,1,1,509,1205,696
5643,1,0,44,0,-44
5644,1,0,10,0,-10
5645,1,1,43,1328,1285
5646,0,0,29,0,-29
5647,0,0,30,0,-30
5648,1,0,69,0,-69
5649,0,0,6,0,-6
5650,1,1,139,1386,1247
5651,1,1,861,1573,712
5652,1,1,581,1388,807
5653,1,1,648,2371,1723
5654,1,1,173,1452,1279
5655,1,1,171,1731,1560
5656,1,1,2406,1353,-1053
5657,1,1,723,1309,586
5658,1,1,977,1417,440
5659,1,0,121,0,-121
5660,1,0,85,0,-85
5661,1,0,116,0,-116
5662,1,1,531,2041,1510
5663,1,0,40,0,-40
5664,1,1,623,1506,883
5665,1,1,686,1287,601
5666,0,0,3,0,-3
5667,1,0,149,0,-149
5668,0,0,6,0,-6
5669,0,0,101,0,-101
5670,1,0,43,0,-43
5671,1,1,529,1543,1014
5672,1,1,257,1242,985
5673,1,1,186,1353,1167
5674,1,1,309,1215,906
5675,0,0,13,0,-13
5676,0,0,70,0,-70
5677,0,0,95,0,-95
5678,0,0,143,0,-143
5679,1,0,27,0,-27
5680,1,0,3,0,-3
5681,0,0,30,0,-30
5682,0,0,44,0,-44
5683,1,1,13,1594,1581
5684,1,0,51,0,-51
5685,1,0,41,0,-41
5686,0,0,14,0,-14
5687,0,0,32,0,-32
5688,1,0,16,0,-16
5689,1,0,51,0,-51
5690,0,0,8,0,-8
5691,0,0,69,0,-69
5692,1,1,95,1382,1287
5693,1,0,38,0,-38
5694,1,0,22,0,-22
5695,1,1,427,1344,917
5696,0,0,1,0,-1
5697,0,0,110,0,-110
5698,0,0,89,0,-89
5699,1,0,20,0,-20
5700,0,0,27,0,-27
5701,1,0,8,0,-8
5702,0,0,36,0,-36
5703,1,0,20,0,-20
5704,1,0,66,0,-66
5705,0,0,70,0,-70
5706,1,1,836,1964,1128
5707,0,0,53,0,-53
5708,0,0,89,0,-89
5709,1,1,1228,1728,500
5710,0,0,152,0,-152
5711,1,0,112,0,-112
5712,1,1,636,1575,939
5713,0,0,60,0,-60
5714,0,0,8,0,-8
5715,1,1,177,1257,1080
5716,1,1,669,1228,559
5717,1,0,47,0,-47
5718,1,0,72,0,-72
5719,1,0,0,0,0
5720,1,1,665,1365,700
5721,1,1,338,2121,1783
5722,1,1,105,1341,1236
5723,0,0,113,0,-113
5724,1,0,9,0,-9
5725,0,0,7,0,-7
5726,1,1,164,1592,1428
5727,1,1,426,1230,804
5728,1,1,968,1252,284
5729,0,0,44,0,-44
5730,1,1,770,1536,766
5731,0,0,21,0,-21
5732,0,0,57,0,-57
5733,1,0,0,0,0
5734,0,0,11,0,-11
5735,1,0,53,0,-53
5736,1,1,92,1832,1740
5737,1,0,14,0,-14
5738,1,1,271,1352,1081
5739,0,0,59,0,-59
5740,0,0,67,0,-67
5741,1,0,13,0,-13
5742,0,0,6,0,-6
5743,1,0,78,0,-78
5744,0,0,91,0,-91
5745,0,0,23,0,-23
5746,0,0,42,0,-42
5747,0,0,49,0,-49
5748,0,0,45,0,-45
5749,1,1,705,1890,1185
5750,1,1,200,1830,1630
5751,1,1,234,1218,984
5752,0,0,7,0,-7
5753,1,1,55,1733,1678
5754,0,0,11,0,-11
5755,1,1,904,1422,518
5756,1,0,5,0,-5
5757,1,1,2089,1478,-611
5758,1,0,20,0,-20
5759,1,0,29,0,-29
5760,0,0,2,0,-2
5761,1,1,924,1324,400
5762,0,0,12,0,-12
5763,1,0,57,0,-57
5764,1,1,483,1242,759
5765,0,0,43,0,-43
5766,0,0,162,0,-162
5767,1,0,41,0,-41
5768,1,0,31,0,-31
5769,1,1,152,1356,1204
5770,1,1,456,1721,1265
5771,1,0,65,0,-65
5772,0,0,72,0,-72
5773,0,0,29,0,-29
5774,1,0,18,0,-18
5775,1,1,895,1592,697
5776,0,0,12,0,-12
5777,1,1,256,1556,1300
5778,1,0,24,0,-24
5779,1,1,78,1470,1392
5780,1,1,685,1684,999
5781,1,1,609,2166,1557
5782,1,1,570,1270,700
5783,1,0,67,0,-67
5784,0,0,10,0,-10
5785,1,1,1144,1252,108
5786,0,0,73,0,-73
5787,0,0,3,0,-3
5788,0,0,70,0,-70
5789,1,1,347,1203,856
5790,0,0,208,0,-208
5791,1,0,162,0,-162
5792,0,0,138,0,-138
5793,1,1,678,1335,657
5794,1,1,435,1208,773
5795,1,0,1,0,-1
5796,0,0,85,0,-85
5797,1,1,117,1304,1187
5798,1,0,47,0,-47
5799,1,0,457,0,-457
5800,1,1,1233,1445,212
5801,0,0,274,0,-274
5802,1,1,182,1493,1311
5803,1,1,407,2639,2232
5804,1,0,15,0,-15
5805,1,0,5,0,-5
5806,0,0,9,0,-9
5807,1,1,40,1235,1195
5808,1,0,13,0,-13
5809,1,0,29,0,-29
5810,1,0,31,0,-31
5811,0,0,61,0,-61
5812,0,0,23,0,-23
5813,1,0,103,0,-103
5814,1,0,18,0,-18
5815,1,0,85,0,-85
5816,1,0,21,0,-21
5817,1,0,126,0,-126
5818,0,0,21,0,-21
5819,1,0,103,0,-103
5820,0,0,11,0,-11
5821,0,0,106,0,-106
5822,1,0,3,0,-3
5823,0,0,85,0,-85
5824,0,0,31,0,-31
5825,1,1,327,1491,1164
5826,1,0,3,0,-3
5827,1,0,110,0,-110
5828,0,0,86,0,-86
5829,1,1,629,1286,657
5830,1,1,59,1258,1199
5831,1,1,1014,2207,1193
5832,1,1,1766,1297,-469
5833,1,1,457,1293,836
5834,1,1,1536,1564,28
5835,1,0,73,0,-73
5836,0,0,165,0,-165
5837,0,0,77,0,-77
5838,0,0,8,0,-8
5839,1,1,42,1296,1254
5840,0,0,28,0,-28
5841,1,0,49,0,-49
5842,1,1,54,1459,1405
5843,1,0,29,0,-29
5844,1,1,85,1861,1776
5845,0,0,54,0,-54
5846,0,0,34,0,-34
5847,0,0,1,0,-1
5848,1,0,4,0,-4
5849,1,1,602,1224,622
5850,1,0,97,0,-97
5851,1,0,36,0,-36
5852,0,0,7,0,-7
5853,1,0,5,0,-5
5854,1,1,465,1257,792
5855,1,0,20,0,-20
5856,0,0,28,0,-28
5857,1,1,174,1205,1031
5858,0,0,22,0,-22
5859,1,1,485,1385,900
5860,0,0,18,0,-18
5861,1,1,345,1512,1167
5862,1,1,244,3305,3061
5863,0,0,38,0,-38
5864,1,0,110,0,-110
5865,0,0,25,0,-25
5866,1,0,71,0,-71
5867,1,1,279,1441,1162
5868,0,0,19,0,-19
5869,0,0,25,0,-25
5870,1,0,61,0,-61
5871,1,1,2653,1208,-1445
5872,1,1,293,1320,1027
5873,0,0,95,0,-95
5874,0,0,61,0,-61
5875,0,0,37,0,-37
5876,1,0,243,0,-243
5877,1,1,1020,1708,688
5878,1,0,142,0,-142
5879,1,0,123,0,-123
5880,0,0,153,0,-153
5881,0,0,48,0,-48
5882,1,0,14,0,-14
5883,0,0,18,0,-18
5884,0,0,28,0,-28
5885,0,0,5,0,-5
5886,1,1,220,1204,984
5887,1,0,3,0,-3
5888,0,0,33,0,-33
5889,1,0,99,0,-99
5890,0,0,1,0,-1
5891,1,1,207,1280,1073
5892,0,0,53,0,-53
5893,0,0,41,0,-41
5894,1,1,413,1692,1279
5895,1,0,25,0,-25
5896,1,1,456,1701,1245
5897,1,0,2,0,-2
5898,1,1,1353,1328,-25
5899,1,1,455,1686,1231
5900,1,1,492,1236,744
5901,1,1,460,1403,943
5902,0,0,64,0,-64
5903,0,0,7,0,-7
5904,0,0,31,0,-31
5905,1,1,37,1303,1266
5906,0,0,69,0,-69
5907,0,0,118,0,-118
5908,1,1,280,1321,1041
5909,0,0,18,0,-18
5910,1,1,331,1327,996
5911,0,0,114,0,-114
5912,0,0,2,0,-2
5913,0,0,86,0,-86
5914,1,0,6,0,-6
5915,1,0,12,0,-12
5916,1,0,5,0,-5
5917,0,0,174,0,-174
5918,0,0,0,0,0
5919,1,0,103,0,-103
5920,0,0,45,0,-45
5921,1,1,1348,1509,161
5922,1,0,37,0,-37
5923,1,1,142,2016,1874
5924,1,0,29,0,-29
5925,1,0,51,0,-51
5926,1,0,59,0,-59
5927,1,1,120,1238,1118
5928,0,0,6,0,-6
5929,1,0,195,0,-195
5930,1,0,1,0,-1
5931,1,1,366,3332,2966
5932,1,0,38,0,-38
5933,1,0,58,0,-58
5934,1,0,36,0,-36
5935,1,0,14,0,-14
5936,0,0,92,0,-92
5937,0,0,9,0,-9
5938,1,0,2,0,-2
5939,1,0,5,0,-5
5940,1,1,163,1442,1279
5941,1,1,99,1359,1260
5942,0,0,130,0,-130
5943,1,0,22,0,-22
5944,0,0,54,0,-54
5945,1,0,4,0,-4
5946,1,1,104,1304,1200
5947,1,0,2,0,-2
5948,1,0,21,0,-21
5949,1,1,854,1487,633
5950,0,0,381,0,-381
5951,1,1,784,1264,480
5952,0,0,13,0,-13
5953,1,1,702,1454,752
5954,1,1,207,1378,1171
5955,0,0,10,0,-10
5956,1,1,633,2203,1570
5957,0,0,166,0,-166
5958,1,0,38,0,-38
5959,1,0,16,0,-16
5960,1,1,117,1483,1366
5961,0,0,0,0,0
5962,1,1,484,2001,1517
5963,0,0,34,0,-34
5964,1,0,118,0,-118
5965,1,0,4,0,-4
5966,1,0,134,0,-134
5967,1,0,37,0,-37
5968,1,0,33,0,-33
5969,0,0,75,0,-75
5970,1,1,929,1568,639
5971,1,1,493,1227,734
5972,1,0,51,0,-51
5973,0,0,74,0,-74
5974,0,0,11,0,-11
5975,0,0,32,0,-32
5976,1,0,0,0,0
5977,1,1,152,1375,1223
5978,1,1,756,1774,1018
5979,0,0,3,0,-3
5980,1,0,71,0,-71
5981,1,0,3,0,-3
5982,1,0,161,0,-161
5983,1,0,2,0,-2
5984,1,0,16,0,-16
5985,0,0,51,0,-51
5986,1,1,1050,1610,560
5987,0,0,53,0,-53
5988,0,0,90,0,-90
5989,1,1,3059,1307,-1752
5990,1,0,93,0,-93
5991,1,1,61,1775,1714
5992,1,1,271,2082,1811
5993,0,0,309,0,-309
5994,1,1,383,1299,916
5995,0,0,1,0,-1
5996,0,0,60,0,-60
5997,0,0,2,0,-2
5998,0,0,44,0,-44
5999,1,1,338,1838,1500
6000,1,0,83,0,-83
6001,0,0,24,0,-24
6002,0,0,51,0,-51
6003,1,1,228,1249,1021
6004,1,1,848,1314,466
6005,0,0,6,0,-6
6006,1,1,768,1454,686
6007,1,0,109,0,-109
6008,1,1,388,1612,1224
6009,0,0,54,0,-54
6010,1,0,49,0,-49
6011,1,1,806,1331,525
6012,1,1,764,3653,2889
6013,1,1,826,1387,561
6014,0,0,34,0,-34
6015,1,0,9,0,-9
6016,0,0,18,0,-18
6017,0,0,32,0,-32
6018,0,0,65,0,-65
6019,0,0,14,0,-14
6020,0,0,65,0,-65
6021,0,0,62,0,-62
6022,0,0,6,0,-6
6023,1,0,11,0,-11
6024,0,0,23,0,-23
6025,1,1,363,1335,972
6026,1,0,3,0,-3
6027,1,1,1910,2210,300
6028,1,0,15,0,-15
6029,1,0,32,0,-32
6030,1,0,15,0,-15
6031,1,0,17,0,-17
6032,0,0,68,0,-68
6033,0,0,37,0,-37
6034,1,1,526,1713,1187
6035,0,0,35,0,-35
6036,0,0,60,0,-60
6037,1,0,98,0,-98
6038,0,0,60,0,-60
6039,0,0,0,0,0
6040,1,1,1452,1627,175
6041,1,0,44,0,-44
6042,0,0,13,0,-13
6043,0,0,68,0,-68
6044,0,0,8,0,-8
6045,0,0,262,0,-262
6046,0,0,20,0,-20
6047,0,0,110,0,-110
6048,1,1,1894,1780,-114
6049,1,0,31,0,-31
6050,1,1,75,1599,1524
6051,0,0,46,0,-46
6052,1,1,1102,1306,204
6053,0,0,49,0,-49
6054,1,1,622,1268,646
6055,1,0,61,0,-61
6056,0,0,36,0,-36
6057,1,1,183,1669,1486
6058,1,0,12,0,-12
6059,0,0,58,0,-58
6060,1,1,263,1223,960
6061,0,0,78,0,-78
6062,0,0,83,0,-83
6063,1,1,484,4253,3769
6064,1,0,15,0,-15
6065,1,1,623,1210,587
6066,1,1,272,1254,982
6067,0,0,1,0,-1
6068,1,0,28,0,-28
6069,0,0,50,0,-50
6070,0,0,10,0,-10
6071,1,1,1604,1508,-96
6072,0,0,2,0,-2
6073,1,1,150,2141,1991
6074,0,0,13,0,-13
6075,1,0,266,0,-266
6076,1,1,390,1298,908
6077,0,0,16,0,-16
6078,1,0,80,0,-80
6079,1,0,67,0,-67
6080,1,1,1434,1748,314
6081,0,0,81,0,-81
6082,0,0,31,0,-31
6083,0,0,4,0,-4
6084,0,0,15,0,-15
6085,1,0,76,0,-76
6086,1,1,1820,1731,-89
6087,1,0,45,0,-45
6088,1,1,498,1232,734
6089,1,1,660,1205,545
6090,0,0,60,0,-60
6091,1,0,45,0,-45
6092,1,1,1076,1568,492
6093,1,1,178,1240,1062
6094,1,1,396,1341,945
6095,0,0,10,0,-10
6096,1,1,175,1279,1104
6097,1,1,365,1214,849
6098,0,0,82,0,-82
6099,0,0,68,0,-68
6100,1,1,187,1432,1245
6101,0,0,39,0,-39
6102,1,1,906,2336,1430
6103,0,0,24,0,-24
6104,1,1,187,1272,1085
6105,0,0,58,0,-58
6106,1,0,22,0,-22
6107,1,1,576,1370,794
6108,1,1,103,1306,1203
6109,0,0,9,0,-9
6110,0,0,15,0,-15
6111,0,0,42,0,-42
6112,1,0,138,0,-138
6113,1,0,88,0,-88
6114,1,0,20,0,-20
6115,1,1,478,1245,767
6116,1,1,470,1353,883
6117,1,1,361,1835,1474
6118,0,0,227,0,-227
6119,0,0,4,0,-4
6120,0,0,81,0,-81
6121,1,0,2,0,-2
6122,1,0,4,0,-4
6123,1,0,0,0,0
6124,1,1,820,2692,1872
6125,0,0,3,0,-3
6126,1,0,47,0,-47
6127,1,1,779,1228,449
6128,1,1,543,1429,886
6129,0,0,20,0,-20
6130,1,0,24,0,-24
6131,1,1,304,2125,1821
6132,0,0,18,0,-18
6133,0,0,46,0,-46
6134,1,1,1579,1345,-234
6135,1,0,24,0,-24
6136,1,0,115,0,-115
6137,0,0,100,0,-100
6138,1,1,151,1326,1175
6139,1,0,39,0,-39
6140,1,0,81,0,-81
6141,1,0,3,0,-3
6142,1,0,30,0,-30
6143,0,0,210,0,-210
6144,1,0,91,0,-91
6145,0,0,22,0,-22
6146,0,0,103,0,-103
6147,0,0,34,0,-34
6148,1,0,86,0,-86
6149,1,0,18,0,-18
6150,1,1,787,1296,509
6151,1,1,106,1985,1879
6152,1,0,24,0,-24
6153,1,1,1269,1425,156
6154,0,0,13,0,-13
6155,1,1,55,1209,1154
6156,0,0,8,0,-8
6157,0,0,34,0,-34
6158,0,0,2,0,-2
6159,1,0,91,0,-91
6160,0,0,23,0,-23
6161,1,1,1233,1327,94
6162,1,0,72,0,-72
6163,0,0,1,0,-1
6164,1,0,6,0,-6
6165,1,1,107,1472,1365
6166,1,1,357,2433,2076
6167,1,1,846,1331,485
6168,1,0,121,0,-121
6169,0,0,12,0,-12
6170,0,0,23,0,-23
6171,1,1,201,1356,1155
6172,0,0,68,0,-68
6173,1,1,403,2263,1860
6174,0,0,35,0,-35
6175,1,1,51,1211,1160
6176,1,1,229,1300,1071
6177,0,0,23,0,-23
6178,1,0,64,0,-64
6179,0,0,223,0,-223
6180,0,0,22,0,-22
6181,1,1,871,3357,2486
6182,0,0,0,0,0
6183,0,0,34,0,-34
6184,1,0,12,0,-12
6185,1,0,6,0,-6
6186,0,0,48,0,-48
6187,1,1,182,2929,2747
6188,0,0,19,0,-19
6189,1,1,1963,1537,-426
6190,0,0,108,0,-108
6191,1,0,38,0,-38
6192,1,1,895,1475,580
6193,0,0,60,0,-60
6194,1,1,1828,1239,-589
6195,0,0,3,0,-3
6196,0,0,272,0,-272
6197,0,0,105,0,-105
6198,0,0,5,0,-5
6199,1,1,1858,1483,-375
6200,1,0,15,0,-15
6201,1,0,10,0,-10
6202,0,0,72,0,-72
6203,1,1,1096,1677,581
6204,0,0,55,0,-55
6205,0,0,11,0,-11
6206,1,0,24,0,-24
6207,1,0,62,0,-62
6208,0,0,19,0,-19
6209,0,0,30,0,-30
6210,0,0,19,0,-19
6211,1,0,29,0,-29
6212,1,0,0,0,0
6213,1,0,26,0,-26
6214,1,1,190,1723,1533
6215,0,0,42,0,-42
6216,1,1,320,1270,950
6217,0,0,6,0,-6
6218,0,0,84,0,-84
6219,1,1,109,1223,1114
6220,0,0,0,0,0
6221,0,0,104,0,-104
6222,1,1,657,1307,650
6223,0,0,87,0,-87
6224,0,0,27,0,-27
6225,1,1,335,1368,1033
6226,0,0,55,0,-55
6227,1,0,166,0,-166
6228,1,1,1272,2646,1374
6229,0,0,36,0,-36
6230,1,0,11,0,-11
6231,0,0,21,0,-21
6232,1,1,173,1620,1447
6233,0,0,48,0,-48
6234,0,0,14,0,-14
6235,0,0,38,0,-38
6236,1,0,39,0,-39
6237,1,0,108,0,-108
6238,1,0,85,0,-85
6239,0,0,207,0,-207
6240,0,0,37,0,-37
6241,1,1,234,1453,1219
6242,1,1,1365,1557,192
6243,1,0,42,0,-42
6244,0,0,52,0,-52
6245,1,0,131,0,-131
6246,1,0,10,0,-10
6247,1,1,1198,1817,619
6248,0,0,162,0,-162
6249,1,1,108,1281,1173
6250,1,0,4,0,-4
6251,0,0,18,0,-18
6252,0,0,88,0,-88
6253,0,0,68,0,-68
6254,1,0,24,0,-24
6255,1,1,122,1375,1253
6256,1,0,29,0,-29
6257,1,0,55,0,-55
6258,0,0,179,0,-179
6259,0,0,28,0,-28
6260,1,0,116,0,-116
6261,0,0,36,0,-36
6262,1,1,868,1335,467
6263,0,0,2,0,-2
6264,0,0,137,0,-137
6265,1,1,812,3322,2510
6266,1,0,26,0,-26
6267,1,0,16,0,-16
6268,1,0,16,0,-16
6269,1,0,21,0,-21
6270,1,1,260,1353,1093
6271,1,0,42,0,-42
6272,1,0,70,0,-70
6273,0,0,4,0,-4
6274,1,1,1238,1244,6
6275,1,1,474,1260,786
6276,1,1,630,1224,594
6277,1,1,1451,1295,-156
6278,1,1,69,1400,1331
6279,1,1,264,1666,1402
6280,0,0,137,0,-137
6281,1,1,250,1434,1184
6282,1,0,25,0,-25
6283,1,1,227,1877,1650
6284,0,0,131,0,-131
6285,1,1,179,1215,1036
6286,1,1,273,1292,1019
6287,1,0,1,0,-1
6288,1,1,1576,1299,-277
6289,0,0,77,0,-77
6290,1,1,178,1501,1323
6291,0,0,10,0,-10
6292,0,0,61,0,-61
6293,0,0,36,0,-36
6294,1,1,424,1200,776
6295,0,0,43,0,-43
6296,1,0,20,0,-20
6297,1,0,0,0,0
6298,0,0,1,0,-1
6299,0,0,29,0,-29
6300,1,0,73,0,-73
6301,1,1,695,1376,681
6302,0,0,95,0,-95
6303,1,1,542,4642,4100
6304,1,1,1023,1524,501
6305,1,0,439,0,-439
6306,0,0,25,0,-25
6307,1,0,37,0,-37
6308,1,0,90,0,-90
6309,1,1,729,1782,1053
6310,0,0,115,0,-115
6311,0,0,0,0,0
6312,1,1,277,1419,1142
6313,1,1,2903,1483,-1420
6314,0,0,11,0,-11
6315,1,1,351,3498,3147
6316,1,1,104,1250,1146
6317,1,0,69,0,-69
6318,1,0,24,0,-24
6319,1,1,208,1451,1243
6320,0,0,26,0,-26
6321,0,0,57,0,-57
6322,0,0,68,0,-68
6323,0,0,25,0,-25
6324,0,0,30,0,-30
6325,1,1,640,2130,1490
6326,1,0,1,0,-1
6327,1,1,1458,2530,1072
6328,1,1,434,11828,11394
6329,1,0,137,0,-137
6330,1,1,824,1284,460
6331,0,0,0,0,0
6332,0,0,44,0,-44
6333,1,1,186,1324,1138
6334,1,1,299,1519,1220
6335,1,1,381,1215,834
6336,1,0,80,0,-80
6337,0,0,4,0,-4
6338,0,0,41,0,-41
6339,0,0,16,0,-16
6340,1,1,81,1261,1180
6341,0,0,9,0,-9
6342,0,0,73,0,-73
6343,0,0,3,0,-3
6344,1,1,234,1596,1362
6345,0,0,14,0,-14
6346,1,0,22,0,-22
6347,0,0,36,0,-36
6348,0,0,11,0,-11
6349,1,0,140,0,-140
6350,0,0,14,0,-14
6351,0,0,81,0,-81
6352,0,0,21,0,-21
6353,1,0,127,0,-127
6354,1,0,56,0,-56
6355,1,0,9,0,-9
6356,1,0,31,0,-31
6357,1,1,986,1643,657
6358,1,1,230,1953,1723
6359,0,0,175,0,-175
6360,0,0,11,0,-11
6361,0,0,59,0,-59
6362,1,0,67,0,-67
6363,1,0,167,0,-167
6364,1,1,275,2258,1983
6365,0,0,104,0,-104
6366,1,1,405,2033,1628
6367,0,0,3,0,-3
6368,1,0,78,0,-78
6369,1,0,210,0,-210
6370,1,0,202,0,-202
6371,1,0,80,0,-80
6372,1,0,78,0,-78
6373,1,0,14,0,-14
6374,1,0,61,0,-61
6375,1,1,1053,1267,214
6376,1,0,82,0,-82
6377,1,0,200,0,-200
6378,1,0,64,0,-64
6379,0,0,4,0,-4
6380,1,1,125,1306,1181
6381,1,0,27,0,-27
6382,1,1,68,2035,1967
6383,1,0,97,0,-97
6384,1,1,776,1851,1075
6385,1,1,743,1769,1026
6386,1,0,31,0,-31
6387,0,0,81,0,-81
6388,0,0,56,0,-56
6389,1,1,1529,1209,-320
6390,1,0,87,0,-87
6391,1,0,15,0,-15
6392,1,0,10,0,-10
6393,1,1,798,1332,534
6394,1,1,303,1400,1097
6395,0,0,34,0,-34
6396,0,0,10,0,-10
6397,1,1,205,1219,1014
6398,1,1,566,2226,1660
6399,0,0,15,0,-15
6400,1,0,78,0,-78
6401,0,0,27,0,-27
6402,1,0,116,0,-116
6403,0,0,24,0,-24
6404,0,0,24,0,-24
6405,1,0,95,0,-95
6406,1,1,328,1220,892
6407,0,0,35,0,-35
6408,1,0,152,0,-152
6409,1,0,58,0,-58
6410,1,1,94,2134,2040
6411,0,0,23,0,-23
6412,1,1,773,1246,473
6413,1,0,106,0,-106
6414,0,0,152,0,-152
6415,1,1,1366,1296,-70
6416,0,0,93,0,-93
6417,0,0,121,0,-121
6418,1,1,173,1282,1109
6419,1,0,76,0,-76
6420,1,0,49,0,-49
6421,1,0,35,0,-35
6422,1,0,74,0,-74
6423,0,0,53,0,-53
6424,1,0,34,0,-34
6425,1,0,33,0,-33
6426,0,0,45,0,-45
6427,1,1,958,1254,296
6428,1,0,6,0,-6
6429,0,0,58,0,-58
6430,0,0,181,0,-181
6431,1,0,53,0,-53
6432,1,0,1,0,-1
6433,1,1,1263,1218,-45
6434,0,0,4,0,-4
6435,1,1,262,1213,951
6436,0,0,22,0,-22
6437,1,0,25,0,-25
6438,0,0,28,0,-28
6439,0,0,18,0,-18
6440,0,0,50,0,-50
6441,0,0,5,0,-5
6442,1,0,27,0,-27
6443,1,0,56,0,-56
6444,1,0,45,0,-45
6445,1,1,137,1595,1458
6446,0,0,55,0,-55
6447,1,0,4,0,-4
6448,1,1,195,1341,1146
6449,1,1,1252,1343,91
6450,0,0,20,0,-20
6451,0,0,25,0,-25
6452,1,0,185,0,-185
6453,0,0,105,0,-105
6454,1,1,499,1203,704
6455,1,1,636,1270,634
6456,0,0,200,0,-200
6457,1,1,61,1424,1363
6458,0,0,32,0,-32
6459,1,0,11,0,-11
6460,0,0,81,0,-81
6461,0,0,79,0,-79
6462,0,0,42,0,-42
6463,1,1,263,1318,1055
6464,0,0,79,0,-79
6465,0,0,0,0,0
6466,1,1,250,1934,1684
6467,1,1,892,1353,461
6468,0,0,3,0,-3
6469,0,0,83,0,-83
6470,0,0,2,0,-2
6471,1,0,36,0,-36
6472,1,0,90,0,-90
6473,1,0,25,0,-25
6474,1,0,307,0,-307
6475,1,0,13,0,-13
6476,1,0,49,0,-49
6477,0,0,22,0,-22
6478,0,0,14,0,-14
6479,1,0,127,0,-127
6480,0,0,14,0,-14
6481,0,0,38,0,-38
6482,1,1,1340,1828,488
6483,0,0,9,0,-9
6484,1,1,110,1200,1090
6485,1,1,92,1849,1757
6486,0,0,42,0,-42
6487,1,0,39,0,-39
6488,0,0,4,0,-4
6489,1,1,131,1746,1615
6490,1,0,5,0,-5
6491,1,0,24,0,-24
6492,0,0,127,0,-127
6493,0,0,136,0,-136
6494,1,0,33,0,-33
6495,1,1,1108,1344,236
6496,0,0,23,0,-23
6497,0,0,67,0,-67
6498,1,0,57,0,-57
6499,0,0,8,0,-8
6500,1,1,580,2112,1532
6501,1,1,206,1277,1071
6502,1,0,94,0,-94
6503,0,0,82,0,-82
6504,1,1,138,1267,1129
6505,0,0,49,0,-49
6506,0,0,64,0,-64
6507,0,0,34,0,-34
6508,0,0,24,0,-24
6509,1,1,85,1257,1172
6510,1,1,62,1756,1694
6511,1,0,44,0,-44
6512,1,1,68,1931,1863
6513,1,0,21,0,-21
6514,1,0,80,0,-80
6515,1,0,12,0,-12
6516,1,0,88,0,-88
6517,1,1,1368,2415,1047
6518,1,1,1800,1398,-402
6519,0,0,102,0,-102
6520,1,0,34,0,-34
6521,1,0,14,0,-14
6522,0,0,5,0,-5
6523,1,1,148,1463,1315
6524,1,1,787,2532,1745
6525,1,0,37,0,-37
6526,0,0,31,0,-31
6527,0,0,47,0,-47
6528,1,1,58,1208,1150
6529,0,0,133,0,-133
6530,1,0,6,0,-6
6531,0,0,94,0,-94
6532,0,0,62,0,-62
6533,1,0,67,0,-67
6534,0,0,2,0,-2
6535,0,0,51,0,-51
6536,0,0,56,0,-56
6537,1,0,44,0,-44
6538,0,0,50,0,-50
6539,0,0,20,0,-20
6540,1,0,29,0,-29
6541,0,0,21,0,-21
6542,0,0,19,0,-19
6543,1,0,31,0,-31
6544,1,0,13,0,-13
6545,0,0,14,0,-14
6546,1,0,77,0,-77
6547,1,0,68,0,-68
6548,1,1,742,1464,722
6549,1,1,599,1519,920
6550,1,0,42,0,-42
6551,1,0,47,0,-47
6552,0,0,25,0,-25
6553,1,0,4,0,-4
6554,1,0,65,0,-65
6555,1,1,873,1359,486
6556,0,0,82,0,-82
6557,1,1,130,1776,1646
6558,1,1,253,1473,1220
6559,1,0,62,0,-62
6560,1,0,21,0,-21
6561,1,1,1109,1630,521
6562,1,1,498,1435,937
6563,1,1,171,1258,1087
6564,1,1,119,1811,1692
6565,1,1,672,1311,639
6566,1,0,86,0,-86
6567,1,1,362,1482,1120
6568,1,1,165,2003,1838
6569,1,1,1160,1235,75
6570,0,0,111,0,-111
6571,0,0,37,0,-37
6572,1,0,46,0,-46
6573,1,1,436,1420,984
6574,0,0,51,0,-51
6575,0,0,26,0,-26
6576,0,0,14,0,-14
6577,0,0,83,0,-83
6578,1,0,45,0,-45
6579,0,0,94,0,-94
6580,0,0,94,0,-94
6581,1,0,71,0,-71
6582,1,1,151,1505,1354
6583,1,1,772,1993,1221
6584,1,1,307,2769,2462
6585,0,0,29,0,-29
6586,1,1,405,2038,1633
6587,0,0,50,0,-50
6588,0,0,41,0,-41
6589,1,0,80,0,-80
6590,0,0,15,0,-15
6591,1,0,42,0,-42
6592,1,1,376,1216,840
6593,0,0,93,0,-93
6594,1,1,197,1521,1324
6595,0,0,277,0,-277
6596,1,0,5,0,-5
6597,0,0,50,0,-50
6598,0,0,10,0,-10
6599,1,0,20,0,-20
6600,1,1,115,1876,1761
6601,1,0,5,0,-5
6602,1,0,48,0,-48
6603,1,0,11,0,-11
6604,1,1,374,1417,1043
6605,1,1,27,1234,1207
6606,0,0,86,0,-86
6607,0,0,58,0,-58
6608,0,0,114,0,-114
6609,1,1,280,1285,1005
6610,1,0,75,0,-75
6611,1,0,49,0,-49
6612,1,1,1104,1621,517
6613,1,1,776,1605,829
6614,1,1,383,1251,868
6615,0,0,38,0,-38
6616,0,0,17,0,-17
6617,1,0,11,0,-11
6618,0,0,31,0,-31
6619,1,0,148,0,-148
6620,0,0,31,0,-31
6621,0,0,71,0,-71
6622,0,0,48,0,-48
6623,1,1,599,1240,641
6624,0,0,12,0,-12
6625,1,0,2,0,-2
6626,1,0,37,0,-37
6627,1,0,30,0,-30
6628,0,0,25,0,-25
6629,1,1,385,2534,2149
6630,1,0,5,0,-5
6631,1,1,547,1876,1329
6632,1,1,988,1231,243
6633,0,0,15,0,-15
6634,0,0,2,0,-2
6635,1,1,189,1230,1041
6636,1,0,8,0,-8
6637,1,1,1080,1283,203
6638,1,1,579,1699,1120
6639,1,1,40,1289,1249
6640,1,1,101,1283,1182
6641,1,1,209,2232,2023
6642,1,1,1947,1938,-9
6643,0,0,33,0,-33
6644,0,0,159,0,-159
6645,1,0,20,0,-20
6646,1,1,257,1415,1158
6647,1,1,695,1906,1211
6648,1,1,365,1659,1294
6649,0,0,44,0,-44
6650,0,0,18,0,-18
6651,1,1,565,1464,899
6652,1,1,290,1617,1327
6653,0,0,76,0,-76
6654,0,0,7,0,-7
6655,0,0,30,0,-30
6656,1,0,0,0,0
6657,1,0,27,0,-27
6658,0,0,86,0,-86
6659,0,0,1,0,-1
6660,1,0,117,0,-117
6661,1,1,1248,1276,28
6662,0,0,66,0,-66
6663,1,1,450,1426,976
6664,1,0,8,0,-8
6665,0,0,28,0,-28
6666,0,0,132,0,-132
6667,1,1,953,1515,562
6668,1,1,509,1327,818
6669,0,0,47,0,-47
6670,0,0,42,0,-42
6671,1,0,17,0,-17
6672,0,0,14,0,-14
6673,0,0,80,0,-80
6674,1,1,2617,1441,-1176
6675,1,1,612,1478,866
6676,0,0,82,0,-82
6677,1,1,548,1426,878
6678,1,1,1179,1598,419
6679,0,0,122,0,-122
6680,1,1,348,1968,1620
6681,1,1,319,1474,1155
6682,0,0,142,0,-142
6683,1,1,1075,1648,573
6684,1,1,173,1229,1056
6685,1,0,15,0,-15
6686,1,0,6,0,-6
6687,1,0,41,0,-41
6688,0,0,5,0,-5
6689,1,1,860,1289,429
6690,1,0,16,0,-16
6691,1,0,61,0,-61
6692,1,0,81,0,-81
6693,0,0,44,0,-44
6694,1,1,273,1547,1274
6695,0,0,22,0,-22
6696,1,0,47,0,-47
6697,1,1,347,1399,1052
6698,0,0,48,0,-48
6699,0,0,62,0,-62
6700,1,0,74,0,-74
6701,1,1,325,1303,978
6702,1,0,154,0,-154
6703,1,1,1271,1395,124
6704,0,0,34,0,-34
6705,0,0,98,0,-98
6706,0,0,9,0,-9
6707,1,0,95,0,-95
6708,1,0,29,0,-29
6709,1,0,16,0,-16
6710,1,0,29,0,-29
6711,1,1,1218,1951,733
6712,0,0,15,0,-15
6713,0,0,2,0,-2
6714,1,0,20,0,-20
6715,0,0,130,0,-130
6716,0,0,13,0,-13
6717,0,0,22,0,-22
6718,0,0,25,0,-25
6719,1,1,907,1664,757
6720,0,0,4,0,-4
6721,0,0,101,0,-101
6722,0,0,6,0,-6
6723,1,0,8,0,-8
6724,1,1,1455,1378,-77
6725,0,0,140,0,-140
6726,1,1,732,1798,1066
6727,1,0,4,0,-4
6728,0,0,77,0,-77
6729,1,1,1083,1367,284
6730,1,0,7,0,-7
6731,0,0,128,0,-128
6732,1,1,934,1260,326
6733,0,0,109,0,-109
6734,1,0,35,0,-35
6735,0,0,39,0,-39
6736,0,0,8,0,-8
6737,1,0,60,0,-60
6738,0,0,10,0,-10
6739,0,0,2,0,-2
6740,0,0,63,0,-63
6741,0,0,11,0,-11
6742,1,1,570,1778,1208
6743,0,0,193,0,-193
6744,0,0,27,0,-27
6745,0,0,22,0,-22
6746,0,0,9,0,-9
6747,1,1,908,1529,621
6748,1,1,430,1663,1233
6749,1,1,1391,2003,612
6750,0,0,8,0,-8
6751,1,0,23,0,-23
6752,0,0,8,0,-8
6753,0,0,28,0,-28
6754,1,0,32,0,-32
6755,1,0,73,0,-73
6756,0,0,58,0,-58
6757,1,1,329,1501,1172
6758,0,0,62,0,-62
6759,0,0,2,0,-2
6760,1,1,324,1233,909
6761,0,0,139,0,-139
6762,1,0,3,0,-3
6763,1,1,627,1266,639
6764,0,0,86,0,-86
6765,0,0,74,0,-74
6766,1,0,25,0,-25
6767,1,0,84,0,-84
6768,1,0,2,0,-2
6769,1,1,1605,1260,-345
6770,1,0,23,0,-23
6771,1,1,225,1743,1518
6772,1,1,781,1761,980
6773,1,1,267,1395,1128
6774,0,0,68,0,-68
6775,0,0,56,0,-56
6776,1,0,12,0,-12
6777,1,0,150,0,-150
6778,1,1,1237,3739,2502
6779,1,1,1194,1409,215
6780,1,0,51,0,-51
6781,0,0,21,0,-21
6782,0,0,114,0,-114
6783,0,0,15,0,-15
6784,1,1,43,1248,1205
6785,0,0,24,0,-24
6786,1,1,633,1274,641
6787,0,0,14,0,-14
6788,1,0,287,0,-287
6789,0,0,70,0,-70
6790,1,1,1139,1717,578
6791,0,0,65,0,-65
6792,1,1,518,3914,3396
6793,1,1,1048,1515,467
6794,1,1,631,1274,643
6795,1,1,2343,1358,-985
6796,1,0,35,0,-35
6797,0,0,22,0,-22
6798,0,0,57,0,-57
6799,0,0,5,0,-5
6800,1,1,90,2448,2358
6801,1,1,47,1438,1391
6802,1,1,442,1273,831
6803,0,0,87,0,-87
6804,1,0,287,0,-287
6805,0,0,3,0,-3
6806,1,0,42,0,-42
6807,1,1,371,1698,1327
6808,1,0,69,0,-69
6809,1,1,508,1281,773
6810,0,0,16,0,-16
6811,1,1,365,1214,849
6812,1,1,645,1637,992
6813,0,0,15,0,-15
6814,1,1,335,1257,922
6815,1,1,352,2051,1699
6816,1,0,34,0,-34
6817,1,1,165,1498,1333
6818,0,0,18,0,-18
6819,0,0,38,0,-38
6820,1,0,38,0,-38
6821,1,0,63,0,-63
6822,1,1,171,1315,1144
6823,1,1,448,1476,1028
6824,1,1,245,1309,1064
6825,0,0,59,0,-59
6826,0,0,14,0,-14
6827,1,0,33,0,-33
6828,1,1,1549,1345,-204
6829,0,0,178,0,-178
6830,0,0,121,0,-121
6831,1,1,595,1606,1011
6832,1,1,541,1312,771
6833,1,1,295,1211,916
6834,1,1,699,1241,542
6835,1,0,5,0,-5
6836,1,0,15,0,-15
6837,1,0,11,0,-11
6838,1,1,823,1346,523
6839,0,0,48,0,-48
6840,0,0,85,0,-85
6841,0,0,6,0,-6
6842,0,0,76,0,-76
6843,0,0,106,0,-106
6844,0,0,2,0,-2
6845,1,1,207,1200,993
6846,0,0,4,0,-4
6847,0,0,115,0,-115
6848,0,0,12,0,-12
6849,1,1,103,1458,1355
6850,1,0,24,0,-24
6851,1,1,304,3137,2833
6852,1,0,23,0,-23
6853,0,0,33,0,-33
6854,1,0,16,0,-16
6855,1,1,309,1299,990
6856,1,1,763,1941,1178
6857,1,1,606,1447,841
6858,0,0,0,0,0
6859,1,0,65,0,-65
6860,1,0,2,0,-2
6861,1,1,282,1341,1059
6862,0,0,33,0,-33
6863,1,0,15,0,-15
6864,0,0,0,0,0
6865,1,0,4,0,-4
6866,1,1,44,1395,1351
6867,1,1,86,2156,2070
6868,0,0,28,0,-28
6869,1,0,36,0,-36
6870,1,1,669,1289,620
6871,1,1,185,1613,1428
6872,1,1,1395,1377,-18
6873,0,0,51,0,-51
6874,1,0,21,0,-21
6875,0,0,97,0,-97
6876,1,1,51,1797,1746
6877,1,0,260,0,-260
6878,1,0,12,0,-12
6879,0,0,20,0,-20
6880,0,0,24,0,-24
6881,1,1,220,1267,1047
6882,0,0,40,0,-40
6883,1,0,91,0,-91
6884,1,1,278,1254,976
6885,0,0,2,0,-2
6886,1,0,25,0,-25
6887,1,0,147,0,-147
6888,0,0,45,0,-45
6889,1,1,544,5240,4696
6890,0,0,35,0,-35
6891,0,0,26,0,-26
6892,0,0,22,0,-22
6893,1,1,285,1551,1266
6894,1,1,548,1567,1019
6895,1,1,101,1278,1177
6896,1,0,151,0,-151
6897,1,0,93,0,-93
6898,1,0,50,0,-50
6899,1,1,1544,1465,-79
6900,0,0,8,0,-8
6901,1,1,316,1272,956
6902,0,0,14,0,-14
6903,0,0,38,0,-38
6904,1,1,233,1507,1274
6905,0,0,20,0,-20
6906,0,0,12,0,-12
6907,1,0,169,0,-169
6908,1,0,29,0,-29
6909,1,1,173,1287,1114
6910,1,1,588,1467,879
6911,1,1,225,1430,1205
6912,1,0,48,0,-48
6913,1,1,343,1319,976
6914,0,0,17,0,-17
6915,1,0,118,0,-118
6916,1,1,898,1212,314
6917,1,0,84,0,-84
6918,1,0,68,0,-68
6919,1,1,62,1579,1517
6920,1,1,1237,1783,546
6921,0,0,92,0,-92
6922,0,0,32,0,-32
6923,0,0,50,0,-50
6924,1,1,549,1320,771
6925,1,0,42,0,-42
6926,0,0,79,0,-79
6927,1,1,324,1208,884
6928,0,0,36,0,-36
6929,0,0,130,0,-130
6930,1,1,450,1370,920
6931,0,0,94,0,-94
6932,1,0,8,0,-8
6933,1,0,38,0,-38
6934,1,0,45,0,-45
6935,1,0,117,0,-117
6936,0,0,79,0,-79
6937,0,0,34,0,-34
6938,1,0,27,0,-27
6939,1,0,87,0,-87
6940,0,0,16,0,-16
6941,1,0,14,0,-14
6942,1,1,112,2203,2091
6943,0,0,39,0,-39
6944,1,1,515,1310,795
6945,0,0,32,0,-32
6946,1,1,319,2609,2290
6947,1,1,1161,1299,138
6948,1,1,52,1492,1440
6949,0,0,138,0,-138
6950,1,0,3,0,-3
6951,0,0,9,0,-9
6952,1,1,125,1232,1107
6953,1,0,41,0,-41
6954,1,0,89,0,-89
6955,0,0,210,0,-210
6956,1,0,19,0,-19
6957,1,0,10,0,-10
6958,0,0,6,0,-6
6959,1,0,99,0,-99
6960,1,1,317,1705,1388
6961,1,0,41,0,-41
6962,1,0,46,0,-46
6963,1,1,309,1470,1161
6964,0,0,75,0,-75
6965,0,0,79,0,-79
6966,1,1,367,2695,2328
6967,0,0,65,0,-65
6968,1,1,723,1459,736
6969,0,0,77,0,-77
6970,1,0,24,0,-24
6971,1,1,785,1417,632
6972,1,0,23,0,-23
6973,0,0,34,0,-34
6974,0,0,13,0,-13
6975,0,0,75,0,-75
6976,0,0,47,0,-47
6977,1,0,4,0,-4
6978,1,0,61,0,-61
6979,1,1,2265,1462,-803
6980,1,1,311,1288,977
6981,1,1,1552,1352,-200
6982,0,0,95,0,-95
6983,0,0,23,0,-23
6984,1,0,10,0,-10
6985,1,1,759,1226,467
6986,0,0,30,0,-30
6987,0,0,8,0,-8
6988,0,0,4,0,-4
6989,1,0,0,0,0
6990,1,0,4,0,-4
6991,0,0,36,0,-36
6992,1,0,47,0,-47
6993,1,0,24,0,-24
6994,0,0,23,0,-23
6995,1,1,260,1460,1200
6996,1,1,471,1256,785
6997,1,0,20,0,-20
6998,1,0,15,0,-15
6999,0,0,0,0,0
7000,1,1,41,1357,1316
7001,1,1,642,1615,973
7002,0,0,79,0,-79
7003,0,0,72,0,-72
7004,1,0,1,0,-1
7005,1,0,42,0,-42
7006,1,0,21,0,-21
7007,0,0,71,0,-71
7008,1,0,27,0,-27
7009,1,1,823,1216,393
7010,0,0,48,0,-48
7011,1,1,499,1417,918
7012,1,1,544,1682,1138
7013,1,0,120,0,-120
7014,1,1,547,1412,865
7015,0,0,82,0,-82
7016,1,0,177,0,-177
7017,1,0,38,0,-38
7018,1,0,92,0,-92
7019,0,0,16,0,-16
7020,1,0,9,0,-9
7021,1,1,20,1701,1681
7022,1,1,798,1654,856
7023,0,0,52,0,-52
7024,1,0,78,0,-78
7025,1,1,1029,1389,360
7026,1,1,142,1210,1068
7027,1,0,110,0,-110
7028,0,0,69,0,-69
7029,1,1,678,2410,1732
7030,0,0,35,0,-35
7031,1,0,78,0,-78
7032,0,0,7,0,-7
7033,1,0,18,0,-18
7034,1,1,1814,1240,-574
7035,1,1,325,1558,1233
7036,1,0,27,0,-27
7037,1,1,307,1203,896
7038,1,1,380,1598,1218
7039,1,1,1500,1334,-166
7040,0,0,47,0,-47
7041,0,0,103,0,-103
7042,0,0,73,0,-73
7043,0,0,33,0,-33
7044,1,0,35,0,-35
7045,1,0,80,0,-80
7046,1,1,1142,2024,882
7047,1,1,897,1677,780
7048,0,0,37,0,-37
7049,0,0,29,0,-29
7050,1,1,131,2699,2568
7051,0,0,68,0,-68
7052,0,0,42,0,-42
7053,1,0,8,0,-8
7054,0,0,144,0,-144
7055,0,0,2,0,-2
7056,0,0,36,0,-36
7057,1,1,336,1229,893
7058,0,0,26,0,-26
7059,1,0,97,0,-97
7060,1,1,1292,1418,126
7061,1,0,125,0,-125
7062,0,0,129,0,-129
7063,0,0,49,0,-49
7064,0,0,28,0,-28
7065,0,0,6,0,-6
7066,0,0,21,0,-21
7067,1,1,548,1483,935
7068,0,0,101,0,-101
7069,1,1,1174,1473,299
7070,1,0,27,0,-27
7071,1,0,66,0,-66
7072,1,1,163,1242,1079
7073,1,1,362,1254,892
7074,0,0,2,0,-2
7075,1,0,141,0,-141
7076,1,1,102,2219,2117
7077,1,1,1872,1442,-430
7078,0,0,122,0,-122
7079,1,1,32,1228,1196
7080,1,1,1120,1659,539
7081,0,0,14,0,-14
7082,1,0,6,0,-6
7083,1,1,835,1968,1133
7084,1,0,52,0,-52
7085,0,0,74,0,-74
7086,1,0,44,0,-44
7087,0,0,69,0,-69
7088,0,0,67,0,-67
7089,1,1,1318,1413,95
7090,0,0,13,0,-13
7091,1,1,575,1889,1314
7092,1,0,5,0,-5
7093,0,0,110,0,-110
7094,1,0,26,0,-26
7095,0,0,36,0,-36
7096,0,0,29,0,-29
7097,1,0,30,0,-30
7098,1,1,213,1884,1671
7099,0,0,41,0,-41
7100,0,0,47,0,-47
7101,1,1,263,1850,1587
7102,1,1,2788,1476,-1312
7103,1,0,6,0,-6
7104,0,0,26,0,-26
7105,1,1,402,1237,835
7106,1,1,16,1310,1294
7107,1,0,36,0,-36
7108,1,1,159,1278,1119
7109,0,0,0,0,0
7110,1,1,171,1238,1067
7111,1,0,29,0,-29
7112,1,1,166,1209,1043
7113,1,1,71,1374,1303
7114,0,0,86,0,-86
7115,0,0,69,0,-69
7116,1,1,562,1311,749
7117,1,1,103,1674,1571
7118,1,0,32,0,-32
7119,0,0,29,0,-29
7120,0,0,29,0,-29
7121,1,1,322,1285,963
7122,1,1,2747,1223,-1524
7123,1,1,644,1295,651
7124,1,0,72,0,-72
7125,1,0,41,0,-41
7126,0,0,94,0,-94
7127,1,0,23,0,-23
7128,1,0,40,0,-40
7129,0,0,17,0,-17
7130,0,0,0,0,0
7131,0,0,110,0,-110
7132,1,0,39,0,-39
7133,1,0,1,0,-1
7134,0,0,8,0,-8
7135,1,1,1857,1200,-657
7136,0,0,103,0,-103
7137,1,0,92,0,-92
7138,0,0,2,0,-2
7139,1,0,155,0,-155
7140,1,0,25,0,-25
7141,0,0,10,0,-10
7142,1,1,163,1285,1122
7143,0,0,231,0,-231
7144,1,1,435,1633,1198
7145,0,0,30,0,-30
7146,0,0,81,0,-81
7147,0,0,5,0,-5
7148,1,1,335,1215,880
7149,1,1,196,1285,1089
7150,0,0,3,0,-3
7151,0,0,37,0,-37
7152,1,0,50,0,-50
7153,0,0,41,0,-41
7154,1,0,11,0,-11
7155,1,1,1135,2602,1467
7156,1,1,1476,1208,-268
7157,0,0,64,0,-64
7158,1,0,110,0,-110
7159,0,0,34,0,-34
7160,1,1,117,1529,1412
7161,0,0,20,0,-20
7162,1,0,79,0,-79
7163,1,0,93,0,-93
7164,1,0,34,0,-34
7165,1,1,60,1927,1867
7166,1,1,77,1672,1595
7167,1,1,729,1491,762
7168,0,0,2,0,-2
7169,0,0,11,0,-11
7170,1,1,436,1379,943
7171,1,1,145,1212,1067
7172,0,0,37,0,-37
7173,0,0,68,0,-68
7174,0,0,63,0,-63
7175,0,0,49,0,-49
7176,1,1,1424,1424,0
7177,1,1,653,1486,833
7178,1,0,26,0,-26
7179,0,0,96,0,-96
7180,1,0,87,0,-87
7181,1,1,936,1250,314
7182,0,0,2,0,-2
7183,0,0,7,0,-7
7184,1,0,43,0,-43
7185,1,1,639,1520,881
7186,1,0,23,0,-23
7187,0,0,149,0,-149
7188,0,0,7,0,-7
7189,0,0,0,0,0
7190,0,0,66,0,-66
7191,1,1,110,1535,1425
7192,0,0,44,0,-44
7193,1,1,391,1412,1021
7194,1,0,76,0,-76
7195,1,1,55,1263,1208
7196,1,1,17,1223,1206
7197,1,1,1228,1741,513
7198,1,1,64,1511,1447
7199,1,1,879,1233,354
7200,1,0,14,0,-14
7201,0,0,69,0,-69
7202,1,0,36,0,-36
7203,0,0,3,0,-3
7204,1,0,37,0,-37
7205,1,0,114,0,-114
7206,1,0,37,0,-37
7207,1,1,156,1895,1739
7208,1,0,166,0,-166
7209,1,0,32,0,-32
7210,1,1,408,1202,794
7211,0,0,40,0,-40
7212,1,0,68,0,-68
7213,1,0,96,0,-96
7214,1,0,6,0,-6
7215,1,0,39,0,-39
7216,0,0,37,0,-37
7217,0,0,71,0,-71
7218,0,0,158,0,-158
7219,0,0,80,0,-80
7220,1,1,365,1499,1134
7221,0,0,51,0,-51
7222,0,0,90,0,-90
7223,1,1,189,1290,1101
7224,1,0,37,0,-37
7225,1,0,19,0,-19
7226,1,0,73,0,-73
7227,1,0,80,0,-80
7228,1,0,39,0,-39
7229,1,0,23,0,-23
7230,0,0,9,0,-9
7231,1,1,523,1269,746
7232,1,1,366,1388,1022
7233,0,0,25,0,-25
7234,1,0,0,0,0
7235,1,1,47,1224,1177
7236,0,0,12,0,-12
7237,1,1,523,1702,1179
7238,0,0,6,0,-6
7239,0,0,6,0,-6
7240,0,0,102,0,-102
7241,0,0,64,0,-64
7242,0,0,14,0,-14
7243,0,0,25,0,-25
7244,1,1,250,1200,950
7245,1,1,92,1360,1268
7246,0,0,49,0,-49
7247,0,0,54,0,-54
7248,1,1,481,1414,933
7249,1,1,371,1518,1147
7250,0,0,66,0,-66
7251,0,0,11,0,-11
7252,1,1,30,1742,1712
7253,1,0,72,0,-72
7254,1,0,61,0,-61
7255,0,0,86,0,-86
7256,0,0,11,0,-11
7257,1,1,376,1689,1313
7258,1,1,1164,2270,1106
7259,0,0,17,0,-17
7260,0,0,5,0,-5
7261,0,0,14,0,-14
7262,1,0,8,0,-8
7263,1,1,196,2112,1916
7264,0,0,17,0,-17
7265,0,0,138,0,-138
7266,1,1,526,1699,1173
7267,1,1,684,1607,923
7268,0,0,20,0,-20
7269,0,0,48,0,-48
7270,1,1,678,1306,628
7271,0,0,52,0,-52
7272,0,0,31,0,-31
7273,1,0,17,0,-17
7274,1,1,477,1338,861
7275,1,0,110,0,-110
7276,0,0,18,0,-18
7277,1,1,64,1468,1404
7278,0,0,26,0,-26
7279,1,0,8,0,-8
7280,1,0,10,0,-10
7281,0,0,16,0,-16
7282,0,0,8,0,-8
7283,1,0,22,0,-22
7284,0,0,13,0,-13
7285,1,0,64,0,-64
7286,1,0,15,0,-15
7287,0,0,74,0,-74
7288,1,1,186,1519,1333
7289,1,0,38,0,-38
7290,1,0,58,0,-58
7291,1,1,376,1685,1309
7292,1,1,760,1257,497
7293,0,0,2,0,-2
7294,0,0,50,0,-50
7295,1,0,119,0,-119
7296,1,0,86,0,-86
7297,1,0,20,0,-20
7298,0,0,64,0,-64
7299,1,1,924,1451,527
7300,0,0,43,0,-43
7301,0,0,48,0,-48
7302,1,0,10,0,-10
7303,1,1,457,1440,983
7304,1,0,87,0,-87
7305,0,0,50,0,-50
7306,1,0,15,0,-15
7307,0,0,78,0,-78
7308,1,1,501,1236,735
7309,1,0,23,0,-23
7310,1,1,333,1273,940
7311,1,0,8,0,-8
7312,1,0,131,0,-131
7313,0,0,29,0,-29
7314,1,0,2,0,-2
7315,1,1,72,1332,1260
7316,1,1,267,1280,1013
7317,1,0,35,0,-35
7318,0,0,3,0,-3
7319,0,0,48,0,-48
7320,1,1,1078,1488,410
7321,0,0,7,0,-7
7322,1,1,2466,1274,-1192
7323,0,0,24,0,-24
7324,0,0,0,0,0
7325,1,0,48,0,-48
7326,1,0,49,0,-49
7327,0,0,11,0,-11
7328,1,0,9,0,-9
7329,1,0,72,0,-72
7330,0,0,49,0,-49
7331,1,0,130,0,-130
7332,1,1,159,1500,1341
7333,1,0,31,0,-31
7334,0,0,4,0,-4
7335,0,0,19,0,-19
7336,1,1,925,1506,581
7337,1,0,43,0,-43
7338,1,1,2064,1604,-460
7339,1,0,34,0,-34
7340,1,1,279,1746,1467
7341,1,1,525,2047,1522
7342,1,1,759,1583,824
7343,1,1,387,2014,1627
7344,0,0,34,0,-34
7345,1,0,15,0,-15
7346,1,0,29,0,-29
7347,1,1,205,1792,1587
7348,1,1,644,1941,1297
7349,0,0,60,0,-60
7350,1,0,22,0,-22
7351,1,1,768,1461,693
7352,0,0,11,0,-11
7353,0,0,7,0,-7
7354,1,0,31,0,-31
7355,0,0,22,0,-22
7356,1,1,108,1296,1188
7357,1,0,85,0,-85
7358,1,0,48,0,-48
7359,1,1,149,1380,1231
7360,1,0,35,0,-35
7361,0,0,49,0,-49
7362,1,0,32,0,-32
7363,0,0,29,0,-29
7364,0,0,99,0,-99
7365,0,0,19,0,-19
7366,1,1,1769,2264,495
7367,1,1,898,1395,497
7368,0,0,19,0,-19
7369,1,1,1544,1519,-25
7370,0,0,9,0,-9
7371,0,0,151,0,-151
7372,0,0,116,0,-116
7373,1,1,916,1493,577
7374,0,0,192,0,-192
7375,1,1,548,1289,741
7376,1,0,5,0,-5
7377,1,0,7,0,-7
7378,0,0,9,0,-9
7379,0,0,82,0,-82
7380,0,0,14,0,-14
7381,1,1,199,1497,1298
7382,0,0,74,0,-74
7383,0,0,0,0,0
7384,0,0,4,0,-4
7385,1,1,434,1357,923
7386,1,0,71,0,-71
7387,0,0,35,0,-35
7388,1,0,11,0,-11
7389,1,1,1159,1366,207
7390,1,1,716,1486,770
7391,0,0,1,0,-1
7392,1,0,35,0,-35
7393,0,0,29,0,-29
7394,1,0,84,0,-84
7395,0,0,64,0,-64
7396,1,1,154,2378,2224
7397,0,0,4,0,-4
7398,0,0,32,0,-32
7399,1,1,374,1306,932
7400,0,0,47,0,-47
7401,1,0,57,0,-57
7402,1,0,64,0,-64
7403,1,1,289,1525,1236
7404,0,0,58,0,-58
7405,1,1,186,1249,1063
7406,1,0,11,0,-11
7407,1,0,22,0,-22
7408,1,0,3,0,-3
7409,1,1,365,1526,1161
7410,1,1,575,1206,631
7411,1,1,287,1283,996
7412,0,0,52,0,-52
7413,0,0,112,0,-112
7414,1,0,43,0,-43
7415,0,0,9,0,-9
7416,1,1,186,1327,1141
7417,0,0,18,0,-18
7418,1,1,565,1376,811
7419,0,0,33,0,-33
7420,1,1,824,1259,435
7421,0,0,100,0,-100
7422,1,0,31,0,-31
7423,0,0,62,0,-62
7424,0,0,18,0,-18
7425,0,0,80,0,-80
7426,1,1,514,1257,743
7427,1,0,65,0,-65
7428,0,0,34,0,-34
7429,0,0,13,0,-13
7430,1,0,37,0,-37
7431,1,0,30,0,-30
7432,1,0,11,0,-11
7433,0,0,102,0,-102
7434,0,0,72,0,-72
7435,0,0,12,0,-12
7436,1,0,29,0,-29
7437,1,1,177,2004,1827
7438,1,0,2,0,-2
7439,1,1,431,1849,1418
7440,1,0,35,0,-35
7441,0,0,13,0,-13
7442,1,0,37,0,-37
7443,1,1,945,2661,1716
7444,1,1,156,1413,1257
7445,1,0,138,0,-138
7446,0,0,28,0,-28
7447,1,1,194,1516,1322
7448,0,0,127,0,-127
7449,1,1,90,1949,1859
7450,1,0,165,0,-165
7451,0,0,68,0,-68
7452,1,1,1290,1975,685
7453,1,0,159,0,-159
7454,1,1,1319,1579,260
7455,0,0,51,0,-51
7456,1,1,55,1366,1311
7457,1,0,26,0,-26
7458,1,1,552,1414,862
7459,1,1,483,1747,1264
7460,1,0,53,0,-53
7461,1,0,129,0,-129
7462,1,1,143,1314,1171
7463,1,0,54,0,-54
7464,0,0,4,0,-4
7465,1,0,13,0,-13
7466,1,0,27,0,-27
7467,1,1,91,1212,1121
7468,1,1,92,1522,1430
7469,1,0,26,0,-26
7470,1,1,505,1411,906
7471,1,0,2,0,-2
7472,0,0,35,0,-35
7473,1,0,18,0,-18
7474,1,1,1479,1213,-266
7475,1,0,39,0,-39
7476,1,1,1825,2260,435
7477,0,0,106,0,-106
7478,0,0,102,0,-102
7479,0,0,36,0,-36
7480,1,1,806,1651,845
7481,0,0,41,0,-41
7482,1,0,105,0,-105
7483,1,0,39,0,-39
7484,0,0,43,0,-43
7485,0,0,60,0,-60
7486,1,0,123,0,-123
7487,1,1,149,1758,1609
7488,1,1,976,1274,298
7489,1,1,883,1236,353
7490,1,1,389,1836,1447
7491,1,0,42,0,-42
7492,1,0,111,0,-111
7493,0,0,0,0,0
7494,0,0,99,0,-99
7495,1,0,89,0,-89
7496,1,1,140,1785,1645
7497,1,1,261,1208,947
7498,1,1,1205,1714,509
7499,0,0,95,0,-95
7500,1,1,105,1435,1330
7501,0,0,46,0,-46
7502,1,0,88,0,-88
7503,1,0,197,0,-197
7504,1,1,152,1333,1181
7505,0,0,15,0,-15
7506,0,0,11,0,-11
7507,1,0,46,0,-46
7508,1,0,64,0,-64
7509,0,0,23,0,-23
7510,0,0,66,0,-66
7511,0,0,11,0,-11
7512,1,1,232,1702,1470
7513,1,0,159,0,-159
7514,0,0,78,0,-78
7515,1,0,41,0,-41
7516,0,0,6,0,-6
7517,0,0,0,0,0
7518,0,0,14,0,-14
7519,0,0,62,0,-62
7520,0,0,133,0,-133
7521,0,0,139,0,-139
7522,1,1,213,1820,1607
7523,1,1,363,1234,871
7524,1,1,386,1304,918
7525,1,1,1336,1401,65
7526,1,0,176,0,-176
7527,1,0,97,0,-97
7528,1,0,30,0,-30
7529,0,0,112,0,-112
7530,1,0,2,0,-2
7531,0,0,58,0,-58
7532,1,0,223,0,-223
7533,1,0,12,0,-12
7534,0,0,14,0,-14
7535,1,1,511,1287,776
7536,1,1,279,1953,1674
7537,1,1,1061,1235,174
7538,1,1,873,1411,538
7539,1,0,55,0,-55
7540,1,0,16,0,-16
7541,1,1,57,1409,1352
7542,0,0,34,0,-34
7543,1,1,676,1693,1017
7544,1,0,51,0,-51
7545,1,1,1076,1349,273
7546,0,0,5,0,-5
7547,0,0,67,0,-67
7548,1,0,1,0,-1
7549,0,0,34,0,-34
7550,0,0,6,0,-6
7551,0,0,109,0,-109
7552,1,1,501,1307,806
7553,0,0,61,0,-61
7554,1,0,24,0,-24
7555,1,1,306,1392,1086
7556,1,1,281,1533,1252
7557,1,0,48,0,-48
7558,0,0,19,0,-19
7559,1,0,81,0,-81
7560,0,0,8,0,-8
7561,1,1,1931,1495,-436
7562,1,1,162,1393,1231
7563,1,0,63,0,-63
7564,0,0,75,0,-75
7565,1,1,1085,1219,134
7566,1,1,167,1597,1430
7567,1,0,36,0,-36
7568,1,1,1131,1463,332
7569,1,1,558,1827,1269
7570,1,1,526,1608,1082
7571,1,0,12,0,-12
7572,0,0,19,0,-19
7573,0,0,41,0,-41
7574,1,1,254,1348,1094
7575,1,1,63,1321,1258
7576,1,1,1001,2127,1126
7577,1,1,709,1678,969
7578,1,1,434,1608,1174
7579,0,0,6,0,-6
7580,1,1,860,1677,817
7581,0,0,55,0,-55
7582,0,0,138,0,-138
7583,1,1,237,1720,1483
7584,0,0,18,0,-18
7585,1,1,1231,1763,532
7586,1,0,9,0,-9
7587,1,0,33,0,-33
7588,0,0,64,0,-64
7589,1,1,1593,1409,-184
7590,0,0,209,0,-209
7591,1,0,10,0,-10
7592,1,0,29,0,-29
7593,1,0,20,0,-20
7594,1,0,43,0,-43
7595,0,0,2,0,-2
7596,1,0,117,0,-117
7597,0,0,8,0,-8
7598,0,0,25,0,-25
7599,1,0,58,0,-58
7600,1,0,4,0,-4
7601,1,0,22,0,-22
7602,0,0,155,0,-155
7603,1,1,20,1557,1537
7604,1,0,30,0,-30
7605,0,0,225,0,-225
7606,1,1,606,2071,1465
7607,0,0,100,0,-100
7608,1,1,783,2218,1435
7609,1,0,53,0,-53
7610,0,0,24,0,-24
7611,1,1,387,1404,1017
7612,0,0,94,0,-94
7613,1,1,419,1325,906
7614,1,1,129,1470,1341
7615,1,1,60,1246,1186
7616,0,0,45,0,-45
7617,1,0,4,0,-4
7618,0,0,10,0,-10
7619,1,1,1469,1943,474
7620,0,0,45,0,-45
7621,1,0,5,0,-5
7622,1,1,212,1274,1062
7623,0,0,27,0,-27
7624,0,0,68,0,-68
7625,0,0,19,0,-19
7626,1,0,58,0,-58
7627,1,1,479,1381,902
7628,1,1,224,1492,1268
7629,1,0,40,0,-40
7630,0,0,18,0,-18
7631,0,0,13,0,-13
7632,1,0,27,0,-27
7633,0,0,123,0,-123
7634,1,0,0,0,0
7635,1,0,119,0,-119
7636,0,0,22,0,-22
7637,1,1,67,1440,1373
7638,0,0,0,0,0
7639,0,0,56,0,-56
7640,0,0,71,0,-71
7641,1,0,45,0,-45
7642,1,0,13,0,-13
7643,0,0,89,0,-89
7644,1,1,115,1380,1265
7645,0,0,28,0,-28
7646,1,0,49,0,-49
7647,1,1,255,1890,1635
7648,1,0,158,0,-158
7649,1,1,459,1263,804
7650,1,1,823,1208,385
7651,1,0,137,0,-137
7652,0,0,94,0,-94
7653,1,1,147,1515,1368
7654,0,0,3,0,-3
7655,1,0,104,0,-104
7656,1,1,625,1721,1096
7657,1,1,115,1467,1352
7658,0,0,5,0,-5
7659,1,1,495,4104,3609
7660,1,1,823,1551,728
7661,0,0,35,0,-35
7662,1,1,428,2201,1773
7663,0,0,220,0,-220
7664,1,1,1006,1308,302
7665,1,0,49,0,-49
7666,0,0,54,0,-54
7667,0,0,2,0,-2
7668,1,0,0,0,0
7669,1,1,333,1214,881
7670,1,1,411,1203,792
7671,1,1,248,1425,1177
7672,0,0,13,0,-13
7673,1,0,112,0,-112
7674,0,0,59,0,-59
7675,1,0,28,0,-28
7676,0,0,40,0,-40
7677,1,1,391,1308,917
7678,0,0,6,0,-6
7679,1,1,993,1224,231
7680,1,1,591,5403,4812
7681,1,0,5,0,-5
7682,1,0,9,0,-9
7683,1,0,56,0,-56
7684,1,1,558,1729,1171
7685,1,1,680,1922,1242
7686,1,1,551,1652,1101
7687,0,0,70,0,-70
7688,1,0,42,0,-42
7689,1,1,118,1218,1100
7690,0,0,39,0,-39
7691,0,0,70,0,-70
7692,0,0,0,0,0
7693,1,0,4,0,-4
7694,1,1,326,1227,901
7695,1,1,339,2835,2496
7696,1,1,1262,1306,44
7697,1,1,561,2154,1593
7698,1,1,665,1539,874
7699,0,0,37,0,-37
7700,1,0,0,0,0
7701,1,0,122,0,-122
7702,1,1,276,1260,984
7703,1,1,616,2060,1444
7704,0,0,65,0,-65
7705,1,0,11,0,-11
7706,1,1,222,2553,2331
7707,1,1,560,1327,767
7708,1,1,223,1992,1769
7709,1,0,9,0,-9
7710,0,0,35,0,-35
7711,0,0,199,0,-199
7712,0,0,24,0,-24
7713,1,1,328,1315,987
7714,0,0,2,0,-2
7715,1,0,69,0,-69
7716,1,0,12,0,-12
7717,1,0,14,0,-14
7718,0,0,11,0,-11
7719,1,1,428,1363,935
7720,1,1,137,1305,1168
7721,1,1,160,1246,1086
7722,0,0,42,0,-42
7723,1,0,4,0,-4
7724,1,0,27,0,-27
7725,1,1,1401,1534,133
7726,0,0,44,0,-44
7727,0,0,54,0,-54
7728,1,0,6,0,-6
7729,0,0,42,0,-42
7730,0,0,35,0,-35
7731,1,0,30,0,-30
7732,1,1,360,1316,956
7733,1,1,2199,1225,-974
7734,1,0,73,0,-73
7735,1,0,5,0,-5
7736,1,0,22,0,-22
7737,1,0,8,0,-8
7738,0,0,114,0,-114
7739,0,0,17,0,-17
7740,1,1,822,1440,618
7741,0,0,11,0,-11
7742,0,0,39,0,-39
7743,1,1,986,2534,1548
7744,0,0,39,0,-39
7745,1,1,2421,1716,-705
7746,0,0,106,0,-106
7747,1,1,376,1768,1392
7748,1,0,65,0,-65
7749,0,0,43,0,-43
7750,1,1,1084,1411,327
7751,1,1,213,1702,1489
7752,1,1,107,1361,1254
7753,0,0,1,0,-1
7754,1,0,17,0,-17
7755,1,1,76,1533,1457
7756,1,0,17,0,-17
7757,1,1,926,1819,893
7758,1,0,7,0,-7
7759,1,1,224,2256,2032
7760,1,1,187,1240,1053
7761,1,0,39,0,-39
7762,1,1,267,1361,1094
7763,1,1,523,1216,693
7764,1,1,220,1330,1110
7765,0,0,18,0,-18
7766,0,0,142,0,-142
7767,0,0,8,0,-8
7768,0,0,15,0,-15
7769,0,0,28,0,-28
7770,0,0,98,0,-98
7771,0,0,14,0,-14
7772,1,0,15,0,-15
7773,1,1,106,1534,1428
7774,0,0,95,0,-95
7775,0,0,79,0,-79
7776,1,0,96,0,-96
7777,1,0,108,0,-108
7778,0,0,72,0,-72
7779,1,1,45,1548,1503
7780,1,0,5,0,-5
7781,1,1,572,1228,656
7782,1,1,225,1331,1106
7783,1,1,513,1353,840
7784,0,0,22,0,-22
7785,1,1,245,1271,1026
7786,1,1,660,2063,1403
7787,0,0,6,0,-6
7788,0,0,48,0,-48
7789,0,0,136,0,-136
7790,1,1,765,1221,456
7791,1,1,850,1472,622
7792,1,1,175,2702,2527
7793,0,0,66,0,-66
7794,1,1,1119,1437,318
7795,1,1,1242,1547,305
7796,1,1,478,1210,732
7797,1,0,0,0,0
7798,0,0,1,0,-1
7799,0,0,102,0,-102
7800,1,0,218,0,-218
7801,0,0,81,0,-81
7802,1,0,114,0,-114
7803,0,0,2,0,-2
7804,0,0,61,0,-61
7805,1,0,73,0,-73
7806,1,0,12,0,-12
7807,1,1,356,1452,1096
7808,1,0,34,0,-34
7809,1,1,258,1349,1091
7810,0,0,43,0,-43
7811,0,0,130,0,-130
7812,1,1,1530,1352,-178
7813,0,0,64,0,-64
7814,1,1,514,1342,828
7815,1,1,678,1313,635
7816,1,1,1035,1509,474
7817,1,1,108,1969,1861
7818,1,1,697,1212,515
7819,0,0,68,0,-68
7820,0,0,24,0,-24
7821,1,1,305,1368,1063
7822,1,0,39,0,-39
7823,1,1,764,1811,1047
7824,1,1,362,1423,1061
7825,1,1,895,1643,748
7826,1,0,38,0,-38
7827,0,0,8,0,-8
7828,1,0,20,0,-20
7829,1,1,609,1647,1038
7830,1,1,72,2103,2031
7831,0,0,7,0,-7
7832,0,0,65,0,-65
7833,0,0,35,0,-35
7834,0,0,122,0,-122
7835,1,1,315,1326,1011
7836,1,1,119,1606,1487
7837,0,0,14,0,-14
7838,0,0,28,0,-28
7839,1,1,375,1808,1433
7840,1,0,20,0,-20
7841,0,0,24,0,-24
7842,0,0,11,0,-11
7843,1,1,244,1496,1252
7844,0,0,52,0,-52
7845,1,1,267,1588,1321
7846,1,0,154,0,-154
7847,1,0,28,0,-28
7848,0,0,26,0,-26
7849,0,0,172,0,-172
7850,0,0,38,0,-38
7851,0,0,4,0,-4
7852,0,0,106,0,-106
7853,1,0,9,0,-9
7854,1,1,277,2062,1785
7855,1,1,1084,2506,1422
7856,0,0,104,0,-104
7857,0,0,55,0,-55
7858,1,0,21,0,-21
7859,0,0,41,0,-41
7860,0,0,22,0,-22
7861,0,0,11,0,-11
7862,1,0,19,0,-19
7863,1,1,580,1275,695
7864,0,0,44,0,-44
7865,0,0,70,0,-70
7866,1,0,36,0,-36
7867,0,0,60,0,-60
7868,0,0,21,0,-21
7869,1,0,157,0,-157
7870,0,0,3,0,-3
7871,1,1,284,1327,1043
7872,0,0,9,0,-9
7873,1,0,24,0,-24
7874,0,0,36,0,-36
7875,1,0,30,0,-30
7876,1,1,494,1289,795
7877,1,1,138,1499,1361
7878,0,0,6,0,-6
7879,0,0,4,0,-4
7880,1,0,130,0,-130
7881,0,0,12,0,-12
7882,1,1,955,1644,689
7883,0,0,50,0,-50
7884,1,1,128,1645,1517
7885,1,1,99,1240,1141
7886,1,0,186,0,-186
7887,1,1,488,1765,1277
7888,1,0,121,0,-121
7889,1,1,219,1492,1273
7890,1,1,545,1429,884
7891,0,0,37,0,-37
7892,0,0,16,0,-16
7893,1,0,145,0,-145
7894,0,0,58,0,-58
7895,1,0,41,0,-41
7896,1,1,971,1818,847
7897,1,0,51,0,-51
7898,1,1,507,1572,1065
7899,0,0,41,0,-41
7900,1,0,17,0,-17
7901,1,0,98,0,-98
7902,0,0,11,0,-11
7903,0,0,224,0,-224
7904,0,0,94,0,-94
7905,0,0,53,0,-53
7906,0,0,13,0,-13
7907,1,1,295,1280,985
7908,1,0,5,0,-5
7909,1,0,90,0,-90
7910,1,1,1092,1441,349
7911,1,0,8,0,-8
7912,1,0,17,0,-17
7913,0,0,4,0,-4
7914,1,1,1321,2519,1198
7915,1,0,27,0,-27
7916,0,0,104,0,-104
7917,1,1,286,1291,1005
7918,1,1,105,1660,1555
7919,0,0,31,0,-31
7920,1,1,210,1577,1367
7921,0,0,45,0,-45
7922,1,1,1260,1862,602
7923,1,1,207,1696,1489
7924,0,0,51,0,-51
7925,1,1,846,1522,676
7926,0,0,145,0,-145
7927,0,0,73,0,-73
7928,1,1,552,1262,710
7929,1,0,5,0,-5
7930,0,0,26,0,-26
7931,1,0,58,0,-58
7932,0,0,24,0,-24
7933,0,0,11,0,-11
7934,1,0,112,0,-112
7935,1,0,8,0,-8
7936,0,0,14,0,-14
7937,1,0,7,0,-7
7938,1,0,7,0,-7
7939,1,0,23,0,-23
7940,1,1,125,1271,1146
7941,0,0,188,0,-188
7942,0,0,94,0,-94
7943,1,0,74,0,-74
7944,1,1,263,1200,937
7945,1,1,249,1203,954
7946,1,1,1282,1430,148
7947,0,0,36,0,-36
7948,1,0,26,0,-26
7949,1,0,27,0,-27
7950,1,1,435,1829,1394
7951,0,0,34,0,-34
7952,1,1,1246,1268,22
7953,0,0,66,0,-66
7954,0,0,7,0,-7
7955,1,0,32,0,-32
7956,1,0,33,0,-33
7957,1,1,2299,2153,-146
7958,1,1,443,1240,797
7959,1,1,258,1413,1155
7960,0,0,77,0,-77
7961,0,0,20,0,-20
7962,0,0,49,0,-49
7963,1,1,348,1795,1447
7964,0,0,14,0,-14
7965,1,0,13,0,-13
7966,1,1,523,2407,1884
7967,1,0,1,0,-1
7968,0,0,67,0,-67
7969,1,1,470,1669,1199
7970,1,1,603,2190,1587
7971,1,0,32,0,-32
7972,0,0,39,0,-39
7973,1,0,40,0,-40
7974,1,1,281,1434,1153
7975,1,1,355,1355,1000
7976,0,0,13,0,-13
7977,1,1,995,2069,1074
7978,0,0,80,0,-80
7979,0,0,30,0,-30
7980,1,0,7,0,-7
7981,1,0,24,0,-24
7982,1,1,272,1252,980
7983,1,0,5,0,-5
7984,1,1,313,1355,1042
7985,0,0,16,0,-16
7986,1,1,311,1511,1200
7987,0,0,307,0,-307
7988,0,0,21,0,-21
7989,1,0,50,0,-50
7990,0,0,88,0,-88
7991,1,1,768,1576,808
7992,1,0,86,0,-86
7993,1,1,154,1331,1177
7994,1,0,24,0,-24
7995,1,1,221,2817,2596
7996,1,0,21,0,-21
7997,0,0,122,0,-122
7998,0,0,11,0,-11
7999,1,1,229,1600,1371
8000,0,0,21,0,-21
8001,1,0,144,0,-144
8002,0,0,37,0,-37
8003,1,0,31,0,-31
8004,1,1,197,1257,1060
8005,1,0,8,0,-8
8006,0,0,45,0,-45
8007,1,1,253,1678,1425
8008,0,0,69,0,-69
8009,1,0,55,0,-55
8010,1,1,220,1483,1263
8011,0,0,0,0,0
8012,0,0,19,0,-19
8013,1,1,585,1250,665
8014,1,1,1096,1506,410
8015,1,0,95,0,-95
8016,1,1,233,1613,1380
8017,0,0,23,0,-23
8018,1,1,246,1217,971
8019,0,0,5,0,-5
8020,0,0,56,0,-56
8021,1,0,3,0,-3
8022,1,0,1,0,-1
8023,0,0,80,0,-80
8024,1,0,77,0,-77
8025,1,0,25,0,-25
8026,1,0,82,0,-82
8027,1,1,224,1297,1073
8028,1,0,2,0,-2
8029,0,0,4,0,-4
8030,1,0,72,0,-72
8031,1,1,940,1358,418
8032,1,1,1033,1288,255
8033,0,0,199,0,-199
8034,1,1,612,1418,806
8035,0,0,29,0,-29
8036,1,0,13,0,-13
8037,1,0,69,0,-69
8038,0,0,0,0,0
8039,1,1,988,1659,671
8040,1,1,675,2209,1534
8041,1,0,32,0,-32
8042,0,0,26,0,-26
8043,1,1,224,1307,1083
8044,1,0,18,0,-18
8045,1,0,7,0,-7
8046,1,1,695,1303,608
8047,1,0,69,0,-69
8048,1,0,6,0,-6
8049,1,0,105,0,-105
8050,0,0,20,0,-20
8051,1,0,25,0,-25
8052,1,1,3024,1439,-1585
8053,0,0,1,0,-1
8054,1,0,35,0,-35
8055,1,1,634,1290,656
8056,0,0,158,0,-158
8057,1,0,12,0,-12
8058,1,1,137,1300,1163
8059,1,0,13,0,-13
8060,1,1,1056,2049,993
8061,1,1,1160,2895,1735
8062,1,0,49,0,-49
8063,1,0,1,0,-1
8064,0,0,6,0,-6
8065,1,0,27,0,-27
8066,0,0,3,0,-3
8067,1,1,1109,1544,435
8068,0,0,131,0,-131
8069,0,0,43,0,-43
8070,1,0,60,0,-60
8071,1,0,37,0,-37
8072,0,0,4,0,-4
8073,0,0,52,0,-52
8074,1,0,36,0,-36
8075,0,0,178,0,-178
8076,1,1,64,1327,1263
8077,1,0,0,0,0
8078,1,0,80,0,-80
8079,0,0,74,0,-74
8080,0,0,26,0,-26
8081,0,0,22,0,-22
8082,0,0,32,0,-32
8083,0,0,8,0,-8
8084,0,0,76,0,-76
8085,1,1,90,1303,1213
8086,1,0,14,0,-14
8087,1,0,71,0,-71
8088,0,0,41,0,-41
8089,0,0,131,0,-131
8090,1,0,4,0,-4
8091,0,0,35,0,-35
8092,1,1,73,1291,1218
8093,1,1,1445,1258,-187
8094,1,1,174,1200,1026
8095,1,1,3223,2009,-1214
8096,1,1,504,2648,2144
8097,1,1,448,1485,1037
8098,0,0,15,0,-15
8099,1,1,986,1440,454
8100,1,0,269,0,-269
8101,1,1,16,1447,1431
8102,0,0,25,0,-25
8103,1,1,1890,1212,-678
8104,1,1,2407,1268,-1139
8105,1,0,199,0,-199
8106,1,1,161,1388,1227
8107,0,0,42,0,-42
8108,1,1,418,1344,926
8109,1,0,0,0,0
8110,0,0,103,0,-103
8111,1,0,19,0,-19
8112,1,1,844,1325,481
8113,1,0,9,0,-9
8114,0,0,19,0,-19
8115,1,0,48,0,-48
8116,0,0,15,0,-15
8117,1,1,352,1589,1237
8118,0,0,6,0,-6
8119,0,0,52,0,-52
8120,1,1,490,1526,1036
8121,1,0,3,0,-3
8122,1,1,179,1337,1158
8123,1,1,620,1656,1036
8124,0,0,160,0,-160
8125,1,0,10,0,-10
8126,1,0,33,0,-33
8127,1,0,15,0,-15
8128,1,1,1022,1215,193
8129,1,1,705,1617,912
8130,1,0,34,0,-34
8131,1,1,69,3095,3026
8132,1,1,846,1292,446
8133,1,1,1102,1409,307
8134,1,0,159,0,-159
8135,1,1,1252,2060,808
8136,0,0,51,0,-51
8137,1,1,304,2330,2026
8138,1,0,3,0,-3
8139,1,0,90,0,-90
8140,0,0,21,0,-21
8141,0,0,27,0,-27
8142,1,0,91,0,-91
8143,1,0,53,0,-53
8144,1,1,333,1332,999
8145,0,0,54,0,-54
8146,1,0,64,0,-64
8147,1,0,19,0,-19
8148,1,0,26,0,-26
8149,1,0,25,0,-25
8150,0,0,74,0,-74
8151,1,0,10,0,-10
8152,0,0,35,0,-35
8153,0,0,32,0,-32
8154,0,0,15,0,-15
8155,1,0,28,0,-28
8156,1,1,331,1209,878
8157,0,0,46,0,-46
8158,1,0,1,0,-1
8159,0,0,30,0,-30
8160,1,1,1744,1460,-284
8161,1,0,139,0,-139
8162,1,0,36,0,-36
8163,0,0,32,0,-32
8164,0,0,28,0,-28
8165,0,0,38,0,-38
8166,1,1,770,1516,746
8167,1,1,442,1481,1039
8168,0,0,38,0,-38
8169,1,0,21,0,-21
8170,0,0,13,0,-13
8171,1,0,7,0,-7
8172,0,0,58,0,-58
8173,0,0,2,0,-2
8174,0,0,21,0,-21
8175,1,0,1,0,-1
8176,1,1,181,1255,1074
8177,0,0,198,0,-198
8178,1,1,287,1432,1145
8179,1,0,80,0,-80
8180,1,1,176,2078,1902
8181,1,1,300,1593,1293
8182,1,0,35,0,-35
8183,1,1,507,1397,890
8184,1,0,27,0,-27
8185,0,0,75,0,-75
8186,1,0,51,0,-51
8187,0,0,250,0,-250
8188,1,1,64,1353,1289
8189,1,0,27,0,-27
8190,1,1,505,1220,715
8191,0,0,23,0,-23
8192,0,0,17,0,-17
8193,0,0,117,0,-117
8194,0,0,29,0,-29
8195,0,0,89,0,-89
8196,1,1,127,1200,1073
8197,0,0,50,0,-50
8198,1,1,307,1342,1035
8199,1,0,106,0,-106
8200,1,1,405,2142,1737
8201,0,0,0,0,0
8202,1,1,309,1256,947
8203,1,1,633,1225,592
8204,0,0,15,0,-15
8205,0,0,53,0,-53
8206,1,1,2015,1670,-345
8207,0,0,63,0,-63
8208,1,1,193,1527,1334
8209,0,0,21,0,-21
8210,0,0,36,0,-36
8211,1,1,394,1251,857
8212,1,0,284,0,-284
8213,0,0,92,0,-92
8214,0,0,63,0,-63
8215,1,0,49,0,-49
8216,0,0,55,0,-55
8217,1,1,30,1334,1304
8218,1,0,0,0,0
8219,1,1,71,1419,1348
8220,1,1,484,2246,1762
8221,1,0,5,0,-5
8222,0,0,7,0,-7
8223,0,0,55,0,-55
8224,0,0,118,0,-118
8225,1,0,12,0,-12
8226,0,0,94,0,-94
8227,1,0,67,0,-67
8228,0,0,116,0,-116
8229,1,1,1246,1489,243
8230,0,0,30,0,-30
8231,0,0,4,0,-4
8232,0,0,66,0,-66
8233,1,0,52,0,-52
8234,1,0,51,0,-51
8235,0,0,87,0,-87
8236,1,1,225,1284,1059
8237,1,1,229,1360,1131
8238,0,0,29,0,-29
8239,1,0,43,0,-43
8240,1,1,494,1856,1362
8241,0,0,1,0,-1
8242,0,0,95,0,-95
8243,0,0,26,0,-26
8244,1,1,1979,1447,-532
8245,1,1,888,1363,475
8246,0,0,3,0,-3
8247,0,0,43,0,-43
8248,0,0,147,0,-147
8249,0,0,15,0,-15
8250,1,0,18,0,-18
8251,1,1,73,1210,1137
8252,1,1,127,2137,2010
8253,0,0,154,0,-154
8254,1,0,70,0,-70
8255,1,1,1022,1274,252
8256,1,1,498,1304,806
8257,1,1,58,2919,2861
8258,0,0,49,0,-49
8259,1,1,239,1668,1429
8260,1,0,0,0,0
8261,1,1,25,1435,1410
8262,1,1,531,1208,677
8263,1,1,119,1416,1297
8264,0,0,49,0,-49
8265,0,0,66,0,-66
8266,1,1,129,1290,1161
8267,1,0,4,0,-4
8268,1,0,21,0,-21
8269,1,0,8,0,-8
8270,1,1,1272,1314,42
8271,1,0,49,0,-49
8272,1,0,37,0,-37
8273,0,0,4,0,-4
8274,0,0,47,0,-47
8275,1,1,74,2263,2189
8276,1,0,12,0,-12
8277,0,0,28,0,-28
8278,0,0,23,0,-23
8279,1,0,97,0,-97
8280,1,0,29,0,-29
8281,0,0,89,0,-89
8282,1,1,90,1330,1240
8283,0,0,4,0,-4
8284,1,1,221,1313,1092
8285,1,0,104,0,-104
8286,0,0,5,0,-5
8287,0,0,27,0,-27
8288,1,1,830,2254,1424
8289,0,0,2,0,-2
8290,1,0,52,0,-52
8291,0,0,117,0,-117
8292,1,1,49,1992,1943
8293,0,0,53,0,-53
8294,1,1,653,1260,607
8295,0,0,18,0,-18
8296,0,0,48,0,-48
8297,1,1,263,1485,1222
8298,1,1,857,1554,697
8299,0,0,6,0,-6
8300,1,0,3,0,-3
8301,0,0,117,0,-117
8302,0,0,172,0,-172
8303,0,0,0,0,0
8304,0,0,40,0,-40
8305,1,0,92,0,-92
8306,1,0,67,0,-67
8307,1,1,1687,2503,816
8308,1,0,22,0,-22
8309,1,0,21,0,-21
8310,1,1,690,1551,861
8311,1,1,558,1389,831
8312,1,1,51,1216,1165
8313,1,1,271,1525,1254
8314,0,0,54,0,-54
8315,1,1,236,1369,1133
8316,0,0,24,0,-24
8317,1,1,873,1336,463
8318,0,0,0,0,0
8319,1,1,763,2473,1710
8320,1,0,79,0,-79
8321,1,0,22,0,-22
8322,0,0,38,0,-38
8323,1,0,21,0,-21
8324,0,0,2,0,-2
8325,1,1,793,1995,1202
8326,1,1,1775,1424,-351
8327,1,1,285,1957,1672
8328,1,0,10,0,-10
8329,1,0,13,0,-13
8330,0,0,34,0,-34
8331,1,0,14,0,-14
8332,1,0,125,0,-125
8333,1,0,20,0,-20
8334,0,0,155,0,-155
8335,1,1,698,1288,590
8336,1,1,344,2342,1998
8337,0,0,0,0,0
8338,1,0,2,0,-2
8339,1,0,40,0,-40
8340,1,1,1025,1346,321
8341,0,0,51,0,-51
8342,1,0,99,0,-99
8343,0,0,10,0,-10
8344,1,0,29,0,-29
8345,1,0,26,0,-26
8346,0,0,17,0,-17
8347,0,0,0,0,0
8348,0,0,135,0,-135
8349,1,1,351,1281,930
8350,1,1,204,1228,1024
8351,0,0,11,0,-11
8352,1,1,41,1911,1870
8353,1,1,366,1213,847
8354,1,0,19,0,-19
8355,0,0,22,0,-22
8356,1,0,3,0,-3
8357,1,1,299,1257,958
8358,0,0,79,0,-79
8359,1,1,116,2360,2244
8360,0,0,32,0,-32
8361,1,0,2,0,-2
8362,0,0,45,0,-45
8363,0,0,20,0,-20
8364,1,1,1647,1245,-402
8365,0,0,71,0,-71
8366,0,0,8,0,-8
8367,1,1,106,1620,1514
8368,1,0,8,0,-8
8369,0,0,23,0,-23
8370,0,0,1,0,-1
8371,1,1,245,1252,1007
8372,0,0,66,0,-66
8373,0,0,26,0,-26
8374,0,0,31,0,-31
8375,1,0,30,0,-30
8376,0,0,9,0,-9
8377,1,0,0,0,0
8378,1,0,6,0,-6
8379,1,1,797,1525,728
8380,0,0,15,0,-15
8381,1,1,82,1556,1474
8382,1,0,2,0,-2
8383,1,0,12,0,-12
8384,0,0,72,0,-72
8385,1,0,10,0,-10
8386,0,0,61,0,-61
8387,1,1,120,1826,1706
8388,1,1,187,1337,1150
8389,1,0,15,0,-15
8390,1,1,147,1430,1283
8391,1,0,16,0,-16
8392,1,0,50,0,-50
8393,0,0,6,0,-6
8394,0,0,4,0,-4
8395,0,0,26,0,-26
8396,1,0,17,0,-17
8397,0,0,27,0,-27
8398,1,0,8,0,-8
8399,1,0,34,0,-34
8400,0,0,48,0,-48
8401,0,0,78,0,-78
8402,1,1,488,1338,850
8403,1,1,759,1285,526
8404,1,1,60,1219,1159
8405,0,0,25,0,-25
8406,1,0,30,0,-30
8407,1,0,45,0,-45
8408,1,1,345,1552,1207
8409,0,0,6,0,-6
8410,0,0,72,0,-72
8411,1,0,57,0,-57
8412,0,0,24,0,-24
8413,1,0,17,0,-17
8414,1,1,100,1492,1392
8415,0,0,82,0,-82
8416,1,1,183,1288,1105
8417,0,0,9,0,-9
8418,1,0,7,0,-7
8419,1,0,15,0,-15
8420,1,1,216,1221,1005
8421,1,1,406,1586,1180
8422,1,0,4,0,-4
8423,0,0,59,0,-59
8424,1,0,46,0,-46
8425,1,0,24,0,-24
8426,1,0,7,0,-7
8427,1,1,227,1380,1153
8428,1,1,862,1243,381
8429,0,0,30,0,-30
8430,1,0,17,0,-17
8431,1,1,659,1773,1114
8432,1,1,287,1327,1040
8433,0,0,33,0,-33
8434,0,0,42,0,-42
8435,1,0,93,0,-93
8436,0,0,51,0,-51
8437,0,0,22,0,-22
8438,1,0,9,0,-9
8439,0,0,145,0,-145
8440,1,0,9,0,-9
8441,0,0,44,0,-44
8442,1,1,291,1338,1047
8443,1,1,184,1319,1135
8444,0,0,7,0,-7
8445,0,0,31,0,-31
8446,0,0,60,0,-60
8447,0,0,48,0,-48
8448,1,0,64,0,-64
8449,1,1,2544,1930,-614
8450,1,0,138,0,-138
8451,1,1,763,1566,803
8452,0,0,15,0,-15
8453,0,0,0,0,0
8454,1,0,17,0,-17
8455,1,0,24,0,-24
8456,1,0,3,0,-3
8457,0,0,31,0,-31
8458,1,0,177,0,-177
8459,1,1,755,1906,1151
8460,0,0,35,0,-35
8461,0,0,44,0,-44
8462,1,1,210,1288,1078
8463,1,0,74,0,-74
8464,1,1,87,1387,1300
8465,1,1,146,1274,1128
8466,0,0,7,0,-7
8467,0,0,15,0,-15
8468,0,0,60,0,-60
8469,0,0,0,0,0
8470,0,0,8,0,-8
8471,0,0,23,0,-23
8472,1,0,37,0,-37
8473,0,0,50,0,-50
8474,1,1,812,1655,843
8475,1,0,101,0,-101
8476,0,0,190,0,-190
8477,0,0,26,0,-26
8478,1,0,73,0,-73
8479,1,1,141,1696,1555
8480,1,1,350,1293,943
8481,1,0,10,0,-10
8482,0,0,76,0,-76
8483,1,1,76,1771,1695
8484,0,0,39,0,-39
8485,1,1,41,1660,1619
8486,1,1,127,3008,2881
8487,0,0,6,0,-6
8488,1,0,41,0,-41
8489,1,0,11,0,-11
8490,1,1,454,1831,1377
8491,0,0,18,0,-18
8492,1,1,236,1243,1007
8493,1,1,590,1405,815
8494,1,0,68,0,-68
8495,1,0,65,0,-65
8496,1,1,51,1671,1620
8497,1,1,624,1298,674
8498,1,0,8,0,-8
8499,0,0,74,0,-74
8500,0,0,11,0,-11
8501,0,0,34,0,-34
8502,1,0,172,0,-172
8503,0,0,8,0,-8
8504,0,0,76,0,-76
8505,0,0,192,0,-192
8506,1,0,256,0,-256
8507,0,0,150,0,-150
8508,1,0,97,0,-97
8509,1,0,44,0,-44
8510,1,1,272,1328,1056
8511,0,0,2,0,-2
8512,1,1,185,2931,2746
8513,0,0,4,0,-4
8514,1,0,1,0,-1
8515,0,0,32,0,-32
8516,1,0,95,0,-95
8517,1,0,31,0,-31
8518,1,0,1,0,-1
8519,0,0,61,0,-61
8520,0,0,43,0,-43
8521,1,0,6,0,-6
8522,0,0,88,0,-88
8523,1,1,227,1288,1061
8524,1,0,20,0,-20
8525,0,0,118,0,-118
8526,0,0,48,0,-48
8527,0,0,119,0,-119
8528,0,0,14,0,-14
8529,1,0,133,0,-133
8530,1,1,287,1418,1131
8531,0,0,24,0,-24
8532,1,0,13,0,-13
8533,0,0,114,0,-114
8534,0,0,102,0,-102
8535,0,0,25,0,-25
8536,0,0,33,0,-33
8537,1,1,807,1262,455
8538,0,0,12,0,-12
8539,0,0,21,0,-21
8540,1,0,11,0,-11
8541,0,0,80,0,-80
8542,1,0,19,0,-19
8543,0,0,18,0,-18
8544,0,0,57,0,-57
8545,0,0,17,0,-17
8546,1,0,28,0,-28
8547,1,0,104,0,-104
8548,1,0,20,0,-20
8549,0,0,112,0,-112
8550,0,0,16,0,-16
8551,0,0,81,0,-81
8552,1,0,10,0,-10
8553,1,0,106,0,-106
8554,1,1,1225,1685,460
8555,1,0,190,0,-190
8556,1,0,38,0,-38
8557,0,0,19,0,-19
8558,0,0,6,0,-6
8559,0,0,10,0,-10
8560,0,0,28,0,-28
8561,1,0,69,0,-69
8562,1,0,21,0,-21
8563,0,0,0,0,0
8564,1,1,136,1457,1321
8565,0,0,7,0,-7
8566,1,1,486,1417,931
8567,1,0,14,0,-14
8568,0,0,84,0,-84
8569,1,1,710,1231,521
8570,0,0,122,0,-122
8571,1,0,47,0,-47
8572,0,0,108,0,-108
8573,0,0,72,0,-72
8574,1,1,376,1494,1118
8575,0,0,10,0,-10
8576,0,0,158,0,-158
8577,1,1,88,1284,1196
8578,0,0,66,0,-66
8579,1,0,36,0,-36
8580,0,0,35,0,-35
8581,0,0,3,0,-3
8582,0,0,35,0,-35
8583,1,1,172,1548,1376
8584,1,0,15,0,-15
8585,1,0,28,0,-28
8586,0,0,39,0,-39
8587,1,0,64,0,-64
8588,0,0,13,0,-13
8589,1,0,40,0,-40
8590,0,0,9,0,-9
8591,0,0,30,0,-30
8592,1,1,404,1447,1043
8593,1,1,98,2026,1928
8594,0,0,21,0,-21
8595,1,1,782,1232,450
8596,1,0,1,0,-1
8597,0,0,22,0,-22
8598,1,1,219,2415,2196
8599,1,0,15,0,-15
8600,1,1,166,1435,1269
8601,1,1,73,1281,1208
8602,1,1,136,1317,1181
8603,1,1,1392,1793,401
8604,0,0,16,0,-16
8605,0,0,15,0,-15
8606,1,0,76,0,-76
8607,0,0,13,0,-13
8608,1,0,68,0,-68
8609,1,1,139,1336,1197
8610,0,0,21,0,-21
8611,0,0,7,0,-7
8612,1,1,51,1283,1232
8613,1,0,0,0,0
8614,1,1,771,1535,764
8615,0,0,18,0,-18
8616,1,1,229,1267,1038
8617,1,0,30,0,-30
8618,1,0,15,0,-15
8619,1,0,55,0,-55
8620,1,0,2,0,-2
8621,1,0,15,0,-15
8622,1,1,42,2026,1984
8623,0,0,55,0,-55
8624,1,0,12,0,-12
8625,0,0,216,0,-216
8626,1,1,754,1454,700
8627,0,0,120,0,-120
8628,1,0,58,0,-58
8629,1,0,94,0,-94
8630,1,0,9,0,-9
8631,0,0,32,0,-32
8632,1,1,652,1639,987
8633,1,0,107,0,-107
8634,0,0,118,0,-118
8635,1,0,23,0,-23
8636,1,1,815,2191,1376
8637,0,0,9,0,-9
8638,0,0,68,0,-68
8639,1,0,12,0,-12
8640,1,1,331,1462,1131
8641,0,0,17,0,-17
8642,1,0,17,0,-17
8643,0,0,5,0,-5
8644,1,1,364,1294,930
8645,1,0,204,0,-204
8646,0,0,16,0,-16
8647,1,1,476,1474,998
8648,0,0,27,0,-27
8649,1,0,35,0,-35
8650,1,1,551,1381,830
8651,0,0,99,0,-99
8652,0,0,55,0,-55
8653,0,0,84,0,-84
8654,0,0,50,0,-50
8655,1,1,386,2137,1751
8656,1,1,1178,1377,199
8657,1,1,587,1460,873
8658,1,0,151,0,-151
8659,0,0,83,0,-83
8660,1,0,33,0,-33
8661,1,1,423,1432,1009
8662,1,1,1024,1652,628
8663,0,0,34,0,-34
8664,1,1,131,1284,1153
8665,1,1,1035,1598,563
8666,1,0,11,0,-11
8667,0,0,55,0,-55
8668,1,1,461,1279,818
8669,1,1,964,1449,485
8670,1,1,203,1321,1118
8671,1,1,1050,1452,402
8672,0,0,25,0,-25
8673,1,0,35,0,-35
8674,0,0,73,0,-73
8675,0,0,28,0,-28
8676,1,1,104,1510,1406
8677,1,0,164,0,-164
8678,0,0,77,0,-77
8679,1,0,3,0,-3
8680,1,1,1537,2600,1063
8681,0,0,25,0,-25
8682,0,0,61,0,-61
8683,1,0,19,0,-19
8684,1,1,472,1730,1258
8685,0,0,93,0,-93
8686,1,1,325,1273,948
8687,0,0,42,0,-42
8688,1,0,11,0,-11
8689,1,1,485,2002,1517
8690,0,0,2,0,-2
8691,1,0,27,0,-27
8692,1,1,684,1783,1099
8693,1,1,1562,1214,-348
8694,1,1,98,1294,1196
8695,1,1,215,1751,1536
8696,0,0,13,0,-13
8697,1,1,592,1307,715
8698,0,0,66,0,-66
8699,1,0,17,0,-17
8700,0,0,45,0,-45
8701,1,0,45,0,-45
8702,0,0,38,0,-38
8703,1,1,202,1634,1432
8704,0,0,20,0,-20
8705,0,0,38,0,-38
8706,1,0,18,0,-18
8707,0,0,131,0,-131
8708,1,1,208,1398,1190
8709,1,1,590,1243,653
8710,0,0,54,0,-54
8711,1,1,347,1399,1052
8712,1,1,1136,1346,210
8713,1,1,1119,1279,160
8714,1,0,102,0,-102
8715,1,1,227,4734,4507
8716,0,0,9,0,-9
8717,1,1,331,1432,1101
8718,1,0,33,0,-33
8719,1,1,184,1228,1044
8720,1,0,37,0,-37
8721,1,0,119,0,-119
8722,1,0,26,0,-26
8723,0,0,16,0,-16
8724,0,0,46,0,-46
8725,1,0,9,0,-9
8726,0,0,56,0,-56
8727,1,0,33,0,-33
8728,0,0,88,0,-88
8729,0,0,0,0,0
8730,1,0,19,0,-19
8731,0,0,90,0,-90
8732,1,0,22,0,-22
8733,0,0,20,0,-20
8734,1,1,382,1523,1141
8735,0,0,97,0,-97
8736,0,0,16,0,-16
8737,1,1,283,3104,2821
8738,1,0,33,0,-33
8739,1,1,218,1660,1442
8740,0,0,22,0,-22
8741,1,0,13,0,-13
8742,0,0,375,0,-375
8743,1,0,31,0,-31
8744,0,0,71,0,-71
8745,1,0,184,0,-184
8746,1,1,435,1449,1014
8747,1,1,1125,1893,768
8748,0,0,88,0,-88
8749,0,0,86,0,-86
8750,1,1,255,1465,1210
8751,0,0,18,0,-18
8752,0,0,6,0,-6
8753,1,0,80,0,-80
8754,1,0,115,0,-115
8755,1,1,191,1226,1035
8756,0,0,8,0,-8
8757,1,0,0,0,0
8758,0,0,6,0,-6
8759,1,1,324,2039,1715
8760,0,0,117,0,-117
8761,1,0,38,0,-38
8762,1,1,135,1298,1163
8763,1,1,208,1487,1279
8764,1,1,323,1798,1475
8765,1,1,572,1213,641
8766,0,0,50,0,-50
8767,1,0,17,0,-17
8768,1,0,34,0,-34
8769,1,0,28,0,-28
8770,1,0,95,0,-95
8771,1,1,1342,1283,-59
8772,1,0,29,0,-29
8773,1,0,20,0,-20
8774,1,1,650,1378,728
8775,1,1,120,1687,1567
8776,0,0,24,0,-24
8777,0,0,31,0,-31
8778,0,0,1,0,-1
8779,1,0,3,0,-3
8780,0,0,88,0,-88
8781,1,1,1007,1279,272
8782,1,1,712,1806,1094
8783,1,1,343,2551,2208
8784,1,1,138,1568,1430
8785,0,0,0,0,0
8786,0,0,4,0,-4
8787,1,1,1164,1336,172
8788,1,1,1308,1417,109
8789,0,0,94,0,-94
8790,1,1,1510,1206,-304
8791,1,0,23,0,-23
8792,1,0,25,0,-25
8793,0,0,51,0,-51
8794,0,0,45,0,-45
8795,0,0,3,0,-3
8796,0,0,67,0,-67
8797,0,0,22,0,-22
8798,0,0,23,0,-23
8799,1,0,31,0,-31
8800,0,0,20,0,-20
8801,0,0,61,0,-61
8802,0,0,23,0,-23
8803,0,0,8,0,-8
8804,1,1,145,1527,1382
8805,1,0,122,0,-122
8806,0,0,89,0,-89
8807,1,1,2581,1291,-1290
8808,1,1,72,1359,1287
8809,0,0,18,0,-18
8810,0,0,25,0,-25
8811,1,1,530,1428,898
8812,1,0,184,0,-184
8813,0,0,17,0,-17
8814,1,0,10,0,-10
8815,1,1,116,1528,1412
8816,1,1,927,1238,311
8817,1,0,8,0,-8
8818,0,0,77,0,-77
8819,1,1,955,1343,388
8820,1,0,5,0,-5
8821,1,1,31,1970,1939
8822,1,0,81,0,-81
8823,1,1,183,1417,1234
8824,1,0,78,0,-78
8825,1,1,1132,1498,366
8826,1,0,22,0,-22
8827,1,1,138,1402,1264
8828,1,1,1131,2033,902
8829,0,0,34,0,-34
8830,1,1,337,1250,913
8831,1,1,577,1212,635
8832,0,0,5,0,-5
8833,1,1,472,1272,800
8834,1,0,8,0,-8
8835,1,0,68,0,-68
8836,1,1,105,1247,1142
8837,1,0,38,0,-38
8838,1,1,268,1746,1478
8839,0,0,29,0,-29
8840,1,1,482,1253,771
8841,1,1,662,1470,808
8842,1,0,84,0,-84
8843,1,1,1908,1522,-386
8844,1,1,37,2767,2730
8845,0,0,44,0,-44
8846,1,1,260,1372,1112
8847,1,0,45,0,-45
8848,1,0,151,0,-151
8849,0,0,19,0,-19
8850,0,0,101,0,-101
8851,0,0,56,0,-56
8852,1,1,141,1453,1312
8853,1,0,156,0,-156
8854,1,0,19,0,-19
8855,0,0,25,0,-25
8856,1,1,680,1429,749
8857,0,0,0,0,0
8858,1,1,695,1382,687
8859,0,0,27,0,-27
8860,0,0,0,0,0
8861,1,0,53,0,-53
8862,1,1,29,1260,1231
8863,1,1,672,1558,886
8864,1,1,125,1511,1386
8865,0,0,27,0,-27
8866,1,1,144,1700,1556
8867,0,0,174,0,-174
8868,1,1,152,1255,1103
8869,0,0,32,0,-32
8870,1,1,786,1533,747
8871,1,1,388,1415,1027
8872,0,0,267,0,-267
8873,0,0,7,0,-7
8874,1,0,44,0,-44
8875,1,1,1767,1329,-438
8876,1,0,80,0,-80
8877,0,0,10,0,-10
8878,1,0,40,0,-40
8879,1,1,346,1380,1034
8880,1,1,1048,2136,1088
8881,0,0,24,0,-24
8882,0,0,38,0,-38
8883,0,0,81,0,-81
8884,1,1,518,1935,1417
8885,1,0,62,0,-62
8886,0,0,16,0,-16
8887,0,0,5,0,-5
8888,1,1,24,1334,1310
8889,1,1,1018,1428,410
8890,1,0,5,0,-5
8891,0,0,0,0,0
8892,0,0,70,0,-70
8893,0,0,48,0,-48
8894,1,1,58,2394,2336
8895,1,1,2731,2498,-233
8896,0,0,10,0,-10
8897,0,0,63,0,-63
8898,0,0,31,0,-31
8899,0,0,82,0,-82
8900,0,0,3,0,-3
8901,1,0,11,0,-11
8902,1,0,116,0,-116
8903,1,0,144,0,-144
8904,1,1,561,1336,775
8905,0,0,84,0,-84
8906,1,0,21,0,-21
8907,1,0,46,0,-46
8908,1,0,11,0,-11
8909,1,0,58,0,-58
8910,1,0,78,0,-78
8911,0,0,40,0,-40
8912,1,1,633,1526,893
8913,0,0,7,0,-7
8914,1,1,1762,2566,804
8915,1,1,115,1265,1150
8916,0,0,22,0,-22
8917,1,0,6,0,-6
8918,1,0,35,0,-35
8919,0,0,36,0,-36
8920,1,0,148,0,-148
8921,1,1,609,2902,2293
8922,1,0,165,0,-165
8923,0,0,9,0,-9
8924,1,1,239,1414,1175
8925,1,0,39,0,-39
8926,0,0,44,0,-44
8927,1,1,643,2134,1491
8928,1,0,0,0,0
8929,1,0,32,0,-32
8930,1,1,795,1396,601
8931,1,1,2110,2800,690
8932,0,0,94,0,-94
8933,0,0,50,0,-50
8934,1,0,17,0,-17
8935,1,0,4,0,-4
8936,0,0,13,0,-13
8937,0,0,14,0,-14
8938,0,0,30,0,-30
8939,1,0,62,0,-62
8940,1,0,28,0,-28
8941,0,0,7,0,-7
8942,0,0,27,0,-27
8943,1,0,12,0,-12
8944,0,0,45,0,-45
8945,0,0,67,0,-67
8946,1,0,8,0,-8
8947,1,1,686,1323,637
8948,1,1,66,1541,1475
8949,1,0,48,0,-48
8950,0,0,40,0,-40
8951,1,0,63,0,-63
8952,0,0,25,0,-25
8953,0,0,2,0,-2
8954,0,0,48,0,-48
8955,1,1,303,1373,1070
8956,0,0,30,0,-30
8957,1,0,36,0,-36
8958,1,0,18,0,-18
8959,0,0,10,0,-10
8960,1,0,41,0,-41
8961,0,0,141,0,-141
8962,1,0,39,0,-39
8963,1,1,257,2500,2243
8964,1,0,36,0,-36
8965,1,0,0,0,0
8966,0,0,1,0,-1
8967,0,0,121,0,-121
8968,1,0,101,0,-101
8969,1,0,98,0,-98
8970,1,1,127,1896,1769
8971,0,0,37,0,-37
8972,1,0,0,0,0
8973,1,1,835,1229,394
8974,1,1,149,1246,1097
8975,1,0,15,0,-15
8976,0,0,55,0,-55
8977,1,0,115,0,-115
8978,0,0,15,0,-15
8979,1,0,20,0,-20
8980,1,0,216,0,-216
8981,1,0,20,0,-20
8982,1,1,735,1452,717
8983,1,1,579,1897,1318
8984,1,0,20,0,-20
8985,0,0,25,0,-25
8986,1,1,139,1355,1216
8987,1,0,66,0,-66
8988,0,0,31,0,-31
8989,1,1,888,1434,546
8990,1,0,18,0,-18
8991,1,1,250,1510,1260
8992,0,0,37,0,-37
8993,0,0,22,0,-22
8994,1,1,363,1216,853
8995,1,0,106,0,-106
8996,1,1,697,1585,888
8997,0,0,36,0,-36
8998,1,0,0,0,0
8999,0,0,76,0,-76
9000,1,0,15,0,-15
9001,0,0,1,0,-1
9002,1,0,7,0,-7
9003,1,0,46,0,-46
9004,0,0,52,0,-52
9005,1,1,53,1725,1672
9006,1,0,4,0,-4
9007,1,0,40,0,-40
9008,0,0,77,0,-77
9009,1,0,33,0,-33
9010,1,0,9,0,-9
9011,1,1,905,1820,915
9012,1,0,178,0,-178
9013,0,0,3,0,-3
9014,1,0,15,0,-15
9015,1,0,306,0,-306
9016,1,0,68,0,-68
9017,0,0,53,0,-53
9018,0,0,74,0,-74
9019,1,0,66,0,-66
9020,0,0,13,0,-13
9021,0,0,49,0,-49
9022,1,0,8,0,-8
9023,1,0,147,0,-147
9024,1,0,81,0,-81
9025,1,0,1,0,-1
9026,1,0,64,0,-64
9027,1,1,171,1568,1397
9028,1,0,10,0,-10
9029,0,0,4,0,-4
9030,0,0,47,0,-47
9031,1,0,109,0,-109
9032,1,0,49,0,-49
9033,0,0,22,0,-22
9034,0,0,19,0,-19
9035,0,0,200,0,-200
9036,1,1,168,1310,1142
9037,1,1,435,1545,1110
9038,1,1,230,1480,1250
9039,1,1,884,1351,467
9040,0,0,16,0,-16
9041,1,0,37,0,-37
9042,1,1,874,1353,479
9043,0,0,103,0,-103
9044,0,0,68,0,-68
9045,1,0,32,0,-32
9046,1,1,472,1244,772
9047,0,0,39,0,-39
9048,0,0,88,0,-88
9049,0,0,33,0,-33
9050,0,0,8,0,-8
9051,1,0,35,0,-35
9052,0,0,135,0,-135
9053,1,0,29,0,-29
9054,0,0,140,0,-140
9055,1,1,97,1317,1220
9056,0,0,195,0,-195
9057,1,1,3524,1290,-2234
9058,1,0,27,0,-27
9059,0,0,70,0,-70
9060,0,0,205,0,-205
9061,0,0,38,0,-38
9062,1,0,18,0,-18
9063,0,0,32,0,-32
9064,0,0,74,0,-74
9065,1,0,0,0,0
9066,1,0,2,0,-2
9067,1,0,0,0,0
9068,1,1,798,1489,691
9069,0,0,72,0,-72
9070,1,0,11,0,-11
9071,1,0,15,0,-15
9072,0,0,4,0,-4
9073,1,0,16,0,-16
9074,0,0,11,0,-11
9075,0,0,4,0,-4
9076,0,0,42,0,-42
9077,1,1,1272,1594,322
9078,1,1,1832,1263,-569
9079,1,0,81,0,-81
9080,0,0,108,0,-108
9081,0,0,112,0,-112
9082,1,0,36,0,-36
9083,0,0,92,0,-92
9084,0,0,58,0,-58
9085,0,0,30,0,-30
9086,1,0,8,0,-8
9087,0,0,3,0,-3
9088,1,1,439,1320,881
9089,1,0,103,0,-103
9090,1,1,69,1492,1423
9091,0,0,13,0,-13
9092,0,0,22,0,-22
9093,0,0,98,0,-98
9094,1,0,51,0,-51
9095,0,0,109,0,-109
9096,1,1,235,1510,1275
9097,1,1,264,1231,967
9098,1,1,410,1756,1346
9099,0,0,9,0,-9
9100,1,0,12,0,-12
9101,1,0,32,0,-32
9102,0,0,30,0,-30
9103,1,0,40,0,-40
9104,1,0,53,0,-53
9105,1,1,300,1359,1059
9106,0,0,11,0,-11
9107,1,1,795,3452,2657
9108,1,1,302,1278,976
9109,1,1,373,1855,1482
9110,1,1,185,1276,1091
9111,1,1,360,1459,1099
9112,1,1,217,1457,1240
9113,0,0,96,0,-96
9114,0,0,79,0,-79
9115,1,1,53,1321,1268
9116,1,0,57,0,-57
9117,1,1,442,2076,1634
9118,0,0,53,0,-53
9119,1,0,54,0,-54
9120,1,1,181,1335,1154
9121,1,1,102,1879,1777
9122,0,0,5,0,-5
9123,0,0,29,0,-29
9124,1,1,233,1216,983
9125,0,0,69,0,-69
9126,1,0,51,0,-51
9127,1,1,730,2425,1695
9128,1,1,924,1292,368
9129,1,1,434,1228,794
9130,1,0,6,0,-6
9131,1,0,73,0,-73
9132,0,0,177,0,-177
9133,1,0,41,0,-41
9134,0,0,72,0,-72
9135,0,0,57,0,-57
9136,1,1,433,1619,1186
9137,0,0,54,0,-54
9138,0,0,41,0,-41
9139,1,0,9,0,-9
9140,0,0,45,0,-45
9141,1,0,64,0,-64
9142,1,1,66,1439,1373
9143,0,0,113,0,-113
9144,1,1,361,1257,896
9145,0,0,12,0,-12
9146,1,0,75,0,-75
9147,1,1,266,1813,1547
9148,0,0,33,0,-33
9149,1,0,82,0,-82
9150,1,0,14,0,-14
9151,1,1,762,1209,447
9152,1,1,291,1273,982
9153,1,0,158,0,-158
9154,0,0,8,0,-8
9155,0,0,1,0,-1
9156,0,0,60,0,-60
9157,1,1,92,1525,1433
9158,1,0,37,0,-37
9159,1,1,111,1228,1117
9160,1,1,333,1599,1266
9161,1,1,272,1702,1430
9162,1,1,415,3522,3107
9163,0,0,37,0,-37
9164,0,0,14,0,-14
9165,0,0,112,0,-112
9166,1,1,613,1442,829
9167,1,1,557,1434,877
9168,1,1,93,1210,1117
9169,1,0,20,0,-20
9170,1,0,12,0,-12
9171,1,1,117,1441,1324
9172,1,0,82,0,-82
9173,0,0,0,0,0
9174,1,0,37,0,-37
9175,1,0,95,0,-95
9176,1,1,155,1564,1409
9177,1,1,342,1388,1046
9178,0,0,39,0,-39
9179,1,0,48,0,-48
9180,0,0,28,0,-28
9181,1,1,1412,1329,-83
9182,0,0,142,0,-142
9183,1,1,381,1332,951
9184,1,1,80,1201,1121
9185,0,0,18,0,-18
9186,1,0,88,0,-88
9187,0,0,231,0,-231
9188,1,1,618,1713,1095
9189,0,0,75,0,-75
9190,1,1,315,1416,1101
9191,1,0,30,0,-30
9192,0,0,12,0,-12
9193,0,0,9,0,-9
9194,1,1,729,1509,780
9195,1,0,25,0,-25
9196,1,0,13,0,-13
9197,0,0,9,0,-9
9198,0,0,12,0,-12
9199,0,0,135,0,-135
9200,1,0,50,0,-50
9201,1,0,27,0,-27
9202,1,0,127,0,-127
9203,1,0,3,0,-3
9204,0,0,46,0,-46
9205,0,0,5,0,-5
9206,1,1,1222,1543,321
9207,1,1,1083,1381,298
9208,0,0,6,0,-6
9209,1,1,235,1276,1041
9210,1,1,750,2145,1395
9211,1,0,54,0,-54
9212,1,1,260,1457,1197
9213,0,0,74,0,-74
9214,1,0,7,0,-7
9215,1,0,30,0,-30
9216,1,1,312,1229,917
9217,0,0,30,0,-30
9218,1,0,18,0,-18
9219,1,1,1867,1389,-478
9220,1,0,131,0,-131
9221,1,1,31,1322,1291
9222,1,1,357,1271,914
9223,0,0,0,0,0
9224,1,1,1272,1406,134
9225,1,1,313,1200,887
9226,1,0,44,0,-44
9227,1,1,1063,1370,307
9228,0,0,4,0,-4
9229,1,1,62,1276,1214
9230,1,0,115,0,-115
9231,1,1,76,1306,1230
9232,1,0,28,0,-28
9233,1,1,425,1222,797
9234,1,1,91,2284,2193
9235,0,0,10,0,-10
9236,0,0,69,0,-69
9237,0,0,46,0,-46
9238,0,0,3,0,-3
9239,1,0,100,0,-100
9240,1,1,33,1289,1256
9241,1,0,7,0,-7
9242,1,0,52,0,-52
9243,1,1,643,2063,1420
9244,1,1,621,1259,638
9245,0,0,156,0,-156
9246,0,0,6,0,-6
9247,1,0,20,0,-20
9248,1,0,4,0,-4
9249,1,0,9,0,-9
9250,1,1,704,1317,613
9251,1,1,658,1202,544
9252,1,0,20,0,-20
9253,1,1,1400,1821,421
9254,1,0,54,0,-54
9255,0,0,66,0,-66
9256,0,0,86,0,-86
9257,1,0,34,0,-34
9258,0,0,15,0,-15
9259,1,0,27,0,-27
9260,1,0,20,0,-20
9261,1,0,23,0,-23
9262,1,0,64,0,-64
9263,1,0,126,0,-126
9264,1,0,48,0,-48
9265,0,0,18,0,-18
9266,0,0,24,0,-24
9267,1,0,36,0,-36
9268,1,1,171,1773,1602
9269,0,0,23,0,-23
9270,1,0,15,0,-15
9271,1,1,80,1267,1187
9272,0,0,5,0,-5
9273,1,0,10,0,-10
9274,1,1,293,1292,999
9275,0,0,93,0,-93
9276,1,1,268,2804,2536
9277,1,1,635,1242,607
9278,0,0,8,0,-8
9279,1,1,230,1329,1099
9280,1,1,1436,2545,1109
9281,0,0,18,0,-18
9282,1,0,67,0,-67
9283,1,1,177,1420,1243
9284,0,0,71,0,-71
9285,1,1,246,1348,1102
9286,0,0,208,0,-208
9287,0,0,44,0,-44
9288,0,0,66,0,-66
9289,1,1,198,1205,1007
9290,0,0,21,0,-21
9291,1,1,43,1369,1326
9292,1,1,690,1346,656
9293,1,0,48,0,-48
9294,1,0,69,0,-69
9295,1,0,104,0,-104
9296,0,0,5,0,-5
9297,1,0,26,0,-26
9298,1,1,84,1644,1560
9299,0,0,14,0,-14
9300,1,0,13,0,-13
9301,1,1,913,1423,510
9302,1,1,136,1220,1084
9303,1,0,8,0,-8
9304,1,0,57,0,-57
9305,1,1,96,1217,1121
9306,1,1,432,1269,837
9307,1,0,29,0,-29
9308,0,0,45,0,-45
9309,0,0,100,0,-100
9310,1,0,18,0,-18
9311,0,0,120,0,-120
9312,1,0,7,0,-7
9313,0,0,2,0,-2
9314,1,1,1265,1482,217
9315,1,0,1,0,-1
9316,1,0,87,0,-87
9317,0,0,22,0,-22
9318,0,0,65,0,-65
9319,1,1,365,2164,1799
9320,0,0,16,0,-16
9321,0,0,6,0,-6
9322,1,1,597,1302,705
9323,0,0,41,0,-41
9324,1,1,236,1251,1015
9325,1,0,49,0,-49
9326,0,0,66,0,-66
9327,0,0,12,0,-12
9328,0,0,2,0,-2
9329,0,0,20,0,-20
9330,0,0,102,0,-102
9331,1,1,215,1200,985
9332,0,0,23,0,-23
9333,0,0,39,0,-39
9334,1,0,7,0,-7
9335,1,0,102,0,-102
9336,1,1,877,1369,492
9337,1,0,32,0,-32
9338,1,1,106,1361,1255
9339,1,0,33,0,-33
9340,1,0,10,0,-10
9341,0,0,79,0,-79
9342,1,0,35,0,-35
9343,0,0,6,0,-6
9344,0,0,1,0,-1
9345,1,1,629,1351,722
9346,1,1,369,1809,1440
9347,1,1,1002,1641,639
9348,0,0,43,0,-43
9349,1,0,101,0,-101
9350,0,0,5,0,-5
9351,1,1,551,1359,808
9352,1,1,346,1291,945
9353,0,0,42,0,-42
9354,1,0,3,0,-3
9355,1,1,385,1367,982
9356,0,0,38,0,-38
9357,1,0,91,0,-91
9358,1,1,216,1277,1061
9359,0,0,30,0,-30
9360,0,0,121,0,-121
9361,0,0,38,0,-38
9362,0,0,48,0,-48
9363,1,1,221,1322,1101
9364,1,0,80,0,-80
9365,1,0,281,0,-281
9366,1,1,100,1210,1110
9367,0,0,158,0,-158
9368,0,0,40,0,-40
9369,0,0,46,0,-46
9370,1,0,136,0,-136
9371,1,0,2,0,-2
9372,1,0,36,0,-36
9373,1,0,41,0,-41
9374,1,0,26,0,-26
9375,1,0,43,0,-43
9376,1,1,125,1589,1464
9377,0,0,28,0,-28
9378,1,0,15,0,-15
9379,1,1,311,2854,2543
9380,0,0,4,0,-4
9381,1,1,890,3002,2112
9382,1,1,1283,1369,86
9383,0,0,0,0,0
9384,0,0,23,0,-23
9385,0,0,91,0,-91
9386,1,1,550,3256,2706
9387,1,1,201,1427,1226
9388,1,1,69,3277,3208
9389,0,0,1,0,-1
9390,1,0,32,0,-32
9391,0,0,165,0,-165
9392,1,0,53,0,-53
9393,0,0,13,0,-13
9394,1,0,37,0,-37
9395,0,0,16,0,-16
9396,0,0,66,0,-66
9397,0,0,15,0,-15
9398,1,0,4,0,-4
9399,0,0,142,0,-142
9400,0,0,82,0,-82
9401,1,0,72,0,-72
9402,1,1,59,1281,1222
9403,0,0,5,0,-5
9404,0,0,172,0,-172
9405,0,0,50,0,-50
9406,1,1,432,1629,1197
9407,1,0,25,0,-25
9408,0,0,4,0,-4
9409,1,1,465,1740,1275
9410,1,0,80,0,-80
9411,1,1,60,1247,1187
9412,1,0,45,0,-45
9413,0,0,49,0,-49
9414,0,0,13,0,-13
9415,0,0,14,0,-14
9416,0,0,21,0,-21
9417,1,1,282,1424,1142
9418,0,0,27,0,-27
9419,0,0,63,0,-63
9420,0,0,23,0,-23
9421,1,1,688,1584,896
9422,0,0,31,0,-31
9423,1,0,26,0,-26
9424,1,0,18,0,-18
9425,0,0,26,0,-26
9426,1,0,70,0,-70
9427,1,1,488,1332,844
9428,1,1,622,1462,840
9429,1,0,2,0,-2
9430,1,0,45,0,-45
9431,1,1,318,1223,905
9432,1,1,1767,1620,-147
9433,0,0,30,0,-30
9434,1,1,172,1229,1057
9435,1,1,563,1509,946
9436,1,1,390,1276,886
9437,1,0,15,0,-15
9438,1,0,43,0,-43
9439,1,1,161,1206,1045
9440,0,0,91,0,-91
9441,0,0,27,0,-27
9442,1,0,56,0,-56
9443,1,1,1375,1605,230
9444,0,0,27,0,-27
9445,1,0,158,0,-158
9446,1,1,185,1443,1258
9447,1,0,14,0,-14
9448,1,0,87,0,-87
9449,0,0,9,0,-9
9450,0,0,111,0,-111
9451,1,0,53,0,-53
9452,1,1,1844,1238,-606
9453,0,0,3,0,-3
9454,0,0,12,0,-12
9455,0,0,67,0,-67
9456,0,0,78,0,-78
9457,1,0,63,0,-63
9458,1,1,754,1392,638
9459,1,1,361,1453,1092
9460,0,0,44,0,-44
9461,1,1,131,1321,1190
9462,0,0,21,0,-21
9463,0,0,10,0,-10
9464,0,0,16,0,-16
9465,0,0,128,0,-128
9466,1,0,150,0,-150
9467,0,0,78,0,-78
9468,0,0,59,0,-59
9469,0,0,13,0,-13
9470,1,0,17,0,-17
9471,0,0,8,0,-8
9472,0,0,73,0,-73
9473,1,0,107,0,-107
9474,1,1,535,1282,747
9475,1,0,10,0,-10
9476,1,0,47,0,-47
9477,0,0,33,0,-33
9478,1,1,177,1292,1115
9479,1,1,403,1227,824
9480,1,0,67,0,-67
9481,0,0,100,0,-100
9482,1,1,618,2356,1738
9483,0,0,61,0,-61
9484,1,1,597,1281,684
9485,1,1,2359,1681,-678
9486,1,0,59,0,-59
9487,1,1,139,1804,1665
9488,1,1,233,1498,1265
9489,1,0,142,0,-142
9490,1,0,0,0,0
9491,1,0,14,0,-14
9492,1,0,104,0,-104
9493,1,1,185,1963,1778
9494,1,1,47,1427,1380
9495,1,0,5,0,-5
9496,1,0,172,0,-172
9497,1,0,78,0,-78
9498,0,0,16,0,-16
9499,0,0,120,0,-120
9500,0,0,71,0,-71
9501,0,0,53,0,-53
9502,1,1,965,1322,357
9503,1,1,376,1457,1081
9504,0,0,19,0,-19
9505,0,0,158,0,-158
9506,0,0,6,0,-6
9507,0,0,178,0,-178
9508,1,1,209,3411,3202
9509,1,1,753,1268,515
9510,0,0,104,0,-104
9511,1,0,18,0,-18
9512,1,0,137,0,-137
9513,0,0,47,0,-47
9514,1,1,827,1419,592
9515,1,0,3,0,-3
9516,1,1,60,1869,1809
9517,1,1,181,1377,1196
9518,0,0,13,0,-13
9519,0,0,85,0,-85
9520,0,0,34,0,-34
9521,1,0,48,0,-48
9522,1,1,1456,1264,-192
9523,1,1,531,1250,719
9524,1,0,29,0,-29
9525,0,0,69,0,-69
9526,0,0,31,0,-31
9527,1,1,110,1494,1384
9528,0,0,49,0,-49
9529,0,0,8,0,-8
9530,0,0,20,0,-20
9531,1,0,69,0,-69
9532,0,0,13,0,-13
9533,0,0,6,0,-6
9534,1,0,45,0,-45
9535,1,1,651,1618,967
9536,0,0,26,0,-26
9537,1,1,23,1467,1444
9538,1,0,36,0,-36
9539,1,1,386,1331,945
9540,0,0,10,0,-10
9541,1,0,22,0,-22
9542,1,0,114,0,-114
9543,1,0,74,0,-74
9544,0,0,22,0,-22
9545,0,0,100,0,-100
9546,1,0,24,0,-24
9547,1,1,149,1209,1060
9548,0,0,17,0,-17
9549,0,0,67,0,-67
9550,0,0,60,0,-60
9551,1,0,54,0,-54
9552,1,0,29,0,-29
9553,1,1,41,1233,1192
9554,1,1,18,1370,1352
9555,0,0,4,0,-4
9556,1,1,694,1211,517
9557,0,0,126,0,-126
9558,1,1,41,1290,1249
9559,1,1,1285,2348,1063
9560,0,0,38,0,-38
9561,1,1,463,1282,819
9562,0,0,6,0,-6
9563,1,0,26,0,-26
9564,0,0,51,0,-51
9565,0,0,83,0,-83
9566,1,0,48,0,-48
9567,1,1,92,1223,1131
9568,1,1,337,2112,1775
9569,1,1,362,1221,859
9570,1,1,398,1817,1419
9571,0,0,27,0,-27
9572,1,0,134,0,-134
9573,0,0,27,0,-27
9574,1,1,679,1269,590
9575,1,0,14,0,-14
9576,0,0,86,0,-86
9577,0,0,70,0,-70
9578,0,0,37,0,-37
9579,0,0,13,0,-13
9580,1,1,177,1204,1027
9581,1,1,344,1250,906
9582,0,0,51,0,-51
9583,1,0,25,0,-25
9584,0,0,66,0,-66
9585,1,1,166,1910,1744
9586,1,0,53,0,-53
9587,0,0,32,0,-32
9588,1,1,289,1532,1243
9589,1,0,9,0,-9
9590,1,1,242,1655,1413
9591,0,0,26,0,-26
9592,1,1,217,1941,1724
9593,1,1,1614,1370,-244
9594,1,1,273,1426,1153
9595,1,1,844,1592,748
9596,1,0,24,0,-24
9597,1,1,55,1456,1401
9598,1,0,89,0,-89
9599,1,0,39,0,-39
9600,1,1,213,2336,2123
9601,1,1,987,1768,781
9602,0,0,40,0,-40
9603,0,0,69,0,-69
9604,1,1,112,1210,1098
9605,1,1,190,2510,2320
9606,1,1,62,1250,1188
9607,1,0,18,0,-18
9608,0,0,64,0,-64
9609,1,1,34,1421,1387
9610,0,0,0,0,0
9611,1,1,383,1478,1095
9612,1,0,7,0,-7
9613,1,0,28,0,-28
9614,1,1,282,1553,1271
9615,1,0,34,0,-34
9616,1,0,1,0,-1
9617,1,1,334,1217,883
9618,1,1,148,1237,1089
9619,1,1,1739,1643,-96
9620,0,0,22,0,-22
9621,1,1,297,1521,1224
9622,1,0,1,0,-1
9623,1,0,73,0,-73
9624,1,1,640,1245,605
9625,1,0,29,0,-29
9626,1,0,35,0,-35
9627,0,0,65,0,-65
9628,1,0,13,0,-13
9629,0,0,20,0,-20
9630,0,0,77,0,-77
9631,1,0,18,0,-18
9632,1,0,121,0,-121
9633,0,0,0,0,0
9634,1,1,181,1269,1088
9635,0,0,29,0,-29
9636,1,1,300,1276,976
9637,0,0,86,0,-86
9638,0,0,26,0,-26
9639,1,1,144,1463,1319
9640,1,1,1545,1242,-303
9641,0,0,17,0,-17
9642,1,0,57,0,-57
9643,1,0,140,0,-140
9644,1,0,5,0,-5
9645,1,1,73,1343,1270
9646,0,0,11,0,-11
9647,0,0,26,0,-26
9648,1,1,806,1218,412
9649,1,1,757,1257,500
9650,1,0,7,0,-7
9651,1,1,348,2229,1881
9652,1,1,88,1253,1165
9653,0,0,12,0,-12
9654,1,1,418,2087,1669
9655,1,1,113,1379,1266
9656,1,0,14,0,-14
9657,1,1,764,1340,576
9658,0,0,26,0,-26
9659,0,0,169,0,-169
9660,1,1,645,1387,742
9661,1,0,20,0,-20
9662,1,1,41,1290,1249
9663,1,0,64,0,-64
9664,1,1,267,1290,1023
9665,0,0,158,0,-158
9666,1,0,35,0,-35
9667,1,1,354,2587,2233
9668,1,0,44,0,-44
9669,1,0,3,0,-3
9670,1,0,16,0,-16
9671,1,1,311,1388,1077
9672,0,0,56,0,-56
9673,0,0,65,0,-65
9674,1,1,2214,1408,-806
9675,1,1,451,1354,903
9676,0,0,42,0,-42
9677,0,0,33,0,-33
9678,0,0,15,0,-15
9679,1,1,44,1796,1752
9680,1,1,148,1801,1653
9681,1,0,21,0,-21
9682,1,1,1835,1270,-565
9683,1,1,2264,1267,-997
9684,1,0,50,0,-50
9685,1,0,13,0,-13
9686,1,0,66,0,-66
9687,0,0,27,0,-27
9688,1,1,394,2251,1857
9689,1,0,104,0,-104
9690,1,1,598,1422,824
9691,0,0,16,0,-16
9692,1,0,25,0,-25
9693,1,1,345,1344,999
9694,1,1,289,1377,1088
9695,1,0,337,0,-337
9696,1,1,1572,1486,-86
9697,1,0,13,0,-13
9698,1,0,93,0,-93
9699,0,0,10,0,-10
9700,1,0,38,0,-38
9701,1,1,512,1390,878
9702,1,1,84,1986,1902
9703,0,0,32,0,-32
9704,0,0,96,0,-96
9705,1,0,46,0,-46
9706,0,0,62,0,-62
9707,1,1,756,1967,1211
9708,0,0,33,0,-33
9709,0,0,2,0,-2
9710,1,1,760,1422,662
9711,0,0,15,0,-15
9712,0,0,15,0,-15
9713,1,1,292,1658,1366
9714,0,0,4,0,-4
9715,1,0,53,0,-53
9716,0,0,71,0,-71
9717,0,0,8,0,-8
9718,0,0,32,0,-32
9719,0,0,16,0,-16
9720,0,0,17,0,-17
9721,1,0,31,0,-31
9722,1,0,113,0,-113
9723,1,1,435,5955,5520
9724,1,1,1064,1239,175
9725,0,0,21,0,-21
9726,0,0,52,0,-52
9727,1,0,16,0,-16
9728,1,0,21,0,-21
9729,0,0,32,0,-32
9730,1,0,86,0,-86
9731,1,1,174,1480,1306
9732,1,1,576,1263,687
9733,1,0,65,0,-65
9734,1,1,1399,1743,344
9735,1,1,95,1293,1198
9736,1,1,179,1484,1305
9737,1,1,43,1837,1794
9738,1,1,86,1798,1712
9739,1,0,84,0,-84
9740,1,1,395,2014,1619
9741,0,0,57,0,-57
9742,1,0,6,0,-6
9743,0,0,2,0,-2
9744,1,0,97,0,-97
9745,1,0,95,0,-95
9746,1,1,1903,1476,-427
9747,1,0,98,0,-98
9748,1,1,194,4080,3886
9749,1,0,69,0,-69
9750,0,0,103,0,-103
9751,0,0,11,0,-11
9752,1,0,16,0,-16
9753,1,1,922,1528,606
9754,1,0,2,0,-2
9755,1,1,71,1460,1389
9756,0,0,65,0,-65
9757,1,0,110,0,-110
9758,0,0,11,0,-11
9759,1,0,117,0,-117
9760,1,1,100,1345,1245
9761,0,0,28,0,-28
9762,1,1,82,1488,1406
9763,1,1,5,1334,1329
9764,0,0,44,0,-44
9765,1,0,30,0,-30
9766,0,0,122,0,-122
9767,1,1,381,1295,914
9768,0,0,184,0,-184
9769,1,1,91,1336,1245
9770,1,1,1081,1578,497
9771,0,0,39,0,-39
9772,0,0,43,0,-43
9773,0,0,33,0,-33
9774,0,0,129,0,-129
9775,0,0,11,0,-11
9776,0,0,9,0,-9
9777,1,1,249,1378,1129
9778,0,0,56,0,-56
9779,1,0,68,0,-68
9780,1,1,90,1612,1522
9781,0,0,24,0,-24
9782,1,1,1709,1450,-259
9783,0,0,156,0,-156
9784,1,0,6,0,-6
9785,1,1,284,1234,950
9786,1,1,336,2555,2219
9787,1,1,402,2983,2581
9788,1,1,314,1320,1006
9789,1,1,347,1259,912
9790,0,0,25,0,-25
9791,1,0,44,0,-44
9792,1,0,28,0,-28
9793,1,1,220,1520,1300
9794,1,0,118,0,-118
9795,0,0,97,0,-97
9796,1,1,152,1257,1105
9797,1,1,407,1583,1176
9798,0,0,34,0,-34
9799,1,1,263,1203,940
9800,1,0,76,0,-76
9801,0,0,56,0,-56
9802,0,0,48,0,-48
9803,1,1,228,1431,1203
9804,0,0,39,0,-39
9805,0,0,11,0,-11
9806,1,1,178,1379,1201
9807,0,0,29,0,-29
9808,0,0,55,0,-55
9809,1,0,71,0,-71
9810,0,0,116,0,-116
9811,1,1,186,1719,1533
9812,1,1,490,1271,781
9813,0,0,53,0,-53
9814,1,0,33,0,-33
9815,1,1,251,1294,1043
9816,0,0,9,0,-9
9817,1,1,1107,1230,123
9818,0,0,126,0,-126
9819,1,0,50,0,-50
9820,1,1,1305,1269,-36
9821,0,0,65,0,-65
9822,0,0,15,0,-15
9823,0,0,18,0,-18
9824,1,1,892,1217,325
9825,0,0,55,0,-55
9826,1,0,58,0,-58
9827,1,0,7,0,-7
9828,0,0,4,0,-4
9829,1,1,582,1609,1027
9830,1,0,134,0,-134
9831,1,1,469,1600,1131
9832,1,0,78,0,-78
9833,1,1,253,1313,1060
9834,1,0,24,0,-24
9835,1,1,616,1330,714
9836,1,1,517,1238,721
9837,1,0,43,0,-43
9838,1,0,68,0,-68
9839,1,1,236,1257,1021
9840,0,0,86,0,-86
9841,1,0,21,0,-21
9842,1,1,89,1351,1262
9843,0,0,108,0,-108
9844,0,0,72,0,-72
9845,1,1,109,1262,1153
9846,1,0,4,0,-4
9847,1,0,50,0,-50
9848,0,0,66,0,-66
9849,1,1,196,1428,1232
9850,0,0,38,0,-38
9851,0,0,138,0,-138
9852,0,0,13,0,-13
9853,0,0,34,0,-34
9854,0,0,4,0,-4
9855,1,0,1,0,-1
9856,1,0,6,0,-6
9857,1,1,461,1436,975
9858,1,1,30,1786,1756
9859,0,0,27,0,-27
9860,1,0,54,0,-54
9861,0,0,14,0,-14
9862,1,0,45,0,-45
9863,1,0,65,0,-65
9864,0,0,19,0,-19
9865,1,0,22,0,-22
9866,0,0,65,0,-65
9867,1,0,124,0,-124
9868,1,0,37,0,-37
9869,0,0,28,0,-28
9870,0,0,18,0,-18
9871,1,1,328,1494,1166
9872,1,1,164,1275,1111
9873,0,0,55,0,-55
9874,1,0,28,0,-28
9875,0,0,26,0,-26
9876,1,0,13,0,-13
9877,1,0,17,0,-17
9878,1,1,641,1723,1082
9879,0,0,260,0,-260
9880,1,0,35,0,-35
9881,0,0,7,0,-7
9882,0,0,20,0,-20
9883,1,0,17,0,-17
9884,0,0,86,0,-86
9885,0,0,7,0,-7
9886,1,0,10,0,-10
9887,1,1,461,1590,1129
9888,1,0,87,0,-87
9889,1,0,6,0,-6
9890,1,1,254,2214,1960
9891,0,0,159,0,-159
9892,1,1,752,1759,1007
9893,1,0,92,0,-92
9894,1,1,60,1274,1214
9895,1,0,5,0,-5
9896,1,1,425,1349,924
9897,0,0,17,0,-17
9898,1,1,923,1225,302
9899,1,0,30,0,-30
9900,1,0,2,0,-2
9901,0,0,68,0,-68
9902,1,1,459,1444,985
9903,1,1,461,1223,762
9904,1,0,126,0,-126
9905,1,1,331,1335,1004
9906,1,1,255,1375,1120
9907,1,0,45,0,-45
9908,1,1,119,1391,1272
9909,1,1,279,1292,1013
9910,0,0,19,0,-19
9911,0,0,55,0,-55
9912,1,1,91,1442,1351
9913,1,0,77,0,-77
9914,0,0,87,0,-87
9915,1,1,468,1608,1140
9916,0,0,42,0,-42
9917,1,0,121,0,-121
9918,1,1,533,1431,898
9919,1,1,200,2659,2459
9920,1,1,878,1248,370
9921,0,0,6,0,-6
9922,0,0,72,0,-72
9923,0,0,26,0,-26
9924,1,0,76,0,-76
9925,0,0,9,0,-9
9926,0,0,55,0,-55
9927,0,0,85,0,-85
9928,0,0,3,0,-3
9929,1,0,19,0,-19
9930,0,0,49,0,-49
9931,0,0,3,0,-3
9932,0,0,14,0,-14
9933,0,0,50,0,-50
9934,0,0,51,0,-51
9935,1,1,208,1495,1287
9936,1,1,896,1229,333
9937,0,0,55,0,-55
9938,1,0,63,0,-63
9939,1,0,55,0,-55
9940,1,0,9,0,-9
9941,1,0,1,0,-1
9942,1,1,313,1662,1349
9943,0,0,13,0,-13
9944,1,0,145,0,-145
9945,0,0,122,0,-122
9946,1,1,246,1711,1465
9947,1,0,25,0,-25
9948,0,0,42,0,-42
9949,0,0,1,0,-1
9950,0,0,30,0,-30
9951,0,0,9,0,-9
9952,1,1,108,1285,1177
9953,0,0,50,0,-50
9954,0,0,5,0,-5
9955,1,1,388,3256,2868
9956,0,0,45,0,-45
9957,0,0,64,0,-64
9958,1,1,304,2842,2538
9959,1,1,2373,1240,-1133
9960,0,0,48,0,-48
9961,1,1,1033,1715,682
9962,1,1,663,1382,719
9963,1,0,7,0,-7
9964,0,0,75,0,-75
9965,1,1,312,1297,985
9966,1,0,36,0,-36
9967,1,1,282,1280,998
9968,0,0,13,0,-13
9969,0,0,43,0,-43
9970,0,0,211,0,-211
9971,0,0,8,0,-8
9972,1,1,283,2103,1820
9973,1,1,80,1347,1267
9974,0,0,64,0,-64
9975,0,0,51,0,-51
9976,1,0,113,0,-113
9977,1,1,765,1292,527
9978,1,0,38,0,-38
9979,1,0,3,0,-3
9980,1,1,427,2416,1989
9981,1,0,89,0,-89
9982,1,0,25,0,-25
9983,0,0,34,0,-34
9984,1,0,127,0,-127
9985,1,0,1,0,-1
9986,1,0,126,0,-126
9987,0,0,51,0,-51
9988,1,1,580,1366,786
9989,1,0,45,0,-45
9990,0,0,20,0,-20
9991,1,0,22,0,-22
9992,1,0,84,0,-84
9993,1,0,20,0,-20
9994,1,0,178,0,-178
9995,1,0,25,0,-25
9996,0,0,55,0,-55
9997,0,0,13,0,-13
9998,0,0,21,0,-21
9999,1,1,64,1313,1249
10000,1,1,129,1384,1255
10001,0,0,0,0,0
10002,0,0,47,0,-47
10003,0,0,97,0,-97
10004,1,0,28,0,-28
10005,0,0,21,0,-21
10006,0,0,13,0,-13
10007,1,0,118,0,-118
10008,1,0,5,0,-5
10009,0,0,4,0,-4
10010,0,0,7,0,-7
10011,0,0,19,0,-19
10012,1,1,371,1478,1107
10013,1,0,57,0,-57
10014,0,0,8,0,-8
10015,0,0,11,0,-11
10016,1,1,183,2795,2612
10017,1,0,25,0,-25
10018,1,0,4,0,-4
10019,1,1,371,1312,941
10020,1,0,11,0,-11
10021,1,1,251,1214,963
10022,0,0,24,0,-24
10023,1,1,223,1333,1110
10024,1,1,210,2298,2088
10025,0,0,36,0,-36
10026,0,0,2,0,-2
10027,1,0,44,0,-44
10028,0,0,55,0,-55
10029,0,0,23,0,-23
10030,1,0,40,0,-40
10031,1,0,73,0,-73
10032,0,0,87,0,-87
10033,1,1,1131,2485,1354
10034,1,0,73,0,-73
10035,1,0,15,0,-15
10036,1,1,306,3489,3183
10037,0,0,26,0,-26
10038,0,0,23,0,-23
10039,1,0,9,0,-9
10040,0,0,4,0,-4
10041,1,0,89,0,-89
10042,0,0,5,0,-5
10043,0,0,40,0,-40
10044,0,0,77,0,-77
10045,1,1,210,1249,1039
10046,1,1,449,1443,994
10047,1,1,336,1580,1244
10048,1,1,864,1410,546
10049,0,0,8,0,-8
10050,1,0,57,0,-57
10051,1,0,34,0,-34
10052,1,0,117,0,-117
10053,1,0,117,0,-117
10054,0,0,43,0,-43
10055,1,1,419,1385,966
10056,0,0,19,0,-19
10057,0,0,11,0,-11
10058,0,0,5,0,-5
10059,0,0,29,0,-29
10060,1,0,74,0,-74
10061,0,0,61,0,-61
10062,0,0,125,0,-125
10063,1,1,292,2444,2152
10064,1,0,35,0,-35
10065,1,1,770,1849,1079
10066,0,0,176,0,-176
10067,1,1,741,2135,1394
10068,1,0,126,0,-126
10069,1,1,855,2076,1221
10070,0,0,28,0,-28
10071,1,0,18,0,-18
10072,1,0,62,0,-62
10073,1,0,122,0,-122
10074,1,1,683,1894,1211
10075,1,1,128,1203,1075
10076,0,0,34,0,-34
10077,0,0,7,0,-7
10078,1,1,335,1210,875
10079,0,0,7,0,-7
10080,1,1,720,1617,897
10081,0,0,109,0,-109
10082,1,0,93,0,-93
10083,1,0,19,0,-19
10084,1,0,30,0,-30
10085,0,0,2,0,-2
10086,0,0,5,0,-5
10087,1,0,54,0,-54
10088,0,0,50,0,-50
10089,1,0,44,0,-44
10090,0,0,3,0,-3
10091,1,0,49,0,-49
10092,0,0,14,0,-14
10093,1,0,88,0,-88
10094,1,1,711,2266,1555
10095,1,1,125,2209,2084
10096,0,0,59,0,-59
10097,0,0,22,0,-22
10098,1,1,102,2962,2860
10099,0,0,7,0,-7
10100,0,0,60,0,-60
10101,0,0,95,0,-95
10102,0,0,15,0,-15
10103,0,0,30,0,-30
10104,1,0,2,0,-2
10105,0,0,38,0,-38
10106,0,0,2,0,-2
10107,0,0,123,0,-123
10108,1,1,722,1360,638
10109,1,0,126,0,-126
10110,0,0,11,0,-11
10111,1,0,123,0,-123
10112,1,1,340,1526,1186
10113,1,1,222,2274,2052
10114,1,0,65,0,-65
10115,1,0,125,0,-125
10116,1,1,81,1362,1281
10117,0,0,3,0,-3
10118,1,1,84,1611,1527
10119,0,0,5,0,-5
10120,1,0,33,0,-33
10121,1,0,14,0,-14
10122,1,1,135,2039,1904
10123,0,0,15,0,-15
10124,0,0,101,0,-101
10125,0,0,8,0,-8
10126,0,0,37,0,-37
10127,1,0,17,0,-17
10128,0,0,17,0,-17
10129,1,0,23,0,-23
10130,1,1,263,1278,1015
10131,1,1,729,1620,891
10132,1,1,544,1590,1046
10133,0,0,35,0,-35
10134,0,0,16,0,-16
10135,1,0,47,0,-47
10136,1,1,285,1418,1133
10137,1,0,11,0,-11
10138,1,1,39,1604,1565
10139,1,0,6,0,-6
10140,1,1,450,2410,1960
10141,1,0,11,0,-11
10142,0,0,53,0,-53
10143,0,0,14,0,-14
10144,1,1,78,2149,2071
10145,1,0,13,0,-13
10146,1,0,83,0,-83
10147,0,0,0,0,0
10148,1,1,362,1258,896
10149,1,0,110,0,-110
10150,1,1,825,1239,414
10151,0,0,6,0,-6
10152,1,0,14,0,-14
10153,0,0,4,0,-4
10154,0,0,72,0,-72
10155,1,0,191,0,-191
10156,0,0,76,0,-76
10157,1,1,504,1646,1142
10158,0,0,80,0,-80
10159,1,0,93,0,-93
10160,1,0,237,0,-237
10161,1,1,177,1383,1206
10162,0,0,116,0,-116
10163,1,1,423,1454,1031
10164,1,0,12,0,-12
10165,1,1,584,1234,650
10166,0,0,119,0,-119
10167,1,0,31,0,-31
10168,0,0,83,0,-83
10169,1,0,211,0,-211
10170,1,0,460,0,-460
10171,1,1,320,1585,1265
10172,1,1,245,1452,1207
10173,1,1,628,2083,1455
10174,1,0,57,0,-57
10175,0,0,74,0,-74
10176,0,0,2,0,-2
10177,1,1,304,1319,1015
10178,1,0,29,0,-29
10179,0,0,143,0,-143
10180,1,0,24,0,-24
10181,1,1,160,1264,1104
10182,0,0,63,0,-63
10183,0,0,4,0,-4
10184,1,0,8,0,-8
10185,0,0,0,0,0
10186,1,1,1716,1271,-445
10187,0,0,20,0,-20
10188,1,0,8,0,-8
10189,1,0,9,0,-9
10190,1,0,8,0,-8
10191,1,1,82,1229,1147
10192,1,0,47,0,-47
10193,1,0,19,0,-19
10194,0,0,61,0,-61
10195,1,1,567,1380,813
10196,1,1,733,1844,1111
10197,0,0,76,0,-76
10198,0,0,28,0,-28
10199,1,0,34,0,-34
10200,0,0,75,0,-75
10201,1,0,174,0,-174
10202,0,0,7,0,-7
10203,0,0,22,0,-22
10204,1,0,73,0,-73
10205,1,0,16,0,-16
10206,1,1,206,1625,1419
10207,1,0,3,0,-3
10208,0,0,76,0,-76
10209,0,0,25,0,-25
10210,1,1,657,1682,1025
10211,0,0,254,0,-254
10212,1,1,630,1384,754
10213,1,1,609,5206,4597
10214,0,0,18,0,-18
10215,0,0,116,0,-116
10216,0,0,23,0,-23
10217,1,1,344,1796,1452
10218,0,0,79,0,-79
10219,0,0,117,0,-117
10220,0,0,3,0,-3
10221,0,0,28,0,-28
10222,1,0,28,0,-28
10223,1,1,535,2169,1634
10224,1,1,224,1252,1028
10225,0,0,225,0,-225
10226,0,0,26,0,-26
10227,1,1,816,1395,579
10228,1,1,405,1290,885
10229,1,1,1060,1413,353
10230,1,0,6,0,-6
10231,0,0,112,0,-112
10232,1,0,51,0,-51
10233,1,0,29,0,-29
10234,0,0,49,0,-49
10235,1,1,418,1939,1521
10236,0,0,6,0,-6
10237,1,1,92,1332,1240
10238,1,0,1,0,-1
10239,0,0,110,0,-110
10240,1,0,22,0,-22
10241,0,0,33,0,-33
10242,1,1,876,1401,525
10243,0,0,0,0,0
10244,1,1,286,1525,1239
10245,1,1,485,1448,963
10246,0,0,43,0,-43
10247,0,0,157,0,-157
10248,1,1,821,1565,744
10249,1,1,67,1200,1133
10250,0,0,2,0,-2
10251,1,1,434,1506,1072
10252,1,1,1149,1318,169
10253,0,0,9,0,-9
10254,0,0,41,0,-41
10255,0,0,91,0,-91
10256,0,0,9,0,-9
10257,1,0,2,0,-2
10258,1,0,186,0,-186
10259,1,0,50,0,-50
10260,0,0,55,0,-55
10261,0,0,108,0,-108
10262,1,0,188,0,-188
10263,1,1,368,1494,1126
10264,1,1,1193,1243,50
10265,0,0,51,0,-51
10266,0,0,1,0,-1
10267,0,0,2,0,-2
10268,1,0,94,0,-94
10269,0,0,76,0,-76
10270,0,0,27,0,-27
10271,1,0,47,0,-47
10272,1,1,352,1780,1428
10273,1,0,196,0,-196
10274,1,1,481,1338,857
10275,1,0,71,0,-71
10276,1,0,52,0,-52
10277,1,1,312,1270,958
10278,0,0,84,0,-84
10279,1,1,128,1431,1303
10280,0,0,52,0,-52
10281,0,0,17,0,-17
10282,0,0,3,0,-3
10283,1,0,147,0,-147
10284,0,0,20,0,-20
10285,1,1,923,1914,991
10286,1,0,37,0,-37
10287,1,1,468,1473,1005
10288,1,0,115,0,-115
10289,1,0,70,0,-70
10290,0,0,26,0,-26
10291,1,1,157,1280,1123
10292,1,0,43,0,-43
10293,1,0,41,0,-41
10294,0,0,10,0,-10
10295,1,1,235,1214,979
10296,1,1,385,1347,962
10297,0,0,88,0,-88
10298,1,0,75,0,-75
10299,0,0,45,0,-45
10300,1,0,15,0,-15
10301,1,1,811,1733,922
10302,0,0,23,0,-23
10303,1,1,1405,2376,971
10304,1,1,93,1461,1368
10305,1,1,377,1279,902
10306,1,0,97,0,-97
10307,1,0,29,0,-29
10308,0,0,119,0,-119
10309,0,0,56,0,-56
10310,0,0,15,0,-15
10311,1,0,25,0,-25
10312,0,0,8,0,-8
10313,1,1,51,1303,1252
10314,1,0,46,0,-46
10315,0,0,1,0,-1
10316,1,1,130,2750,2620
10317,0,0,14,0,-14
10318,1,1,191,1268,1077
10319,1,0,8,0,-8
10320,1,0,49,0,-49
10321,1,0,122,0,-122
10322,0,0,75,0,-75
10323,1,0,5,0,-5
10324,1,0,38,0,-38
10325,0,0,2,0,-2
10326,1,1,499,1440,941
10327,0,0,83,0,-83
10328,0,0,107,0,-107
10329,0,0,15,0,-15
10330,1,0,91,0,-91
10331,0,0,23,0,-23
10332,1,1,246,1327,1081
10333,0,0,25,0,-25
10334,0,0,100,0,-100
10335,0,0,6,0,-6
10336,1,1,923,1221,298
10337,1,0,75,0,-75
10338,0,0,46,0,-46
10339,1,0,71,0,-71
10340,1,1,1440,1271,-169
10341,0,0,1,0,-1
10342,0,0,39,0,-39
10343,1,0,9,0,-9
10344,1,1,714,1985,1271
10345,1,0,2,0,-2
10346,1,1,842,1518,676
10347,1,0,114,0,-114
10348,1,1,2234,1737,-497
10349,1,1,246,2519,2273
10350,1,0,57,0,-57
10351,0,0,9,0,-9
10352,1,1,1166,4524,3358
10353,1,0,118,0,-118
10354,0,0,4,0,-4
10355,1,0,37,0,-37
10356,0,0,0,0,0
10357,0,0,2,0,-2
10358,1,0,24,0,-24
10359,0,0,41,0,-41
10360,1,0,15,0,-15
10361,1,0,55,0,-55
10362,0,0,54,0,-54
10363,1,0,3,0,-3
10364,1,0,8,0,-8
10365,1,0,46,0,-46
10366,1,0,171,0,-171
10367,1,0,3,0,-3
10368,1,0,98,0,-98
10369,1,0,69,0,-69
10370,1,0,23,0,-23
10371,1,0,53,0,-53
10372,0,0,95,0,-95
10373,1,0,133,0,-133
10374,0,0,83,0,-83
10375,0,0,42,0,-42
10376,0,0,42,0,-42
10377,1,1,428,1310,882
10378,0,0,27,0,-27
10379,0,0,113,0,-113
10380,1,1,48,1498,1450
10381,1,0,36,0,-36
10382,1,1,347,1625,1278
10383,0,0,17,0,-17
10384,1,1,290,1514,1224
10385,0,0,6,0,-6
10386,0,0,132,0,-132
10387,1,1,468,1867,1399
10388,0,0,15,0,-15
10389,1,0,86,0,-86
10390,1,1,1732,1390,-342
10391,1,1,54,2440,2386
10392,1,1,774,1242,468
10393,1,0,16,0,-16
10394,1,0,57,0,-57
10395,1,1,505,1655,1150
10396,1,1,445,1208,763
10397,0,0,69,0,-69
10398,0,0,15,0,-15
10399,1,0,57,0,-57
10400,1,1,496,1426,930
10401,1,1,220,1579,1359
10402,1,1,228,1678,1450
10403,0,0,74,0,-74
10404,1,0,6,0,-6
10405,1,0,35,0,-35
10406,1,0,3,0,-3
10407,1,0,74,0,-74
10408,0,0,17,0,-17
10409,1,0,39,0,-39
10410,1,0,1,0,-1
10411,0,0,6,0,-6
10412,1,1,148,1409,1261
10413,1,1,79,2006,1927
10414,1,0,17,0,-17
10415,1,1,907,1371,464
10416,1,0,101,0,-101
10417,0,0,39,0,-39
10418,1,1,394,1955,1561
10419,1,0,15,0,-15
10420,0,0,36,0,-36
10421,0,0,33,0,-33
10422,1,1,519,1308,789
10423,1,1,76,1380,1304
10424,1,1,1124,1574,450
10425,1,0,86,0,-86
10426,0,0,9,0,-9
10427,1,0,29,0,-29
10428,0,0,18,0,-18
10429,1,1,179,1703,1524
10430,1,0,9,0,-9
10431,1,1,210,1244,1034
10432,1,1,543,1325,782
10433,1,1,361,1607,1246
10434,1,1,190,1447,1257
10435,1,0,66,0,-66
10436,1,0,20,0,-20
10437,0,0,172,0,-172
10438,0,0,0,0,0
10439,1,0,1,0,-1
10440,1,1,1033,1262,229
10441,0,0,83,0,-83
10442,0,0,20,0,-20
10443,1,0,126,0,-126
10444,0,0,53,0,-53
10445,0,0,28,0,-28
10446,1,0,142,0,-142
10447,1,1,126,1350,1224
10448,0,0,73,0,-73
10449,1,0,43,0,-43
10450,1,0,21,0,-21
10451,1,0,0,0,0
10452,1,0,43,0,-43
10453,1,0,57,0,-57
10454,1,0,71,0,-71
10455,0,0,24,0,-24
10456,1,0,42,0,-42
10457,0,0,32,0,-32
10458,0,0,11,0,-11
10459,1,1,525,1864,1339
10460,0,0,62,0,-62
10461,1,0,25,0,-25
10462,0,0,89,0,-89
10463,1,0,117,0,-117
10464,1,0,113,0,-113
10465,0,0,44,0,-44
10466,0,0,6,0,-6
10467,1,0,3,0,-3
10468,0,0,34,0,-34
10469,1,0,93,0,-93
10470,1,0,16,0,-16
10471,0,0,42,0,-42
10472,1,1,134,2071,1937
10473,0,0,12,0,-12
10474,0,0,134,0,-134
10475,0,0,3,0,-3
10476,1,0,39,0,-39
10477,1,0,46,0,-46
10478,0,0,30,0,-30
10479,1,0,23,0,-23
10480,1,1,390,1574,1184
10481,0,0,1,0,-1
10482,0,0,12,0,-12
10483,0,0,9,0,-9
10484,1,0,58,0,-58
10485,0,0,63,0,-63
10486,0,0,18,0,-18
10487,1,1,923,1464,541
10488,1,1,175,1714,1539
10489,1,0,10,0,-10
10490,1,0,215,0,-215
10491,0,0,2,0,-2
10492,0,0,21,0,-21
10493,1,0,30,0,-30
10494,1,0,10,0,-10
10495,1,1,138,6946,6808
10496,0,0,144,0,-144
10497,0,0,1,0,-1
10498,1,0,3,0,-3
10499,0,0,18,0,-18
10500,0,0,4,0,-4
10501,0,0,57,0,-57
10502,0,0,18,0,-18
10503,1,0,1,0,-1
10504,1,1,1139,1618,479
10505,1,0,63,0,-63
10506,0,0,9,0,-9
10507,1,1,585,1380,795
10508,1,0,10,0,-10
10509,1,0,121,0,-121
10510,0,0,25,0,-25
10511,1,0,12,0,-12
10512,1,1,964,1274,310
10513,1,0,16,0,-16
10514,0,0,135,0,-135
10515,0,0,58,0,-58
10516,1,0,41,0,-41
10517,1,0,52,0,-52
10518,1,0,4,0,-4
10519,0,0,53,0,-53
10520,0,0,2,0,-2
10521,1,1,909,1566,657
10522,0,0,28,0,-28
10523,1,0,7,0,-7
10524,0,0,30,0,-30
10525,0,0,5,0,-5
10526,0,0,32,0,-32
10527,1,0,166,0,-166
10528,1,0,49,0,-49
10529,1,1,1240,1442,202
10530,0,0,12,0,-12
10531,1,1,1172,1462,290
10532,1,0,91,0,-91
10533,1,1,230,1261,1031
10534,1,1,1662,1258,-404
10535,0,0,54,0,-54
10536,1,1,209,1360,1151
10537,1,0,86,0,-86
10538,0,0,123,0,-123
10539,0,0,2,0,-2
10540,0,0,17,0,-17
10541,0,0,24,0,-24
10542,1,0,33,0,-33
10543,1,1,403,1209,806
10544,0,0,8,0,-8
10545,1,0,60,0,-60
10546,0,0,35,0,-35
10547,0,0,8,0,-8
10548,0,0,47,0,-47
10549,1,0,38,0,-38
10550,1,1,382,1224,842
10551,0,0,201,0,-201
10552,0,0,21,0,-21
10553,0,0,3,0,-3
10554,0,0,0,0,0
10555,1,1,265,2535,2270
10556,1,1,670,1507,837
10557,0,0,38,0,-38
10558,1,0,21,0,-21
10559,1,1,171,1323,1152
10560,0,0,53,0,-53
10561,1,1,119,1254,1135
10562,1,0,21,0,-21
10563,1,1,333,1309,976
10564,1,0,11,0,-11
10565,0,0,21,0,-21
10566,1,1,414,1290,876
10567,0,0,5,0,-5
10568,0,0,25,0,-25
10569,0,0,35,0,-35
10570,0,0,35,0,-35
10571,0,0,5,0,-5
10572,1,0,1,0,-1
10573,1,0,22,0,-22
10574,1,0,120,0,-120
10575,1,1,1069,1462,393
10576,0,0,22,0,-22
10577,0,0,73,0,-73
10578,0,0,13,0,-13
10579,1,0,26,0,-26
10580,1,0,167,0,-167
10581,0,0,152,0,-152
10582,0,0,49,0,-49
10583,0,0,45,0,-45
10584,1,0,88,0,-88
10585,1,1,329,1267,938
10586,0,0,75,0,-75
10587,1,1,632,1286,654
10588,0,0,23,0,-23
10589,0,0,27,0,-27
10590,1,1,689,1240,551
10591,1,1,152,3099,2947
10592,1,1,1145,1708,563
10593,1,0,53,0,-53
10594,0,0,108,0,-108
10595,0,0,23,0,-23
10596,0,0,10,0,-10
10597,0,0,7,0,-7
10598,1,0,61,0,-61
10599,1,1,99,1739,1640
10600,0,0,34,0,-34
10601,1,1,194,1706,1512
10602,0,0,51,0,-51
10603,1,0,11,0,-11
10604,1,0,13,0,-13
10605,0,0,269,0,-269
10606,1,1,518,3493,2975
10607,1,1,220,1234,1014
10608,0,0,42,0,-42
10609,1,1,677,1424,747
10610,1,0,122,0,-122
10611,0,0,274,0,-274
10612,1,0,118,0,-118
10613,0,0,25,0,-25
10614,0,0,6,0,-6
10615,1,1,44,1321,1277
10616,0,0,35,0,-35
10617,1,1,311,1233,922
10618,1,0,13,0,-13
10619,1,0,5,0,-5
10620,0,0,42,0,-42
10621,1,1,227,1255,1028
10622,1,0,28,0,-28
10623,1,1,1578,2241,663
10624,0,0,80,0,-80
10625,1,0,3,0,-3
10626,1,1,391,1750,1359
10627,1,0,64,0,-64
10628,0,0,7,0,-7
10629,1,1,220,1379,1159
10630,0,0,83,0,-83
10631,0,0,58,0,-58
10632,0,0,72,0,-72
10633,1,0,77,0,-77
10634,1,0,52,0,-52
10635,1,1,201,1366,1165
10636,0,0,18,0,-18
10637,1,1,2421,1387,-1034
10638,0,0,84,0,-84
10639,0,0,31,0,-31
10640,1,1,228,1309,1081
10641,1,1,673,1287,614
10642,0,0,80,0,-80
10643,1,0,65,0,-65
10644,0,0,170,0,-170
10645,0,0,47,0,-47
10646,1,0,81,0,-81
10647,0,0,12,0,-12
10648,1,0,7,0,-7
10649,1,1,82,1553,1471
10650,0,0,3,0,-3
10651,1,1,1242,1608,366
10652,1,0,64,0,-64
10653,1,0,45,0,-45
10654,1,0,30,0,-30
10655,0,0,39,0,-39
10656,1,0,66,0,-66
10657,1,1,1597,1924,327
10658,0,0,70,0,-70
10659,0,0,4,0,-4
10660,1,1,260,1218,958
10661,1,0,115,0,-115
10662,1,1,136,1274,1138
10663,1,1,270,1323,1053
10664,1,0,74,0,-74
10665,1,0,53,0,-53
10666,1,0,53,0,-53
10667,1,0,5,0,-5
10668,0,0,65,0,-65
10669,1,1,290,1355,1065
10670,0,0,122,0,-122
10671,0,0,21,0,-21
10672,0,0,28,0,-28
10673,1,0,26,0,-26
10674,1,1,634,1568,934
10675,0,0,40,0,-40
10676,0,0,42,0,-42
10677,1,1,107,1340,1233
10678,1,0,26,0,-26
10679,1,1,1633,2283,650
10680,0,0,150,0,-150
10681,0,0,43,0,-43
10682,0,0,94,0,-94
10683,1,1,1696,1902,206
10684,1,0,13,0,-13
10685,0,0,9,0,-9
10686,1,1,164,1928,1764
10687,0,0,142,0,-142
10688,1,1,828,1400,572
10689,1,0,13,0,-13
10690,1,0,168,0,-168
10691,1,0,2,0,-2
10692,1,1,441,1652,1211
10693,1,0,7,0,-7
10694,0,0,13,0,-13
10695,0,0,55,0,-55
10696,1,0,48,0,-48
10697,1,0,39,0,-39
10698,1,1,147,1304,1157
10699,0,0,16,0,-16
10700,0,0,10,0,-10
10701,1,0,13,0,-13
10702,0,0,93,0,-93
10703,1,1,155,1679,1524
10704,0,0,14,0,-14
10705,1,0,8,0,-8
10706,0,0,47,0,-47
10707,1,1,240,1484,1244
10708,1,1,129,1301,1172
10709,1,0,51,0,-51
10710,0,0,40,0,-40
10711,1,1,181,2381,2200
10712,0,0,9,0,-9
10713,0,0,1,0,-1
10714,0,0,253,0,-253
10715,1,1,321,1301,980
10716,1,1,317,1544,1227
10717,0,0,69,0,-69
10718,1,0,130,0,-130
10719,1,0,126,0,-126
10720,0,0,35,0,-35
10721,1,0,108,0,-108
10722,1,0,39,0,-39
10723,1,1,495,1513,1018
10724,1,1,1182,2239,1057
10725,1,1,90,1510,1420
10726,1,1,783,1284,501
10727,0,0,28,0,-28
10728,0,0,34,0,-34
10729,1,0,5,0,-5
10730,0,0,12,0,-12
10731,1,1,241,1241,1000
10732,0,0,64,0,-64
10733,1,1,596,1856,1260
10734,1,0,64,0,-64
10735,0,0,3,0,-3
10736,0,0,20,0,-20
10737,1,1,845,1253,408
10738,1,1,1018,1335,317
10739,1,0,94,0,-94
10740,1,0,9,0,-9
10741,1,1,1504,1970,466
10742,1,0,14,0,-14
10743,1,1,176,1526,1350
10744,1,1,491,2102,1611
10745,1,0,24,0,-24
10746,1,0,38,0,-38
10747,0,0,67,0,-67
10748,1,1,1853,1345,-508
10749,1,0,39,0,-39
10750,1,0,39,0,-39
10751,0,0,3,0,-3
10752,0,0,6,0,-6
10753,1,0,131,0,-131
10754,1,1,270,2726,2456
10755,0,0,64,0,-64
10756,1,0,12,0,-12
10757,1,0,244,0,-244
10758,0,0,17,0,-17
10759,1,0,48,0,-48
10760,1,1,598,1222,624
10761,0,0,63,0,-63
10762,1,0,16,0,-16
10763,1,1,420,1786,1366
10764,1,0,70,0,-70
10765,1,1,468,1384,916
10766,0,0,71,0,-71
10767,0,0,117,0,-117
10768,0,0,47,0,-47
10769,0,0,4,0,-4
10770,1,1,754,1712,958
10771,0,0,51,0,-51
10772,1,1,411,1270,859
10773,1,0,76,0,-76
10774,0,0,20,0,-20
10775,1,1,42,2869,2827
10776,0,0,59,0,-59
10777,1,1,78,1213,1135
10778,1,0,14,0,-14
10779,0,0,123,0,-123
10780,0,0,156,0,-156
10781,0,0,88,0,-88
10782,1,1,823,1334,511
10783,1,0,138,0,-138
10784,0,0,0,0,0
10785,1,1,70,1340,1270
10786,0,0,80,0,-80
10787,0,0,7,0,-7
10788,0,0,71,0,-71
10789,0,0,13,0,-13
10790,0,0,21,0,-21
10791,0,0,26,0,-26
10792,1,0,14,0,-14
10793,1,1,548,2156,1608
10794,1,1,590,1759,1169
10795,1,0,7,0,-7
10796,1,1,370,1340,970
10797,0,0,43,0,-43
10798,1,1,473,1837,1364
10799,0,0,41,0,-41
10800,1,1,138,1225,1087
10801,0,0,34,0,-34
10802,0,0,6,0,-6
10803,1,0,1,0,-1
10804,0,0,88,0,-88
10805,0,0,2,0,-2
10806,0,0,93,0,-93
10807,1,0,42,0,-42
10808,0,0,32,0,-32
10809,0,0,40,0,-40
10810,1,0,85,0,-85
10811,0,0,3,0,-3
10812,1,1,949,1738,789
10813,1,0,7,0,-7
10814,0,0,107,0,-107
10815,0,0,28,0,-28
10816,1,0,87,0,-87
10817,0,0,14,0,-14
10818,1,1,193,1572,1379
10819,1,0,34,0,-34
10820,1,1,899,1775,876
10821,0,0,30,0,-30
10822,1,1,1368,1432,64
10823,1,1,739,1872,1133
10824,1,0,142,0,-142
10825,0,0,24,0,-24
10826,1,1,1811,1545,-266
10827,1,1,1563,1864,301
10828,1,0,4,0,-4
10829,1,0,16,0,-16
10830,1,1,211,1282,1071
10831,1,0,1,0,-1
10832,1,0,176,0,-176
10833,0,0,5,0,-5
10834,1,0,74,0,-74
10835,1,1,72,1459,1387
10836,1,0,124,0,-124
10837,1,0,136,0,-136
10838,1,0,60,0,-60
10839,0,0,122,0,-122
10840,0,0,110,0,-110
10841,1,0,57,0,-57
10842,1,0,52,0,-52
10843,1,0,10,0,-10
10844,1,1,12,1882,1870
10845,1,0,9,0,-9
10846,1,0,56,0,-56
10847,0,0,0,0,0
10848,1,0,1,0,-1
10849,0,0,24,0,-24
10850,1,1,127,2186,2059
10851,1,0,63,0,-63
10852,0,0,84,0,-84
10853,0,0,92,0,-92
10854,0,0,53,0,-53
10855,0,0,0,0,0
10856,1,1,979,1273,294
10857,1,1,249,1272,1023
10858,0,0,20,0,-20
10859,1,1,461,1603,1142
10860,1,1,348,2548,2200
10861,1,1,227,1322,1095
10862,1,1,780,1345,565
10863,1,1,343,1203,860
10864,1,1,155,1708,1553
10865,1,0,61,0,-61
10866,1,0,35,0,-35
10867,1,1,1408,1391,-17
10868,1,0,41,0,-41
10869,1,1,764,1257,493
10870,0,0,68,0,-68
10871,1,0,6,0,-6
10872,1,0,43,0,-43
10873,0,0,19,0,-19
10874,1,1,24,3287,3263
10875,1,0,27,0,-27
10876,0,0,52,0,-52
10877,1,0,37,0,-37
10878,0,0,168,0,-168
10879,1,1,236,1287,1051
10880,0,0,26,0,-26
10881,0,0,15,0,-15
10882,1,0,16,0,-16
10883,0,0,111,0,-111
10884,0,0,17,0,-17
10885,0,0,40,0,-40
10886,0,0,57,0,-57
10887,1,1,322,1682,1360
10888,1,0,0,0,0
10889,1,0,12,0,-12
10890,0,0,31,0,-31
10891,1,1,1412,1368,-44
10892,1,1,536,1415,879
10893,1,0,17,0,-17
10894,1,0,22,0,-22
10895,1,0,56,0,-56
10896,1,0,67,0,-67
10897,0,0,56,0,-56
10898,1,1,630,1335,705
10899,1,0,22,0,-22
10900,0,0,42,0,-42
10901,1,0,133,0,-133
10902,0,0,32,0,-32
10903,1,1,676,1520,844
10904,0,0,9,0,-9
10905,0,0,33,0,-33
10906,1,0,87,0,-87
10907,1,1,296,1562,1266
10908,1,0,22,0,-22
10909,1,0,101,0,-101
10910,0,0,95,0,-95
10911,1,0,78,0,-78
10912,1,1,1126,1872,746
10913,0,0,39,0,-39
10914,0,0,17,0,-17
10915,1,0,39,0,-39
10916,1,1,1189,1638,449
10917,1,0,10,0,-10
10918,0,0,117,0,-117
10919,0,0,14,0,-14
10920,0,0,79,0,-79
10921,0,0,41,0,-41
10922,1,1,128,1295,1167
10923,0,0,38,0,-38
10924,1,1,595,1204,609
10925,0,0,19,0,-19
10926,1,1,434,1616,1182
10927,1,1,867,1362,495
10928,0,0,45,0,-45
10929,1,0,78,0,-78
10930,1,1,1001,1271,270
10931,1,0,105,0,-105
10932,0,0,110,0,-110
10933,0,0,0,0,0
10934,1,0,24,0,-24
10935,1,0,68,0,-68
10936,1,0,52,0,-52
10937,0,0,13,0,-13
10938,1,1,383,1341,958
10939,0,0,13,0,-13
10940,1,1,711,1561,850
10941,1,0,66,0,-66
10942,1,0,97,0,-97
10943,0,0,29,0,-29
10944,1,1,255,1269,1014
10945,0,0,26,0,-26
10946,1,0,11,0,-11
10947,1,1,123,1347,1224
10948,1,1,2489,1564,-925
10949,1,0,28,0,-28
10950,1,1,169,1536,1367
10951,1,0,28,0,-28
10952,0,0,112,0,-112
10953,0,0,12,0,-12
10954,1,1,150,1706,1556
10955,1,0,5,0,-5
10956,0,0,55,0,-55
10957,0,0,87,0,-87
10958,0,0,88,0,-88
10959,1,0,12,0,-12
10960,1,0,149,0,-149
10961,1,1,778,1537,759
10962,1,1,379,1535,1156
10963,0,0,43,0,-43
10964,1,0,3,0,-3
10965,0,0,140,0,-140
10966,1,1,274,1758,1484
10967,1,1,1075,1727,652
10968,1,0,159,0,-159
10969,0,0,6,0,-6
10970,1,0,78,0,-78
10971,1,1,793,2112,1319
10972,1,0,76,0,-76
10973,1,0,19,0,-19
10974,1,1,113,1260,1147
10975,1,1,2059,1341,-718
10976,1,1,292,1274,982
10977,1,1,453,1212,759
10978,1,1,2642,1762,-880
10979,0,0,9,0,-9
10980,1,1,521,1323,802
10981,1,0,27,0,-27
10982,0,0,26,0,-26
10983,1,1,443,1993,1550
10984,1,1,713,1929,1216
10985,0,0,11,0,-11
10986,1,1,1932,1560,-372
10987,1,1,82,1796,1714
10988,0,0,52,0,-52
10989,0,0,67,0,-67
10990,0,0,77,0,-77
10991,1,0,35,0,-35
10992,1,1,795,1967,1172
10993,1,0,68,0,-68
10994,1,0,8,0,-8
10995,1,1,821,1352,531
10996,0,0,171,0,-171
10997,0,0,97,0,-97
10998,1,1,345,1917,1572
10999,0,0,18,0,-18
11000,0,0,67,0,-67
11001,1,1,618,1251,633
11002,0,0,31,0,-31
11003,1,0,53,0,-53
11004,0,0,4,0,-4
11005,0,0,135,0,-135
11006,1,1,1484,1532,48
11007,0,0,48,0,-48
11008,1,0,0,0,0
11009,0,0,31,0,-31
11010,1,0,15,0,-15
11011,1,0,1,0,-1
11012,1,0,69,0,-69
11013,0,0,86,0,-86
11014,1,0,40,0,-40
11015,1,0,147,0,-147
11016,1,0,40,0,-40
11017,1,0,27,0,-27
11018,0,0,32,0,-32
11019,1,1,796,1304,508
11020,0,0,10,0,-10
11021,1,1,934,1397,463
11022,1,0,0,0,0
11023,0,0,28,0,-28
11024,0,0,49,0,-49
11025,0,0,8,0,-8
11026,1,1,686,1383,697
11027,1,0,9,0,-9
11028,1,0,33,0,-33
11029,0,0,71,0,-71
11030,1,0,14,0,-14
11031,0,0,70,0,-70
11032,1,0,2,0,-2
11033,1,1,80,1348,1268
11034,1,1,426,1258,832
11035,1,1,762,1458,696
11036,1,1,379,1300,921
11037,1,1,221,1716,1495
11038,1,0,28,0,-28
11039,0,0,145,0,-145
11040,1,1,76,1536,1460
11041,1,0,42,0,-42
11042,0,0,103,0,-103
11043,1,0,22,0,-22
11044,0,0,4,0,-4
11045,0,0,19,0,-19
11046,1,0,43,0,-43
11047,1,0,38,0,-38
11048,0,0,31,0,-31
11049,0,0,6,0,-6
11050,0,0,0,0,0
11051,1,0,29,0,-29
11052,0,0,57,0,-57
11053,1,1,625,1456,831
11054,0,0,52,0,-52
11055,0,0,1,0,-1
11056,0,0,14,0,-14
11057,0,0,120,0,-120
11058,1,1,566,1732,1166
11059,1,1,58,1328,1270
11060,0,0,118,0,-118
11061,1,1,176,2009,1833
11062,0,0,130,0,-130
11063,0,0,6,0,-6
11064,1,0,42,0,-42
11065,0,0,247,0,-247
11066,1,1,665,1647,982
11067,1,0,34,0,-34
11068,1,1,759,1528,769
11069,1,1,264,1258,994
11070,1,1,2723,1980,-743
11071,1,0,99,0,-99
11072,0,0,107,0,-107
11073,1,1,254,1420,1166
11074,1,1,129,1313,1184
11075,1,1,226,1349,1123
11076,0,0,18,0,-18
11077,1,1,5,1214,1209
11078,1,0,215,0,-215
11079,1,0,108,0,-108
11080,0,0,134,0,-134
11081,1,1,851,1524,673
11082,0,0,68,0,-68
11083,1,1,596,1496,900
11084,0,0,50,0,-50
11085,1,1,371,1801,1430
11086,0,0,37,0,-37
11087,1,0,20,0,-20
11088,1,1,719,1283,564
11089,0,0,11,0,-11
11090,1,0,79,0,-79
11091,1,1,337,1914,1577
11092,1,0,151,0,-151
11093,1,1,448,1270,822
11094,1,0,19,0,-19
11095,1,1,1802,2062,260
11096,0,0,94,0,-94
11097,1,0,53,0,-53
11098,1,1,127,1253,1126
11099,0,0,24,0,-24
11100,1,0,25,0,-25
11101,0,0,46,0,-46
11102,1,0,73,0,-73
11103,1,0,49,0,-49
11104,1,1,102,1220,1118
11105,1,0,32,0,-32
11106,1,0,18,0,-18
11107,0,0,77,0,-77
11108,1,0,16,0,-16
11109,1,1,588,1405,817
11110,0,0,133,0,-133
11111,1,0,71,0,-71
11112,1,1,223,1200,977
11113,1,0,102,0,-102
11114,1,1,1236,2111,875
11115,1,0,69,0,-69
11116,1,0,41,0,-41
11117,1,1,153,1537,1384
11118,0,0,16,0,-16
11119,1,1,27,1418,1391
11120,0,0,48,0,-48
11121,0,0,105,0,-105
11122,1,1,214,1380,1166
11123,1,0,57,0,-57
11124,0,0,27,0,-27
11125,1,0,3,0,-3
11126,1,0,73,0,-73
11127,1,1,535,1497,962
11128,0,0,5,0,-5
11129,0,0,247,0,-247
11130,0,0,259,0,-259
11131,1,1,34,1369,1335
11132,0,0,4,0,-4
11133,1,1,244,1208,964
11134,1,1,918,1993,1075
11135,0,0,169,0,-169
11136,1,1,174,1836,1662
11137,0,0,25,0,-25
11138,0,0,12,0,-12
11139,1,0,21,0,-21
11140,1,0,37,0,-37
11141,1,0,45,0,-45
11142,1,1,779,1332,553
11143,1,0,9,0,-9
11144,0,0,39,0,-39
11145,0,0,70,0,-70
11146,1,1,814,1411,597
11147,0,0,14,0,-14
11148,1,1,599,1383,784
11149,1,0,4,0,-4
11150,0,0,30,0,-30
11151,1,1,158,1252,1094
11152,0,0,36,0,-36
11153,0,0,30,0,-30
11154,0,0,58,0,-58
11155,1,1,638,1211,573
11156,1,1,63,1344,1281
11157,1,0,9,0,-9
11158,0,0,29,0,-29
11159,0,0,6,0,-6
11160,1,1,227,1262,1035
11161,1,1,530,1410,880
11162,0,0,44,0,-44
11163,1,0,39,0,-39
11164,0,0,54,0,-54
11165,1,1,388,1626,1238
11166,0,0,0,0,0
11167,0,0,51,0,-51
11168,0,0,14,0,-14
11169,1,0,29,0,-29
11170,1,0,29,0,-29
11171,1,0,39,0,-39
11172,0,0,51,0,-51
11173,0,0,65,0,-65
11174,1,1,195,1261,1066
11175,0,0,41,0,-41
11176,0,0,9,0,-9
11177,1,1,564,1528,964
11178,1,0,14,0,-14
11179,0,0,135,0,-135
11180,1,0,26,0,-26
11181,0,0,118,0,-118
11182,0,0,13,0,-13
11183,1,0,17,0,-17
11184,1,0,7,0,-7
11185,0,0,86,0,-86
11186,1,1,538,1259,721
11187,0,0,22,0,-22
11188,1,1,475,1668,1193
11189,0,0,26,0,-26
11190,1,0,3,0,-3
11191,0,0,22,0,-22
11192,0,0,24,0,-24
11193,0,0,39,0,-39
11194,0,0,85,0,-85
11195,1,0,32,0,-32
11196,1,0,22,0,-22
11197,1,1,412,1456,1044
11198,0,0,67,0,-67
11199,0,0,17,0,-17
11200,0,0,27,0,-27
11201,1,0,134,0,-134
11202,0,0,21,0,-21
11203,1,0,9,0,-9
11204,0,0,74,0,-74
11205,1,0,117,0,-117
11206,1,0,74,0,-74
11207,1,0,13,0,-13
11208,1,0,9,0,-9
11209,1,0,44,0,-44
11210,0,0,50,0,-50
11211,0,0,20,0,-20
11212,1,1,336,1352,1016
11213,1,1,239,1531,1292
11214,0,0,2,0,-2
11215,1,0,35,0,-35
11216,1,0,12,0,-12
11217,0,0,7,0,-7
11218,1,1,2553,1210,-1343
11219,0,0,14,0,-14
11220,1,0,21,0,-21
11221,1,1,101,2444,2343
11222,0,0,126,0,-126
11223,1,1,662,2092,1430
11224,1,1,136,1250,1114
11225,1,1,36,1258,1222
11226,1,1,211,1471,1260
11227,1,1,118,1722,1604
11228,0,0,22,0,-22
11229,0,0,33,0,-33
11230,1,1,214,1452,1238
11231,1,1,185,1610,1425
11232,0,0,1,0,-1
11233,0,0,19,0,-19
11234,1,1,160,1532,1372
11235,1,1,169,1416,1247
11236,1,0,18,0,-18
11237,0,0,16,0,-16
11238,0,0,96,0,-96
11239,1,1,123,1918,1795
11240,0,0,14,0,-14
11241,1,0,58,0,-58
11242,0,0,10,0,-10
11243,1,0,104,0,-104
11244,1,1,158,1950,1792
11245,1,1,1208,1280,72
11246,0,0,73,0,-73
11247,0,0,22,0,-22
11248,1,1,87,2941,2854
11249,1,1,269,1887,1618
11250,1,1,253,1742,1489
11251,1,1,249,3010,2761
11252,0,0,112,0,-112
11253,1,0,43,0,-43
11254,1,1,609,1561,952
11255,1,1,371,2035,1664
11256,1,0,13,0,-13
11257,1,1,1568,1288,-280
11258,1,0,101,0,-101
11259,0,0,63,0,-63
11260,0,0,76,0,-76
11261,1,0,13,0,-13
11262,0,0,69,0,-69
11263,0,0,19,0,-19
11264,0,0,85,0,-85
11265,1,1,499,1297,798
11266,1,1,1014,1250,236
11267,1,1,141,1436,1295
11268,0,0,15,0,-15
11269,1,1,224,1393,1169
11270,1,0,1,0,-1
11271,0,0,26,0,-26
11272,0,0,29,0,-29
11273,1,1,385,1500,1115
11274,0,0,4,0,-4
11275,1,0,63,0,-63
11276,1,1,1132,1861,729
11277,1,1,732,1249,517
11278,1,1,1072,1266,194
11279,1,1,1211,2080,869
11280,0,0,18,0,-18
11281,1,0,2,0,-2
11282,0,0,53,0,-53
11283,0,0,21,0,-21
11284,0,0,26,0,-26
11285,1,1,942,1377,435
11286,0,0,25,0,-25
11287,0,0,10,0,-10
11288,0,0,201,0,-201
11289,1,0,21,0,-21
11290,0,0,27,0,-27
11291,0,0,164,0,-164
11292,0,0,36,0,-36
11293,1,0,94,0,-94
11294,1,1,351,1699,1348
11295,0,0,186,0,-186
11296,1,0,76,0,-76
11297,0,0,45,0,-45
11298,1,0,11,0,-11
11299,0,0,60,0,-60
11300,1,0,13,0,-13
11301,1,1,515,1776,1261
11302,1,1,405,1497,1092
11303,1,1,925,1481,556
11304,1,0,9,0,-9
11305,1,1,58,1241,1183
11306,0,0,37,0,-37
11307,0,0,17,0,-17
11308,1,0,4,0,-4
11309,1,1,309,1602,1293
11310,0,0,33,0,-33
11311,1,1,992,1473,481
11312,1,0,115,0,-115
11313,1,0,111,0,-111
11314,0,0,15,0,-15
11315,1,0,2,0,-2
11316,0,0,24,0,-24
11317,1,1,359,1290,931
11318,0,0,11,0,-11
11319,1,0,65,0,-65
11320,0,0,12,0,-12
11321,1,0,76,0,-76
11322,1,0,4,0,-4
11323,1,1,201,1429,1228
11324,0,0,15,0,-15
11325,1,1,1983,1449,-534
11326,0,0,61,0,-61
11327,1,0,56,0,-56
11328,1,0,20,0,-20
11329,1,0,97,0,-97
11330,0,0,57,0,-57
11331,1,0,103,0,-103
11332,0,0,8,0,-8
11333,1,0,38,0,-38
11334,0,0,64,0,-64
11335,0,0,173,0,-173
11336,1,1,334,1321,987
11337,1,1,113,1334,1221
11338,0,0,44,0,-44
11339,0,0,51,0,-51
11340,0,0,101,0,-101
11341,0,0,23,0,-23
11342,1,1,344,1894,1550
11343,0,0,90,0,-90
11344,1,0,238,0,-238
11345,1,0,8,0,-8
11346,1,1,402,1654,1252
11347,1,0,37,0,-37
11348,1,1,276,1254,978
11349,1,0,97,0,-97
11350,1,1,304,1517,1213
11351,0,0,4,0,-4
11352,0,0,78,0,-78
11353,0,0,10,0,-10
11354,0,0,81,0,-81
11355,1,1,316,1310,994
11356,1,1,428,1727,1299
11357,1,1,213,1455,1242
11358,0,0,58,0,-58
11359,1,1,603,1609,1006
11360,0,0,49,0,-49
11361,1,1,299,1539,1240
11362,1,0,47,0,-47
11363,0,0,71,0,-71
11364,1,0,48,0,-48
11365,1,0,47,0,-47
11366,0,0,19,0,-19
11367,1,0,33,0,-33
11368,1,0,147,0,-147
11369,0,0,84,0,-84
11370,0,0,125,0,-125
11371,1,0,33,0,-33
11372,1,1,29,1365,1336
11373,1,0,42,0,-42
11374,1,1,857,1337,480
11375,1,0,71,0,-71
11376,1,1,979,1202,223
11377,0,0,26,0,-26
11378,1,1,443,1401,958
11379,1,0,75,0,-75
11380,1,1,418,2370,1952
11381,1,0,28,0,-28
11382,0,0,1,0,-1
11383,1,1,340,1261,921
11384,1,0,103,0,-103
11385,1,0,3,0,-3
11386,1,0,188,0,-188
11387,1,0,23,0,-23
11388,1,0,18,0,-18
11389,1,1,364,1263,899
11390,0,0,21,0,-21
11391,1,0,103,0,-103
11392,1,1,358,2156,1798
11393,0,0,12,0,-12
11394,1,1,949,1726,777
11395,1,0,43,0,-43
11396,1,1,332,1397,1065
11397,0,0,5,0,-5
11398,1,1,42,1441,1399
11399,0,0,107,0,-107
11400,1,1,821,1272,451
11401,0,0,129,0,-129
11402,1,1,1728,1229,-499
11403,0,0,31,0,-31
11404,0,0,30,0,-30
11405,0,0,29,0,-29
11406,0,0,47,0,-47
11407,1,1,325,1370,1045
11408,0,0,79,0,-79
11409,0,0,11,0,-11
11410,0,0,8,0,-8
11411,1,0,28,0,-28
11412,0,0,58,0,-58
11413,1,0,9,0,-9
11414,1,0,38,0,-38
11415,0,0,52,0,-52
11416,0,0,117,0,-117
11417,0,0,26,0,-26
11418,1,1,437,1743,1306
11419,1,1,952,1207,255
11420,0,0,63,0,-63
11421,0,0,17,0,-17
11422,0,0,10,0,-10
11423,1,1,40,2057,2017
11424,1,0,4,0,-4
11425,0,0,84,0,-84
11426,0,0,145,0,-145
11427,0,0,3,0,-3
11428,1,0,50,0,-50
11429,1,1,1467,1691,224
11430,0,0,20,0,-20
11431,0,0,87,0,-87
11432,1,0,15,0,-15
11433,0,0,5,0,-5
11434,1,0,20,0,-20
11435,1,0,28,0,-28
11436,0,0,72,0,-72
11437,1,0,86,0,-86
11438,0,0,7,0,-7
11439,1,1,171,1211,1040
11440,0,0,8,0,-8
11441,0,0,35,0,-35
11442,1,1,174,1489,1315
11443,0,0,231,0,-231
11444,1,0,14,0,-14
11445,0,0,13,0,-13
11446,1,0,53,0,-53
11447,1,1,264,1354,1090
11448,0,0,7,0,-7
11449,0,0,20,0,-20
11450,1,1,1360,1277,-83
11451,1,0,11,0,-11
11452,1,1,559,1386,827
11453,1,1,87,1643,1556
11454,1,1,208,1311,1103
11455,1,1,51,2520,2469
11456,1,1,187,1423,1236
11457,1,0,87,0,-87
11458,1,1,285,1871,1586
11459,1,0,17,0,-17
11460,1,1,983,1288,305
11461,1,0,111,0,-111
11462,1,1,392,4769,4377
11463,1,1,1106,1816,710
11464,1,1,618,1424,806
11465,0,0,2,0,-2
11466,0,0,54,0,-54
11467,1,0,134,0,-134
11468,0,0,82,0,-82
11469,0,0,5,0,-5
11470,1,0,1,0,-1
11471,0,0,101,0,-101
11472,0,0,51,0,-51
11473,1,1,2669,1431,-1238
11474,1,0,22,0,-22
11475,0,0,20,0,-20
11476,1,1,128,1313,1185
11477,1,0,65,0,-65
11478,0,0,47,0,-47
11479,0,0,14,0,-14
11480,1,0,83,0,-83
11481,0,0,49,0,-49
11482,1,1,115,1859,1744
11483,0,0,4,0,-4
11484,1,1,967,1376,409
11485,0,0,52,0,-52
11486,1,1,425,1561,1136
11487,0,0,9,0,-9
11488,0,0,7,0,-7
11489,1,1,369,1209,840
11490,1,0,47,0,-47
11491,1,0,3,0,-3
11492,1,0,20,0,-20
11493,1,0,4,0,-4
11494,1,0,12,0,-12
11495,0,0,150,0,-150
11496,0,0,8,0,-8
11497,0,0,130,0,-130
11498,0,0,61,0,-61
11499,1,0,39,0,-39
11500,1,0,74,0,-74
11501,0,0,18,0,-18
11502,0,0,14,0,-14
11503,0,0,17,0,-17
11504,1,0,71,0,-71
11505,1,0,95,0,-95
11506,0,0,96,0,-96
11507,1,0,55,0,-55
11508,1,0,27,0,-27
11509,0,0,36,0,-36
11510,0,0,111,0,-111
11511,0,0,33,0,-33
11512,1,0,85,0,-85
11513,1,1,56,2068,2012
11514,0,0,48,0,-48
11515,0,0,7,0,-7
11516,0,0,51,0,-51
11517,1,0,142,0,-142
11518,1,0,87,0,-87
11519,1,1,228,1272,1044
11520,1,0,167,0,-167
11521,0,0,140,0,-140
11522,0,0,70,0,-70
11523,1,1,247,1839,1592
11524,1,1,647,2581,1934
11525,0,0,33,0,-33
11526,1,0,21,0,-21
11527,1,0,51,0,-51
11528,1,0,99,0,-99
11529,1,1,302,1489,1187
11530,1,1,777,1457,680
11531,0,0,35,0,-35
11532,0,0,26,0,-26
11533,1,1,949,1207,258
11534,1,0,217,0,-217
11535,1,1,728,1824,1096
11536,1,1,239,2118,1879
11537,0,0,33,0,-33
11538,1,1,152,1703,1551
11539,1,1,288,1445,1157
11540,1,0,49,0,-49
11541,1,0,102,0,-102
11542,0,0,4,0,-4
11543,1,1,253,1281,1028
11544,1,0,4,0,-4
11545,1,1,187,1963,1776
11546,1,1,1615,2418,803
11547,1,1,200,1276,1076
11548,0,0,68,0,-68
11549,0,0,39,0,-39
11550,0,0,89,0,-89
11551,1,0,23,0,-23
11552,1,1,147,1226,1079
11553,1,1,149,1203,1054
11554,0,0,5,0,-5
11555,1,1,282,1663,1381
11556,0,0,3,0,-3
11557,0,0,19,0,-19
11558,0,0,29,0,-29
11559,1,0,6,0,-6
11560,1,0,116,0,-116
11561,0,0,19,0,-19
11562,0,0,60,0,-60
11563,1,1,192,1782,1590
11564,1,1,192,1229,1037
11565,1,1,2539,1608,-931
11566,0,0,81,0,-81
11567,1,0,3,0,-3
11568,1,0,185,0,-185
11569,0,0,52,0,-52
11570,1,1,546,1307,761
11571,1,0,30,0,-30
11572,1,1,65,1541,1476
11573,0,0,55,0,-55
11574,0,0,3,0,-3
11575,0,0,20,0,-20
11576,1,0,56,0,-56
11577,0,0,88,0,-88
11578,0,0,58,0,-58
11579,0,0,29,0,-29
11580,0,0,21,0,-21
11581,1,0,6,0,-6
11582,0,0,4,0,-4
11583,1,1,299,2334,2035
11584,1,1,2726,1491,-1235
11585,0,0,44,0,-44
11586,0,0,23,0,-23
11587,1,0,2,0,-2
11588,1,0,94,0,-94
11589,1,1,249,1430,1181
11590,0,0,96,0,-96
11591,0,0,89,0,-89
11592,1,1,272,2027,1755
11593,0,0,36,0,-36
11594,1,0,25,0,-25
11595,1,0,16,0,-16
11596,1,0,10,0,-10
11597,0,0,12,0,-12
11598,1,1,211,1757,1546
11599,1,0,107,0,-107
11600,1,1,206,1382,1176
11601,1,0,56,0,-56
11602,0,0,54,0,-54
11603,0,0,7,0,-7
11604,1,1,652,1279,627
11605,1,0,188,0,-188
11606,1,0,20,0,-20
11607,1,0,53,0,-53
11608,1,0,32,0,-32
11609,0,0,8,0,-8
11610,1,1,24,1287,1263
11611,1,0,14,0,-14
11612,0,0,109,0,-109
11613,0,0,54,0,-54
11614,1,1,770,1463,693
11615,1,0,20,0,-20
11616,1,0,4,0,-4
11617,1,1,734,1673,939
11618,1,0,24,0,-24
11619,1,1,691,1324,633
11620,1,1,917,1462,545
11621,1,1,790,1536,746
11622,1,1,479,1242,763
11623,0,0,66,0,-66
11624,1,1,1146,1227,81
11625,0,0,13,0,-13
11626,0,0,87,0,-87
11627,0,0,59,0,-59
11628,0,0,37,0,-37
11629,1,0,19,0,-19
11630,1,1,396,1335,939
11631,0,0,63,0,-63
11632,1,0,73,0,-73
11633,1,1,312,1566,1254
11634,1,1,851,1645,794
11635,1,0,33,0,-33
11636,0,0,132,0,-132
11637,1,0,199,0,-199
11638,0,0,31,0,-31
11639,0,0,35,0,-35
11640,0,0,33,0,-33
11641,1,0,25,0,-25
11642,1,1,1858,1324,-534
11643,1,1,447,1548,1101
11644,1,0,52,0,-52
11645,0,0,73,0,-73
11646,1,0,7,0,-7
11647,0,0,44,0,-44
11648,1,1,1190,1910,720
11649,1,0,6,0,-6
11650,1,1,60,2942,2882
11651,0,0,31,0,-31
11652,1,1,59,1260,1201
11653,0,0,38,0,-38
11654,0,0,28,0,-28
11655,1,1,346,1557,1211
11656,1,1,401,1227,826
11657,1,0,113,0,-113
11658,0,0,6,0,-6
11659,1,0,40,0,-40
11660,1,1,28,1474,1446
11661,1,0,30,0,-30
11662,0,0,97,0,-97
11663,1,0,59,0,-59
11664,1,1,181,1228,1047
11665,0,0,6,0,-6
11666,1,1,494,1219,725
11667,0,0,39,0,-39
11668,1,0,36,0,-36
11669,0,0,14,0,-14
11670,1,0,21,0,-21
11671,0,0,56,0,-56
11672,0,0,41,0,-41
11673,1,0,62,0,-62
11674,1,1,934,1476,542
11675,1,0,69,0,-69
11676,1,1,865,1201,336
11677,0,0,31,0,-31
11678,0,0,82,0,-82
11679,0,0,33,0,-33
11680,1,0,10,0,-10
11681,1,0,49,0,-49
11682,0,0,19,0,-19
11683,1,0,29,0,-29
11684,1,1,126,1307,1181
11685,0,0,110,0,-110
11686,0,0,73,0,-73
11687,0,0,45,0,-45
11688,1,0,37,0,-37
11689,1,1,94,1392,1298
11690,1,0,10,0,-10
11691,1,1,358,1242,884
11692,0,0,18,0,-18
11693,1,0,31,0,-31
11694,1,1,470,3599,3129
11695,0,0,6,0,-6
11696,0,0,48,0,-48
11697,1,0,51,0,-51
11698,0,0,77,0,-77
11699,0,0,163,0,-163
11700,1,0,133,0,-133
11701,1,1,864,1607,743
11702,1,1,397,1552,1155
11703,0,0,76,0,-76
11704,1,0,9,0,-9
11705,1,0,30,0,-30
11706,0,0,173,0,-173
11707,1,1,237,1288,1051
11708,1,0,137,0,-137
11709,1,1,15,1366,1351
11710,0,0,8,0,-8
11711,0,0,25,0,-25
11712,0,0,26,0,-26
11713,1,0,25,0,-25
11714,1,0,24,0,-24
11715,0,0,42,0,-42
11716,0,0,22,0,-22
11717,1,1,102,1215,1113
11718,1,0,35,0,-35
11719,0,0,9,0,-9
11720,0,0,4,0,-4
11721,0,0,38,0,-38
11722,1,0,71,0,-71
11723,0,0,1,0,-1
11724,1,0,45,0,-45
11725,0,0,38,0,-38
11726,1,0,111,0,-111
11727,0,0,19,0,-19
11728,1,0,5,0,-5
11729,0,0,6,0,-6
11730,1,0,15,0,-15
11731,1,0,54,0,-54
11732,1,0,10,0,-10
11733,1,0,0,0,0
11734,1,1,656,1205,549
11735,1,0,13,0,-13
11736,0,0,70,0,-70
11737,0,0,2,0,-2
11738,1,1,755,1281,526
11739,1,1,179,1637,1458
11740,0,0,18,0,-18
11741,0,0,44,0,-44
11742,0,0,53,0,-53
11743,0,0,24,0,-24
11744,0,0,6,0,-6
11745,0,0,81,0,-81
11746,1,0,38,0,-38
11747,1,0,100,0,-100
11748,0,0,35,0,-35
11749,1,0,16,0,-16
11750,0,0,62,0,-62
11751,1,1,244,1291,1047
11752,0,0,40,0,-40
11753,1,1,206,3073,2867
11754,1,1,1079,1860,781
11755,0,0,75,0,-75
11756,1,0,26,0,-26
11757,0,0,21,0,-21
11758,1,0,27,0,-27
11759,1,1,872,1210,338
11760,0,0,79,0,-79
11761,1,1,845,1666,821
11762,1,1,336,1223,887
11763,1,0,6,0,-6
11764,0,0,63,0,-63
11765,1,0,62,0,-62
11766,0,0,59,0,-59
11767,1,0,134,0,-134
11768,0,0,28,0,-28
11769,0,0,180,0,-180
11770,1,0,58,0,-58
11771,1,0,53,0,-53
11772,1,0,14,0,-14
11773,0,0,24,0,-24
11774,1,1,504,1479,975
11775,0,0,77,0,-77
11776,0,0,122,0,-122
11777,0,0,65,0,-65
11778,0,0,114,0,-114
11779,1,0,22,0,-22
11780,0,0,3,0,-3
11781,0,0,4,0,-4
11782,1,0,14,0,-14
11783,0,0,41,0,-41
11784,0,0,15,0,-15
11785,1,1,165,2183,2018
11786,0,0,102,0,-102
11787,0,0,32,0,-32
11788,1,1,336,1480,1144
11789,1,0,17,0,-17
11790,1,1,1071,1496,425
11791,0,0,4,0,-4
11792,1,1,1586,1533,-53
11793,1,1,137,1333,1196
11794,1,0,4,0,-4
11795,1,0,66,0,-66
11796,1,0,41,0,-41
11797,0,0,2,0,-2
11798,0,0,16,0,-16
11799,0,0,4,0,-4
11800,0,0,180,0,-180
11801,0,0,21,0,-21
11802,1,1,1246,1396,150
11803,0,0,33,0,-33
11804,0,0,40,0,-40
11805,0,0,16,0,-16
11806,0,0,102,0,-102
11807,0,0,66,0,-66
11808,1,1,498,1381,883
11809,1,0,51,0,-51
11810,1,0,160,0,-160
11811,1,1,634,1263,629
11812,0,0,2,0,-2
11813,1,1,1424,1875,451
11814,0,0,48,0,-48
11815,1,0,38,0,-38
11816,0,0,0,0,0
11817,0,0,1,0,-1
11818,1,1,472,1386,914
11819,0,0,62,0,-62
11820,1,0,66,0,-66
11821,0,0,241,0,-241
11822,1,0,3,0,-3
11823,1,0,101,0,-101
11824,0,0,62,0,-62
11825,1,0,16,0,-16
11826,1,1,328,1254,926
11827,0,0,3,0,-3
11828,0,0,63,0,-63
11829,1,1,16,1887,1871
11830,0,0,9,0,-9
11831,1,1,42,1281,1239
11832,0,0,83,0,-83
11833,1,0,16,0,-16
11834,0,0,17,0,-17
11835,1,0,39,0,-39
11836,0,0,90,0,-90
11837,0,0,151,0,-151
11838,0,0,45,0,-45
11839,0,0,108,0,-108
11840,0,0,29,0,-29
11841,1,1,1179,1357,178
11842,1,0,125,0,-125
11843,0,0,33,0,-33
11844,0,0,12,0,-12
11845,1,1,408,1241,833
11846,1,0,86,0,-86
11847,1,0,84,0,-84
11848,1,0,24,0,-24
11849,1,1,703,2619,1916
11850,1,1,127,1475,1348
11851,1,1,225,1520,1295
11852,1,0,18,0,-18
11853,1,0,80,0,-80
11854,0,0,57,0,-57
11855,1,0,18,0,-18
11856,0,0,18,0,-18
11857,1,0,56,0,-56
11858,0,0,81,0,-81
11859,0,0,33,0,-33
11860,1,0,25,0,-25
11861,1,1,488,1715,1227
11862,1,0,63,0,-63
11863,0,0,4,0,-4
11864,1,0,115,0,-115
11865,1,1,156,1420,1264
11866,0,0,19,0,-19
11867,1,1,418,1262,844
11868,0,0,3,0,-3
11869,1,1,756,1208,452
11870,1,1,482,1300,818
11871,0,0,102,0,-102
11872,0,0,14,0,-14
11873,0,0,38,0,-38
11874,0,0,5,0,-5
11875,0,0,11,0,-11
11876,1,0,15,0,-15
11877,0,0,75,0,-75
11878,0,0,87,0,-87
11879,1,1,286,2553,2267
11880,0,0,36,0,-36
11881,0,0,82,0,-82
11882,0,0,24,0,-24
11883,1,1,280,2912,2632
11884,1,1,804,1253,449
11885,0,0,134,0,-134
11886,1,0,87,0,-87
11887,1,1,495,1202,707
11888,0,0,99,0,-99
11889,1,1,596,1530,934
11890,1,1,189,2480,2291
11891,1,1,472,1665,1193
11892,1,1,611,1747,1136
11893,1,1,607,1328,721
11894,0,0,13,0,-13
11895,1,1,1108,1237,129
11896,0,0,67,0,-67
11897,1,0,23,0,-23
11898,1,1,1332,1253,-79
11899,0,0,14,0,-14
11900,1,0,141,0,-141
11901,0,0,16,0,-16
11902,1,1,2099,1332,-767
11903,1,1,1087,1908,821
11904,0,0,24,0,-24
11905,0,0,17,0,-17
11906,1,1,1231,1942,711
11907,0,0,144,0,-144
11908,1,1,49,1286,1237
11909,1,1,343,1650,1307
11910,0,0,109,0,-109
11911,1,0,46,0,-46
11912,1,1,223,1363,1140
11913,1,0,58,0,-58
11914,0,0,5,0,-5
11915,1,0,18,0,-18
11916,0,0,7,0,-7
11917,1,1,598,1824,1226
11918,0,0,157,0,-157
11919,1,1,403,1434,1031
11920,1,0,9,0,-9
11921,0,0,6,0,-6
11922,0,0,38,0,-38
11923,1,1,1645,1430,-215
11924,0,0,10,0,-10
11925,0,0,103,0,-103
11926,1,0,17,0,-17
11927,0,0,12,0,-12
11928,0,0,26,0,-26
11929,0,0,64,0,-64
11930,0,0,7,0,-7
11931,0,0,21,0,-21
11932,1,0,9,0,-9
11933,1,1,123,1620,1497
11934,0,0,0,0,0
11935,0,0,127,0,-127
11936,1,0,34,0,-34
11937,1,1,366,1580,1214
11938,0,0,47,0,-47
11939,1,1,465,1404,939
11940,1,0,55,0,-55
11941,1,1,328,2166,1838
11942,1,0,36,0,-36
11943,1,1,748,1333,585
11944,1,1,1180,1725,545
11945,0,0,2,0,-2
11946,0,0,24,0,-24
11947,1,1,959,1691,732
11948,0,0,16,0,-16
11949,1,1,202,1860,1658
11950,0,0,23,0,-23
11951,1,1,1142,1929,787
11952,0,0,36,0,-36
11953,1,1,75,1656,1581
11954,1,1,83,1355,1272
11955,1,1,866,2347,1481
11956,1,1,1662,1289,-373
11957,0,0,5,0,-5
11958,0,0,171,0,-171
11959,1,0,11,0,-11
11960,1,1,131,1520,1389
11961,1,0,53,0,-53
11962,0,0,90,0,-90
11963,0,0,37,0,-37
11964,1,0,1,0,-1
11965,0,0,126,0,-126
11966,1,1,287,1371,1084
11967,0,0,71,0,-71
11968,1,0,1,0,-1
11969,1,0,101,0,-101
11970,1,0,16,0,-16
11971,1,0,57,0,-57
11972,1,0,134,0,-134
11973,0,0,0,0,0
11974,0,0,33,0,-33
11975,1,0,8,0,-8
11976,0,0,67,0,-67
11977,0,0,21,0,-21
11978,1,1,398,1253,855
11979,1,1,196,1417,1221
11980,1,1,445,1433,988
11981,1,0,25,0,-25
11982,1,0,20,0,-20
11983,1,0,2,0,-2
11984,0,0,46,0,-46
11985,0,0,48,0,-48
11986,1,0,9,0,-9
11987,1,0,14,0,-14
11988,1,0,118,0,-118
11989,1,0,108,0,-108
11990,1,0,55,0,-55
11991,0,0,66,0,-66
11992,1,1,471,2069,1598
11993,1,0,19,0,-19
11994,1,0,159,0,-159
11995,1,0,85,0,-85
11996,1,1,400,1212,812
11997,1,0,14,0,-14
11998,0,0,49,0,-49
11999,0,0,16,0,-16
12000,1,0,70,0,-70
12001,1,1,1076,1578,502
12002,1,0,95,0,-95
12003,0,0,48,0,-48
12004,0,0,43,0,-43
12005,1,1,379,1331,952
12006,1,1,111,1204,1093
12007,1,0,64,0,-64
12008,1,0,23,0,-23
12009,1,1,598,2244,1646
12010,1,1,90,1234,1144
12011,0,0,11,0,-11
12012,1,1,291,1536,1245
12013,1,0,11,0,-11
12014,1,1,104,1326,1222
12015,0,0,12,0,-12
12016,1,1,691,1210,519
12017,1,0,20,0,-20
12018,0,0,10,0,-10
12019,1,1,656,1901,1245
12020,0,0,180,0,-180
12021,1,1,1038,1784,746
12022,0,0,31,0,-31
12023,0,0,93,0,-93
12024,0,0,96,0,-96
12025,0,0,46,0,-46
12026,0,0,18,0,-18
12027,0,0,138,0,-138
12028,1,0,13,0,-13
12029,1,0,43,0,-43
12030,0,0,180,0,-180
12031,1,0,25,0,-25
12032,1,0,206,0,-206
12033,0,0,31,0,-31
12034,0,0,26,0,-26
12035,1,0,23,0,-23
12036,0,0,13,0,-13
12037,1,0,45,0,-45
12038,1,0,2,0,-2
12039,1,0,19,0,-19
12040,0,0,63,0,-63
12041,1,0,18,0,-18
12042,1,0,48,0,-48
12043,1,0,59,0,-59
12044,1,1,507,1729,1222
12045,1,0,1,0,-1
12046,1,0,13,0,-13
12047,0,0,32,0,-32
12048,0,0,35,0,-35
12049,1,1,320,1616,1296
12050,1,0,187,0,-187
12051,1,0,112,0,-112
12052,1,1,919,1318,399
12053,0,0,43,0,-43
12054,0,0,31,0,-31
12055,1,0,79,0,-79
12056,1,0,19,0,-19
12057,1,1,752,1321,569
12058,0,0,18,0,-18
12059,1,0,0,0,0
12060,0,0,87,0,-87
12061,1,1,267,1809,1542
12062,1,0,18,0,-18
12063,0,0,2,0,-2
12064,0,0,95,0,-95
12065,1,0,98,0,-98
12066,1,0,56,0,-56
12067,1,0,12,0,-12
12068,0,0,15,0,-15
12069,1,1,180,1242,1062
12070,1,1,475,2095,1620
12071,0,0,26,0,-26
12072,0,0,15,0,-15
12073,0,0,12,0,-12
12074,1,0,53,0,-53
12075,1,1,1400,1762,362
12076,0,0,69,0,-69
12077,1,0,10,0,-10
12078,1,1,653,1652,999
12079,1,1,459,1212,753
12080,0,0,170,0,-170
12081,1,1,965,1681,716
12082,0,0,16,0,-16
12083,1,0,34,0,-34
12084,0,0,74,0,-74
12085,1,1,284,2318,2034
12086,1,0,227,0,-227
12087,1,1,310,1467,1157
12088,1,0,12,0,-12
12089,1,1,298,1372,1074
12090,1,1,161,1625,1464
12091,1,1,1354,1257,-97
12092,1,0,108,0,-108
12093,0,0,9,0,-9
12094,1,0,1,0,-1
12095,1,0,17,0,-17
12096,1,0,16,0,-16
12097,0,0,49,0,-49
12098,1,0,128,0,-128
12099,1,0,76,0,-76
12100,1,0,1,0,-1
12101,1,1,166,1406,1240
12102,1,1,314,1405,1091
12103,1,1,199,1243,1044
12104,1,1,100,1412,1312
12105,1,1,117,2180,2063
12106,1,0,79,0,-79
12107,0,0,61,0,-61
12108,1,0,98,0,-98
12109,1,1,163,1330,1167
12110,1,0,38,0,-38
12111,0,0,50,0,-50
12112,0,0,16,0,-16
12113,1,1,138,1479,1341
12114,1,1,627,1270,643
12115,0,0,82,0,-82
12116,1,1,201,1316,1115
12117,1,0,9,0,-9
12118,0,0,44,0,-44
12119,1,0,3,0,-3
12120,1,1,501,2723,2222
12121,1,0,17,0,-17
12122,0,0,3,0,-3
12123,1,0,90,0,-90
12124,0,0,103,0,-103
12125,0,0,8,0,-8
12126,1,1,2154,1275,-879
12127,1,1,2205,1340,-865
12128,1,1,288,1448,1160
12129,0,0,26,0,-26
12130,1,1,424,1405,981
12131,1,1,138,1623,1485
12132,1,1,1817,1230,-587
12133,0,0,163,0,-163
12134,1,0,77,0,-77
12135,0,0,26,0,-26
12136,1,0,20,0,-20
12137,0,0,16,0,-16
12138,1,0,20,0,-20
12139,0,0,19,0,-19
12140,0,0,107,0,-107
12141,0,0,46,0,-46
12142,0,0,113,0,-113
12143,1,0,16,0,-16
12144,1,1,133,2742,2609
12145,1,1,439,1481,1042
12146,1,1,901,1680,779
12147,1,1,581,1431,850
12148,1,0,67,0,-67
12149,0,0,69,0,-69
12150,1,0,26,0,-26
12151,1,0,187,0,-187
12152,1,0,2,0,-2
12153,1,1,211,1479,1268
12154,1,1,342,2250,1908
12155,1,0,34,0,-34
12156,1,0,98,0,-98
12157,1,0,21,0,-21
12158,0,0,74,0,-74
12159,1,0,106,0,-106
12160,1,0,18,0,-18
12161,1,0,8,0,-8
12162,1,1,37,1299,1262
12163,1,0,6,0,-6
12164,1,0,7,0,-7
12165,1,0,10,0,-10
12166,1,0,4,0,-4
12167,1,0,40,0,-40
12168,1,0,178,0,-178
12169,1,0,35,0,-35
12170,0,0,24,0,-24
12171,1,1,961,1201,240
12172,0,0,8,0,-8
12173,0,0,3,0,-3
12174,0,0,21,0,-21
12175,1,0,1,0,-1
12176,0,0,13,0,-13
12177,1,0,31,0,-31
12178,1,0,13,0,-13
12179,1,0,76,0,-76
12180,1,1,194,1481,1287
12181,1,1,1345,1580,235
12182,1,1,91,1480,1389
12183,0,0,10,0,-10
12184,1,1,229,1943,1714
12185,1,0,61,0,-61
12186,1,1,455,1749,1294
12187,0,0,73,0,-73
12188,1,1,619,1353,734
12189,1,1,971,1310,339
12190,1,1,515,2555,2040
12191,0,0,44,0,-44
12192,0,0,54,0,-54
12193,1,0,37,0,-37
12194,1,1,943,1578,635
12195,1,0,52,0,-52
12196,0,0,16,0,-16
12197,1,1,300,1434,1134
12198,0,0,16,0,-16
12199,1,0,28,0,-28
12200,1,1,874,1259,385
12201,0,0,42,0,-42
12202,0,0,13,0,-13
12203,1,0,3,0,-3
12204,0,0,18,0,-18
12205,0,0,27,0,-27
12206,0,0,3,0,-3
12207,1,0,9,0,-9
12208,0,0,33,0,-33
12209,0,0,8,0,-8
12210,0,0,22,0,-22
12211,0,0,0,0,0
12212,0,0,62,0,-62
12213,1,1,586,2082,1496
12214,0,0,50,0,-50
12215,0,0,41,0,-41
12216,1,1,842,1308,466
12217,0,0,26,0,-26
12218,1,0,104,0,-104
12219,1,0,116,0,-116
12220,0,0,87,0,-87
12221,0,0,169,0,-169
12222,0,0,4,0,-4
12223,1,0,66,0,-66
12224,1,1,457,1281,824
12225,1,0,29,0,-29
12226,1,1,560,1236,676
12227,1,0,19,0,-19
12228,1,1,112,1733,1621
12229,0,0,25,0,-25
12230,1,1,195,1512,1317
12231,1,1,544,1507,963
12232,1,0,29,0,-29
12233,0,0,30,0,-30
12234,1,0,14,0,-14
12235,0,0,20,0,-20
12236,0,0,12,0,-12
12237,1,0,24,0,-24
12238,1,0,108,0,-108
12239,0,0,58,0,-58
12240,1,0,94,0,-94
12241,1,1,504,1299,795
12242,0,0,65,0,-65
12243,1,0,17,0,-17
12244,0,0,110,0,-110
12245,0,0,157,0,-157
12246,1,1,304,1333,1029
12247,0,0,12,0,-12
12248,1,1,596,1290,694
12249,1,0,95,0,-95
12250,1,1,298,1282,984
12251,0,0,30,0,-30
12252,1,1,709,1282,573
12253,1,1,457,1251,794
12254,1,1,738,1536,798
12255,1,1,573,1737,1164
12256,0,0,41,0,-41
12257,0,0,11,0,-11
12258,1,1,750,1531,781
12259,1,0,0,0,0
12260,0,0,82,0,-82
12261,1,0,27,0,-27
12262,1,1,838,1551,713
12263,1,0,125,0,-125
12264,1,0,57,0,-57
12265,0,0,191,0,-191
12266,0,0,119,0,-119
12267,0,0,127,0,-127
12268,0,0,1,0,-1
12269,0,0,45,0,-45
12270,1,0,29,0,-29
12271,1,0,4,0,-4
12272,0,0,22,0,-22
12273,0,0,59,0,-59
12274,1,0,107,0,-107
12275,1,0,25,0,-25
12276,1,1,387,1842,1455
12277,1,0,12,0,-12
12278,1,0,6,0,-6
12279,0,0,4,0,-4
12280,1,1,682,1807,1125
12281,1,0,85,0,-85
12282,1,1,107,1324,1217
12283,0,0,1,0,-1
12284,1,1,308,1335,1027
12285,0,0,65,0,-65
12286,1,0,94,0,-94
12287,1,1,122,1693,1571
12288,0,0,28,0,-28
12289,1,1,14,1258,1244
12290,1,1,751,1350,599
12291,1,1,394,1326,932
12292,0,0,40,0,-40
12293,0,0,105,0,-105
12294,1,0,12,0,-12
12295,0,0,59,0,-59
12296,1,1,109,1979,1870
12297,1,0,3,0,-3
12298,1,1,1583,1497,-86
12299,1,0,82,0,-82
12300,1,1,147,1338,1191
12301,1,0,26,0,-26
12302,1,0,2,0,-2
12303,1,1,229,1373,1144
12304,0,0,39,0,-39
12305,0,0,7,0,-7
12306,1,0,26,0,-26
12307,1,1,249,1554,1305
12308,1,1,598,2072,1474
12309,1,0,16,0,-16
12310,0,0,31,0,-31
12311,0,0,10,0,-10
12312,1,1,548,1704,1156
12313,0,0,14,0,-14
12314,1,1,185,1907,1722
12315,0,0,283,0,-283
12316,0,0,5,0,-5
12317,0,0,49,0,-49
12318,0,0,14,0,-14
12319,0,0,121,0,-121
12320,1,0,1,0,-1
12321,1,1,200,2270,2070
12322,0,0,20,0,-20
12323,1,0,2,0,-2
12324,0,0,112,0,-112
12325,0,0,7,0,-7
12326,1,0,6,0,-6
12327,1,1,431,2266,1835
12328,0,0,16,0,-16
12329,1,0,12,0,-12
12330,1,1,739,2175,1436
12331,1,0,3,0,-3
12332,1,0,91,0,-91
12333,1,0,147,0,-147
12334,0,0,137,0,-137
12335,0,0,14,0,-14
12336,1,1,525,1310,785
12337,1,1,749,1223,474
12338,0,0,79,0,-79
12339,1,1,282,1553,1271
12340,1,0,10,0,-10
12341,1,1,804,1236,432
12342,0,0,47,0,-47
12343,0,0,4,0,-4
12344,1,1,438,1316,878
12345,1,1,875,1630,755
12346,1,0,59,0,-59
12347,1,1,410,1232,822
12348,1,0,78,0,-78
12349,0,0,13,0,-13
12350,1,0,1,0,-1
12351,0,0,95,0,-95
12352,1,1,670,1475,805
12353,0,0,66,0,-66
12354,1,1,209,1227,1018
12355,1,0,21,0,-21
12356,1,0,5,0,-5
12357,1,0,16,0,-16
12358,1,1,546,1296,750
12359,1,1,156,1219,1063
12360,0,0,3,0,-3
12361,1,0,0,0,0
12362,0,0,39,0,-39
12363,1,0,51,0,-51
12364,0,0,30,0,-30
12365,0,0,26,0,-26
12366,1,0,38,0,-38
12367,1,0,58,0,-58
12368,1,1,16,1310,1294
12369,1,1,36,1915,1879
12370,1,0,46,0,-46
12371,0,0,16,0,-16
12372,1,0,60,0,-60
12373,0,0,58,0,-58
12374,1,1,86,1697,1611
12375,0,0,9,0,-9
12376,1,1,379,2059,1680
12377,1,1,134,1659,1525
12378,1,0,119,0,-119
12379,1,0,15,0,-15
12380,1,1,457,2589,2132
12381,0,0,126,0,-126
12382,0,0,14,0,-14
12383,1,1,473,1750,1277
12384,1,1,130,1226,1096
12385,0,0,35,0,-35
12386,1,1,286,1298,1012
12387,0,0,9,0,-9
12388,1,0,60,0,-60
12389,1,0,44,0,-44
12390,0,0,33,0,-33
12391,1,0,6,0,-6
12392,0,0,27,0,-27
12393,0,0,0,0,0
12394,1,1,1185,1754,569
12395,1,0,40,0,-40
12396,1,0,11,0,-11
12397,1,0,36,0,-36
12398,1,0,44,0,-44
12399,1,0,60,0,-60
12400,1,1,265,2315,2050
12401,0,0,16,0,-16
12402,1,1,1328,1282,-46
12403,1,0,28,0,-28
12404,0,0,125,0,-125
12405,1,0,33,0,-33
12406,0,0,68,0,-68
12407,1,1,2239,1364,-875
12408,0,0,119,0,-119
12409,1,0,37,0,-37
12410,1,0,10,0,-10
12411,0,0,70,0,-70
12412,0,0,9,0,-9
12413,1,0,37,0,-37
12414,0,0,55,0,-55
12415,0,0,61,0,-61
12416,0,0,29,0,-29
12417,0,0,5,0,-5
12418,1,0,17,0,-17
12419,0,0,46,0,-46
12420,0,0,0,0,0
12421,1,0,38,0,-38
12422,1,1,448,1227,779
12423,1,0,5,0,-5
12424,0,0,21,0,-21
12425,1,1,388,1479,1091
12426,1,0,92,0,-92
12427,0,0,315,0,-315
12428,1,1,2395,1209,-1186
12429,0,0,1,0,-1
12430,1,1,325,2083,1758
12431,0,0,38,0,-38
12432,1,0,74,0,-74
12433,0,0,8,0,-8
12434,0,0,2,0,-2
12435,1,0,74,0,-74
12436,1,1,2148,1229,-919
12437,0,0,20,0,-20
12438,1,1,337,1571,1234
12439,1,0,64,0,-64
12440,1,0,39,0,-39
12441,0,0,67,0,-67
12442,0,0,17,0,-17
12443,1,0,37,0,-37
12444,0,0,56,0,-56
12445,0,0,54,0,-54
12446,1,1,575,1988,1413
12447,1,1,356,3191,2835
12448,0,0,30,0,-30
12449,0,0,99,0,-99
12450,0,0,47,0,-47
12451,1,0,47,0,-47
12452,1,1,225,1477,1252
12453,1,0,124,0,-124
12454,1,0,30,0,-30
12455,1,1,552,1232,680
12456,1,0,22,0,-22
12457,1,1,1341,1294,-47
12458,1,1,240,1868,1628
12459,1,0,35,0,-35
12460,0,0,61,0,-61
12461,0,0,82,0,-82
12462,1,1,80,1531,1451
12463,1,1,383,1738,1355
12464,1,0,35,0,-35
12465,1,0,5,0,-5
12466,0,0,41,0,-41
12467,1,1,1469,1345,-124
12468,1,0,272,0,-272
12469,1,0,301,0,-301
12470,0,0,19,0,-19
12471,0,0,3,0,-3
12472,1,1,1766,1726,-40
12473,1,1,380,1364,984
12474,1,0,2,0,-2
12475,1,0,14,0,-14
12476,1,0,42,0,-42
12477,0,0,15,0,-15
12478,1,1,131,2056,1925
12479,1,0,60,0,-60
12480,0,0,163,0,-163
12481,0,0,52,0,-52
12482,0,0,51,0,-51
12483,1,0,39,0,-39
12484,0,0,41,0,-41
12485,1,1,367,1439,1072
12486,1,0,20,0,-20
12487,1,0,29,0,-29
12488,0,0,70,0,-70
12489,0,0,146,0,-146
12490,0,0,50,0,-50
12491,1,0,17,0,-17
12492,1,0,78,0,-78
12493,1,1,297,1404,1107
12494,0,0,38,0,-38
12495,1,1,556,1201,645
12496,0,0,19,0,-19
12497,0,0,186,0,-186
12498,1,1,645,1846,1201
12499,0,0,40,0,-40
12500,1,0,31,0,-31
12501,1,0,0,0,0
12502,1,1,269,1227,958
12503,1,1,129,1333,1204
12504,1,1,817,2077,1260
12505,1,1,895,1649,754
12506,0,0,87,0,-87
12507,1,0,101,0,-101
12508,0,0,110,0,-110
12509,1,1,105,1798,1693
12510,0,0,2,0,-2
12511,1,0,147,0,-147
12512,0,0,8,0,-8
12513,0,0,105,0,-105
12514,0,0,62,0,-62
12515,1,1,425,1620,1195
12516,1,1,10,1501,1491
12517,1,1,821,1466,645
12518,1,1,815,1419,604
12519,1,0,83,0,-83
12520,1,0,0,0,0
12521,1,1,243,1213,970
12522,1,0,27,0,-27
12523,1,1,1231,1750,519
12524,1,1,276,2576,2300
12525,1,0,42,0,-42
12526,1,0,63,0,-63
12527,0,0,11,0,-11
12528,1,1,426,1221,795
12529,1,0,4,0,-4
12530,1,1,450,1487,1037
12531,0,0,21,0,-21
12532,0,0,11,0,-11
12533,0,0,17,0,-17
12534,1,0,72,0,-72
12535,1,1,623,3287,2664
12536,0,0,59,0,-59
12537,1,0,50,0,-50
12538,0,0,11,0,-11
12539,0,0,79,0,-79
12540,0,0,67,0,-67
12541,0,0,109,0,-109
12542,0,0,11,0,-11
12543,0,0,24,0,-24
12544,1,0,23,0,-23
12545,1,1,883,1489,606
12546,0,0,29,0,-29
12547,1,0,20,0,-20
12548,0,0,8,0,-8
12549,1,1,16,1397,1381
12550,1,0,7,0,-7
12551,0,0,13,0,-13
12552,0,0,39,0,-39
12553,0,0,10,0,-10
12554,1,1,722,1496,774
12555,1,0,51,0,-51
12556,1,0,11,0,-11
12557,1,1,619,1437,818
12558,1,1,838,2009,1171
12559,1,1,1512,1460,-52
12560,0,0,43,0,-43
12561,0,0,11,0,-11
12562,1,0,61,0,-61
12563,0,0,4,0,-4
12564,0,0,6,0,-6
12565,1,0,12,0,-12
12566,1,0,35,0,-35
12567,1,0,124,0,-124
12568,0,0,61,0,-61
12569,0,0,84,0,-84
12570,1,1,86,1750,1664
12571,0,0,22,0,-22
12572,1,1,341,1201,860
12573,0,0,76,0,-76
12574,0,0,293,0,-293
12575,0,0,24,0,-24
12576,1,0,69,0,-69
12577,1,1,202,1214,1012
12578,1,0,54,0,-54
12579,0,0,23,0,-23
12580,1,1,1526,1644,118
12581,0,0,13,0,-13
12582,1,1,275,1498,1223
12583,1,1,164,1519,1355
12584,0,0,24,0,-24
12585,1,1,542,2108,1566
12586,1,1,396,1960,1564
12587,0,0,30,0,-30
12588,1,0,6,0,-6
12589,1,1,27,3442,3415
12590,1,1,409,1254,845
12591,1,0,118,0,-118
12592,0,0,81,0,-81
12593,0,0,99,0,-99
12594,0,0,86,0,-86
12595,0,0,101,0,-101
12596,1,1,1939,1318,-621
12597,1,0,11,0,-11
12598,1,0,169,0,-169
12599,0,0,8,0,-8
12600,1,0,62,0,-62
12601,0,0,103,0,-103
12602,0,0,14,0,-14
12603,1,1,551,1465,914
12604,1,1,144,1247,1103
12605,1,1,170,1595,1425
12606,1,1,162,1349,1187
12607,1,1,1018,1281,263
12608,1,1,403,1437,1034
12609,1,0,77,0,-77
12610,0,0,33,0,-33
12611,1,1,963,2063,1100
12612,0,0,42,0,-42
12613,0,0,13,0,-13
12614,0,0,26,0,-26
12615,1,1,502,1609,1107
12616,1,0,21,0,-21
12617,1,1,633,1456,823
12618,1,0,14,0,-14
12619,1,0,11,0,-11
12620,0,0,6,0,-6
12621,1,1,320,1319,999
12622,1,1,856,1358,502
12623,1,1,1046,1530,484
12624,0,0,139,0,-139
12625,1,1,475,1667,1192
12626,1,1,132,1349,1217
12627,0,0,26,0,-26
12628,1,1,872,1403,531
12629,1,0,53,0,-53
12630,0,0,112,0,-112
12631,1,0,17,0,-17
12632,1,0,35,0,-35
12633,0,0,25,0,-25
12634,1,1,551,2590,2039
12635,1,0,184,0,-184
12636,1,0,9,0,-9
12637,1,0,6,0,-6
12638,1,0,0,0,0
12639,1,1,517,2166,1649
12640,1,1,1354,1257,-97
12641,0,0,117,0,-117
12642,1,1,185,2256,2071
12643,1,0,32,0,-32
12644,1,0,45,0,-45
12645,1,0,30,0,-30
12646,1,0,118,0,-118
12647,0,0,15,0,-15
12648,1,1,394,1217,823
12649,1,0,24,0,-24
12650,1,1,349,1674,1325
12651,1,1,1463,1606,143
12652,1,1,421,1285,864
12653,0,0,35,0,-35
12654,0,0,103,0,-103
12655,0,0,84,0,-84
12656,1,0,13,0,-13
12657,1,1,836,1409,573
12658,1,0,15,0,-15
12659,1,1,164,1223,1059
12660,1,1,249,1224,975
12661,1,1,50,1401,1351
12662,1,1,239,3463,3224
12663,1,0,8,0,-8
12664,0,0,0,0,0
12665,1,1,203,2301,2098
12666,1,1,656,1631,975
12667,0,0,23,0,-23
12668,1,1,56,1255,1199
12669,1,0,96,0,-96
12670,0,0,49,0,-49
12671,1,0,0,0,0
12672,1,0,10,0,-10
12673,0,0,16,0,-16
12674,1,1,354,2169,1815
12675,1,0,21,0,-21
12676,0,0,1,0,-1
12677,0,0,16,0,-16
12678,0,0,31,0,-31
12679,1,1,527,1242,715
12680,0,0,9,0,-9
12681,1,0,10,0,-10
12682,0,0,19,0,-19
12683,0,0,110,0,-110
12684,0,0,100,0,-100
12685,0,0,28,0,-28
12686,1,0,54,0,-54
12687,1,1,1444,1303,-141
12688,1,1,199,1316,1117
12689,0,0,79,0,-79
12690,1,1,298,1940,1642
12691,1,1,3,1402,1399
12692,0,0,64,0,-64
12693,0,0,71,0,-71
12694,0,0,54,0,-54
12695,1,0,59,0,-59
12696,0,0,1,0,-1
12697,0,0,5,0,-5
12698,1,0,28,0,-28
12699,0,0,25,0,-25
12700,0,0,53,0,-53
12701,1,1,387,1500,1113
12702,1,1,492,1726,1234
12703,1,1,1799,1378,-421
12704,0,0,15,0,-15
12705,1,1,433,1375,942
12706,1,1,333,2889,2556
12707,1,0,69,0,-69
12708,1,0,19,0,-19
12709,1,1,476,1961,1485
12710,0,0,6,0,-6
12711,0,0,17,0,-17
12712,1,1,45,1290,1245
12713,1,0,0,0,0
12714,0,0,2,0,-2
12715,0,0,87,0,-87
12716,0,0,30,0,-30
12717,1,0,14,0,-14
12718,1,1,57,1200,1143
12719,1,1,267,1346,1079
12720,1,0,21,0,-21
12721,1,0,71,0,-71
12722,0,0,149,0,-149
12723,0,0,37,0,-37
12724,1,1,498,1396,898
12725,1,1,244,6782,6538
12726,0,0,25,0,-25
12727,0,0,133,0,-133
12728,1,0,41,0,-41
12729,0,0,114,0,-114
12730,1,0,93,0,-93
12731,1,1,465,1310,845
12732,1,0,98,0,-98
12733,1,0,28,0,-28
12734,1,1,1671,1424,-247
12735,0,0,49,0,-49
12736,0,0,8,0,-8
12737,0,0,100,0,-100
12738,0,0,115,0,-115
12739,0,0,33,0,-33
12740,0,0,30,0,-30
12741,1,1,706,1285,579
12742,0,0,15,0,-15
12743,0,0,47,0,-47
12744,1,1,283,1522,1239
12745,0,0,0,0,0
12746,1,1,969,1874,905
12747,0,0,10,0,-10
12748,0,0,52,0,-52
12749,1,1,436,1388,952
12750,1,1,503,2291,1788
12751,1,0,8,0,-8
12752,1,1,476,1741,1265
12753,1,1,261,1925,1664
12754,1,0,11,0,-11
12755,1,1,1408,1474,66
12756,1,1,718,1417,699
12757,1,1,187,1401,1214
12758,1,1,617,1664,1047
12759,0,0,11,0,-11
12760,1,1,552,1241,689
12761,1,0,181,0,-181
12762,0,0,60,0,-60
12763,1,0,80,0,-80
12764,0,0,9,0,-9
12765,1,1,303,1309,1006
12766,1,1,277,1236,959
12767,0,0,121,0,-121
12768,1,0,19,0,-19
12769,1,0,15,0,-15
12770,0,0,4,0,-4
12771,0,0,35,0,-35
12772,0,0,83,0,-83
12773,1,1,309,1666,1357
12774,1,1,385,1500,1115
12775,1,0,18,0,-18
12776,1,0,9,0,-9
12777,0,0,36,0,-36
12778,1,1,699,1452,753
12779,0,0,1,0,-1
12780,1,1,342,1265,923
12781,0,0,3,0,-3
12782,1,1,65,1290,1225
12783,1,1,617,1300,683
12784,0,0,27,0,-27
12785,0,0,45,0,-45
12786,1,0,16,0,-16
12787,1,0,23,0,-23
12788,1,1,565,1206,641
12789,1,0,4,0,-4
12790,1,1,1382,2051,669
12791,1,1,1432,1347,-85
12792,1,1,927,2043,1116
12793,0,0,31,0,-31
12794,1,1,69,1510,1441
12795,1,0,3,0,-3
12796,0,0,6,0,-6
12797,1,0,173,0,-173
12798,1,0,79,0,-79
12799,0,0,1,0,-1
12800,1,0,2,0,-2
12801,1,1,1242,2272,1030
12802,1,1,1293,1464,171
12803,1,0,26,0,-26
12804,0,0,3,0,-3
12805,1,1,1204,1490,286
12806,1,0,23,0,-23
12807,1,1,446,1387,941
12808,0,0,130,0,-130
12809,1,0,42,0,-42
12810,1,1,349,1277,928
12811,0,0,12,0,-12
12812,1,1,108,1304,1196
12813,0,0,34,0,-34
12814,0,0,23,0,-23
12815,0,0,104,0,-104
12816,1,0,2,0,-2
12817,1,0,37,0,-37
12818,0,0,23,0,-23
12819,0,0,14,0,-14
12820,0,0,104,0,-104
12821,1,0,19,0,-19
12822,1,0,10,0,-10
12823,1,1,151,2168,2017
12824,0,0,41,0,-41
12825,1,1,114,2325,2211
12826,1,0,26,0,-26
12827,0,0,40,0,-40
12828,0,0,57,0,-57
12829,0,0,213,0,-213
12830,1,1,313,1365,1052
12831,0,0,4,0,-4
12832,1,0,62,0,-62
12833,0,0,57,0,-57
12834,0,0,5,0,-5
12835,0,0,54,0,-54
12836,1,1,106,1224,1118
12837,1,1,82,1365,1283
12838,1,1,320,1277,957
12839,0,0,6,0,-6
12840,1,0,4,0,-4
12841,1,1,517,1574,1057
12842,0,0,15,0,-15
12843,0,0,66,0,-66
12844,1,1,554,1281,727
12845,1,0,35,0,-35
12846,1,1,133,1314,1181
12847,0,0,85,0,-85
12848,1,0,197,0,-197
12849,0,0,0,0,0
12850,1,1,1087,1317,230
12851,0,0,94,0,-94
12852,1,0,1,0,-1
12853,1,0,84,0,-84
12854,1,1,555,1204,649
12855,1,1,48,6702,6654
12856,0,0,50,0,-50
12857,0,0,1,0,-1
12858,0,0,42,0,-42
12859,0,0,29,0,-29
12860,0,0,14,0,-14
12861,1,0,2,0,-2
12862,0,0,1,0,-1
12863,0,0,5,0,-5
12864,0,0,17,0,-17
12865,1,1,1265,2007,742
12866,1,1,1781,1291,-490
12867,1,0,96,0,-96
12868,1,0,2,0,-2
12869,1,1,111,1404,1293
12870,1,0,45,0,-45
12871,1,1,304,1255,951
12872,0,0,15,0,-15
12873,1,0,82,0,-82
12874,1,0,61,0,-61
12875,1,1,67,1335,1268
12876,0,0,47,0,-47
12877,0,0,16,0,-16
12878,1,0,146,0,-146
12879,1,1,454,1207,753
12880,1,1,533,1891,1358
12881,0,0,16,0,-16
12882,1,0,0,0,0
12883,1,0,0,0,0
12884,1,0,24,0,-24
12885,0,0,43,0,-43
12886,0,0,198,0,-198
12887,1,1,356,1257,901
12888,1,0,57,0,-57
12889,0,0,55,0,-55
12890,0,0,11,0,-11
12891,0,0,9,0,-9
12892,0,0,35,0,-35
12893,0,0,57,0,-57
12894,1,1,443,2648,2205
12895,0,0,15,0,-15
12896,0,0,34,0,-34
12897,1,1,957,2260,1303
12898,1,1,995,1210,215
12899,1,1,425,2208,1783
12900,1,1,378,1756,1378
12901,0,0,3,0,-3
12902,0,0,67,0,-67
12903,1,0,60,0,-60
12904,1,1,354,1424,1070
12905,1,0,10,0,-10
12906,1,1,278,1315,1037
12907,1,1,1019,1507,488
12908,0,0,36,0,-36
12909,0,0,61,0,-61
12910,1,0,38,0,-38
12911,1,0,90,0,-90
12912,1,0,86,0,-86
12913,1,0,64,0,-64
12914,0,0,179,0,-179
12915,1,0,16,0,-16
12916,0,0,121,0,-121
12917,0,0,2,0,-2
12918,1,1,1148,1899,751
12919,1,1,234,1573,1339
12920,1,1,70,2382,2312
12921,0,0,34,0,-34
12922,1,1,251,1725,1474
12923,1,0,31,0,-31
12924,0,0,223,0,-223
12925,1,1,1142,1733,591
12926,1,0,57,0,-57
12927,0,0,0,0,0
12928,1,1,960,1530,570
12929,1,1,216,1679,1463
12930,1,0,11,0,-11
12931,0,0,12,0,-12
12932,1,1,301,1348,1047
12933,0,0,62,0,-62
12934,1,0,41,0,-41
12935,0,0,15,0,-15
12936,1,0,88,0,-88
12937,1,0,90,0,-90
12938,0,0,35,0,-35
12939,0,0,43,0,-43
12940,0,0,118,0,-118
12941,1,0,4,0,-4
12942,1,0,230,0,-230
12943,1,1,527,1269,742
12944,0,0,29,0,-29
12945,0,0,15,0,-15
12946,1,0,32,0,-32
12947,1,1,2141,1346,-795
12948,1,0,11,0,-11
12949,1,1,194,1261,1067
12950,1,0,49,0,-49
12951,1,1,595,1448,853
12952,1,1,54,1441,1387
12953,0,0,98,0,-98
12954,0,0,3,0,-3
12955,1,1,55,1279,1224
12956,0,0,27,0,-27
12957,0,0,69,0,-69
12958,0,0,11,0,-11
12959,1,0,13,0,-13
12960,1,0,141,0,-141
12961,0,0,89,0,-89
12962,0,0,59,0,-59
12963,0,0,4,0,-4
12964,1,0,30,0,-30
12965,0,0,7,0,-7
12966,0,0,4,0,-4
12967,0,0,92,0,-92
12968,0,0,108,0,-108
12969,1,0,33,0,-33
12970,1,1,1067,2304,1237
12971,0,0,34,0,-34
12972,0,0,51,0,-51
12973,0,0,162,0,-162
12974,0,0,23,0,-23
12975,0,0,1,0,-1
12976,0,0,39,0,-39
12977,0,0,8,0,-8
12978,0,0,85,0,-85
12979,1,1,1001,1363,362
12980,1,1,121,1708,1587
12981,0,0,11,0,-11
12982,1,1,449,1287,838
12983,1,0,21,0,-21
12984,0,0,75,0,-75
12985,1,1,122,1211,1089
12986,0,0,27,0,-27
12987,1,0,20,0,-20
12988,1,0,0,0,0
12989,1,1,1021,1235,214
12990,0,0,3,0,-3
12991,1,1,219,1267,1048
12992,1,1,90,1372,1282
12993,1,1,80,1236,1156
12994,0,0,236,0,-236
12995,1,0,141,0,-141
12996,0,0,26,0,-26
12997,0,0,53,0,-53
12998,1,0,108,0,-108
12999,1,0,212,0,-212
13000,1,0,125,0,-125
13001,0,0,24,0,-24
13002,1,0,24,0,-24
13003,0,0,199,0,-199
13004,0,0,36,0,-36
13005,1,1,86,1283,1197
13006,0,0,22,0,-22
13007,1,0,123,0,-123
13008,1,0,105,0,-105
13009,0,0,29,0,-29
13010,0,0,32,0,-32
13011,1,1,314,1261,947
13012,1,1,685,2674,1989
13013,1,0,39,0,-39
13014,1,0,38,0,-38
13015,0,0,29,0,-29
13016,1,1,902,1304,402
13017,1,1,279,1669,1390
13018,1,0,31,0,-31
13019,0,0,14,0,-14
13020,0,0,7,0,-7
13021,1,0,2,0,-2
13022,0,0,41,0,-41
13023,1,0,30,0,-30
13024,0,0,28,0,-28
13025,0,0,23,0,-23
13026,1,0,36,0,-36
13027,0,0,53,0,-53
13028,1,1,169,1828,1659
13029,0,0,13,0,-13
13030,0,0,139,0,-139
13031,0,0,15,0,-15
13032,0,0,49,0,-49
13033,1,0,58,0,-58
13034,0,0,97,0,-97
13035,0,0,24,0,-24
13036,0,0,54,0,-54
13037,1,0,52,0,-52
13038,0,0,104,0,-104
13039,0,0,32,0,-32
13040,1,1,1195,2035,840
13041,0,0,15,0,-15
13042,1,0,115,0,-115
13043,1,1,239,1601,1362
13044,0,0,44,0,-44
13045,0,0,132,0,-132
13046,0,0,25,0,-25
13047,0,0,25,0,-25
13048,0,0,38,0,-38
13049,1,0,65,0,-65
13050,1,1,201,1318,1117
13051,0,0,78,0,-78
13052,1,1,455,1350,895
13053,0,0,83,0,-83
13054,1,0,81,0,-81
13055,1,1,447,1206,759
13056,1,1,150,1234,1084
13057,0,0,27,0,-27
13058,0,0,25,0,-25
13059,1,1,694,1361,667
13060,0,0,52,0,-52
13061,1,1,446,1426,980
13062,1,0,32,0,-32
13063,0,0,113,0,-113
13064,1,1,170,1409,1239
13065,1,0,48,0,-48
13066,1,0,72,0,-72
13067,1,0,7,0,-7
13068,1,1,246,1327,1081
13069,0,0,9,0,-9
13070,1,0,76,0,-76
13071,1,0,19,0,-19
13072,0,0,125,0,-125
13073,0,0,122,0,-122
13074,0,0,12,0,-12
13075,1,1,365,1211,846
13076,0,0,8,0,-8
13077,1,0,48,0,-48
13078,1,0,120,0,-120
13079,1,1,522,1200,678
13080,0,0,21,0,-21
13081,0,0,14,0,-14
13082,1,1,94,1417,1323
13083,1,0,22,0,-22
13084,1,0,33,0,-33
13085,0,0,95,0,-95
13086,1,1,952,1253,301
13087,0,0,125,0,-125
13088,1,0,2,0,-2
13089,0,0,1,0,-1
13090,1,0,265,0,-265
13091,1,1,388,1334,946
13092,1,1,97,1214,1117
13093,0,0,33,0,-33
13094,1,1,140,1508,1368
13095,1,0,25,0,-25
13096,1,1,300,1566,1266
13097,0,0,30,0,-30
13098,1,1,358,1577,1219
13099,1,0,52,0,-52
13100,1,0,114,0,-114
13101,1,1,105,1644,1539
13102,1,1,171,1305,1134
13103,0,0,9,0,-9
13104,0,0,22,0,-22
13105,0,0,3,0,-3
13106,0,0,24,0,-24
13107,0,0,0,0,0
13108,0,0,74,0,-74
13109,1,0,50,0,-50
13110,1,1,284,1212,928
13111,0,0,177,0,-177
13112,1,0,11,0,-11
13113,1,0,12,0,-12
13114,1,1,340,1208,868
13115,1,0,84,0,-84
13116,0,0,32,0,-32
13117,0,0,41,0,-41
13118,0,0,14,0,-14
13119,1,1,200,1236,1036
13120,0,0,60,0,-60
13121,0,0,4,0,-4
13122,0,0,9,0,-9
13123,1,0,54,0,-54
13124,1,1,182,1210,1028
13125,1,1,370,1214,844
13126,0,0,1,0,-1
13127,0,0,13,0,-13
13128,1,0,5,0,-5
13129,0,0,24,0,-24
13130,0,0,4,0,-4
13131,1,1,271,1474,1203
13132,0,0,17,0,-17
13133,0,0,30,0,-30
13134,1,1,579,1252,673
13135,0,0,16,0,-16
13136,1,1,1124,1739,615
13137,0,0,86,0,-86
13138,1,0,162,0,-162
13139,1,0,5,0,-5
13140,1,1,84,2344,2260
13141,1,0,24,0,-24
13142,1,0,49,0,-49
13143,1,0,90,0,-90
13144,1,1,228,1211,983
13145,1,1,254,1202,948
13146,1,1,278,1477,1199
13147,1,1,859,1425,566
13148,0,0,66,0,-66
13149,0,0,3,0,-3
13150,1,0,80,0,-80
13151,1,1,306,1562,1256
13152,0,0,0,0,0
13153,0,0,100,0,-100
13154,1,1,19,1836,1817
13155,1,0,28,0,-28
13156,1,0,52,0,-52
13157,0,0,26,0,-26
13158,0,0,62,0,-62
13159,0,0,8,0,-8
13160,0,0,45,0,-45
13161,0,0,46,0,-46
13162,1,0,28,0,-28
13163,1,0,21,0,-21
13164,1,1,600,1290,690
13165,1,1,690,1288,598
13166,1,1,103,1473,1370
13167,1,1,62,1413,1351
13168,1,0,24,0,-24
13169,1,0,11,0,-11
13170,0,0,158,0,-158
13171,1,0,53,0,-53
13172,0,0,22,0,-22
13173,1,1,121,2667,2546
13174,0,0,26,0,-26
13175,1,0,3,0,-3
13176,1,1,29,1277,1248
13177,1,0,25,0,-25
13178,1,0,165,0,-165
13179,1,1,446,2483,2037
13180,1,0,25,0,-25
13181,1,1,1089,1211,122
13182,1,1,278,1500,1222
13183,1,1,151,1492,1341
13184,1,1,513,1208,695
13185,0,0,105,0,-105
13186,1,0,119,0,-119
13187,1,1,180,1441,1261
13188,1,0,25,0,-25
13189,0,0,42,0,-42
13190,0,0,35,0,-35
13191,0,0,17,0,-17
13192,1,0,51,0,-51
13193,1,1,215,1437,1222
13194,1,0,7,0,-7
13195,0,0,48,0,-48
13196,1,1,531,1452,921
13197,1,0,41,0,-41
13198,1,1,410,1533,1123
13199,0,0,16,0,-16
13200,0,0,17,0,-17
13201,1,0,28,0,-28
13202,1,0,11,0,-11
13203,0,0,77,0,-77
13204,0,0,59,0,-59
13205,1,0,9,0,-9
13206,1,0,75,0,-75
13207,0,0,3,0,-3
13208,0,0,42,0,-42
13209,0,0,14,0,-14
13210,1,1,776,1332,556
13211,0,0,64,0,-64
13212,1,0,103,0,-103
13213,0,0,24,0,-24
13214,1,1,1351,1224,-127
13215,0,0,22,0,-22
13216,0,0,19,0,-19
13217,1,0,41,0,-41
13218,1,1,161,1603,1442
13219,1,0,106,0,-106
13220,1,0,101,0,-101
13221,1,1,849,1362,513
13222,1,0,32,0,-32
13223,0,0,51,0,-51
13224,1,1,807,3962,3155
13225,1,0,58,0,-58
13226,0,0,86,0,-86
13227,1,0,90,0,-90
13228,0,0,5,0,-5
13229,1,1,107,2218,2111
13230,0,0,9,0,-9
13231,0,0,21,0,-21
13232,0,0,16,0,-16
13233,1,1,171,1557,1386
13234,0,0,7,0,-7
13235,0,0,50,0,-50
13236,1,0,58,0,-58
13237,1,1,129,1625,1496
13238,1,1,366,2605,2239
13239,1,0,2,0,-2
13240,0,0,21,0,-21
13241,1,1,281,2276,1995
13242,1,1,704,1238,534
13243,1,0,106,0,-106
13244,0,0,116,0,-116
13245,0,0,150,0,-150
13246,1,0,181,0,-181
13247,1,0,43,0,-43
13248,1,0,0,0,0
13249,1,0,31,0,-31
13250,0,0,0,0,0
13251,0,0,45,0,-45
13252,1,0,43,0,-43
13253,0,0,54,0,-54
13254,0,0,0,0,0
13255,1,1,668,2857,2189
13256,1,1,342,1222,880
13257,1,1,704,2860,2156
13258,0,0,22,0,-22
13259,0,0,4,0,-4
13260,1,1,255,1303,1048
13261,1,1,376,1842,1466
13262,1,1,179,2023,1844
13263,1,1,565,2663,2098
13264,1,0,75,0,-75
13265,1,1,81,1678,1597
13266,0,0,25,0,-25
13267,1,0,35,0,-35
13268,1,0,75,0,-75
13269,1,0,1,0,-1
13270,1,1,391,1340,949
13271,1,1,426,1301,875
13272,1,0,67,0,-67
13273,1,1,62,1253,1191
13274,1,1,3336,1202,-2134
13275,1,1,296,1466,1170
13276,1,0,47,0,-47
13277,0,0,0,0,0
13278,1,0,37,0,-37
13279,0,0,92,0,-92
13280,1,0,1,0,-1
13281,1,0,233,0,-233
13282,1,1,767,1889,1122
13283,1,1,711,1220,509
13284,0,0,41,0,-41
13285,1,1,264,1586,1322
13286,0,0,108,0,-108
13287,0,0,43,0,-43
13288,0,0,47,0,-47
13289,0,0,3,0,-3
13290,1,0,82,0,-82
13291,1,1,157,1329,1172
13292,1,1,629,2481,1852
13293,1,1,528,2010,1482
13294,0,0,16,0,-16
13295,1,0,79,0,-79
13296,0,0,32,0,-32
13297,0,0,68,0,-68
13298,1,0,67,0,-67
13299,0,0,75,0,-75
13300,0,0,23,0,-23
13301,1,1,129,1274,1145
13302,1,1,523,1836,1313
13303,0,0,133,0,-133
13304,1,1,308,1250,942
13305,1,1,229,1330,1101
13306,1,0,1,0,-1
13307,1,1,586,1287,701
13308,1,0,1,0,-1
13309,1,0,131,0,-131
13310,1,0,59,0,-59
13311,1,1,877,1580,703
13312,1,0,0,0,0
13313,0,0,5,0,-5
13314,1,0,32,0,-32
13315,1,0,4,0,-4
13316,1,1,1165,2174,1009
13317,0,0,35,0,-35
13318,1,0,113,0,-113
13319,1,0,30,0,-30
13320,0,0,245,0,-245
13321,1,0,98,0,-98
13322,0,0,10,0,-10
13323,0,0,88,0,-88
13324,1,1,573,1205,632
13325,0,0,9,0,-9
13326,0,0,28,0,-28
13327,1,0,5,0,-5
13328,1,0,68,0,-68
13329,1,0,51,0,-51
13330,1,1,160,1357,1197
13331,1,1,309,1519,1210
13332,1,1,3483,1587,-1896
13333,0,0,39,0,-39
13334,1,0,89,0,-89
13335,1,0,44,0,-44
13336,0,0,2,0,-2
13337,1,0,52,0,-52
13338,1,0,16,0,-16
13339,0,0,29,0,-29
13340,0,0,47,0,-47
13341,1,1,264,1313,1049
13342,1,1,411,1670,1259
13343,1,0,8,0,-8
13344,0,0,187,0,-187
13345,1,0,5,0,-5
13346,1,1,871,1807,936
13347,0,0,71,0,-71
13348,1,1,377,1221,844
13349,1,0,177,0,-177
13350,0,0,34,0,-34
13351,1,0,1,0,-1
13352,1,0,59,0,-59
13353,0,0,14,0,-14
13354,1,1,67,1303,1236
13355,1,1,102,2422,2320
13356,1,0,30,0,-30
13357,0,0,237,0,-237
13358,1,1,23,1733,1710
13359,1,0,5,0,-5
13360,1,1,143,1754,1611
13361,0,0,10,0,-10
13362,1,1,133,1332,1199
13363,1,1,1812,2100,288
13364,0,0,229,0,-229
13365,1,1,131,1274,1143
13366,0,0,87,0,-87
13367,1,0,42,0,-42
13368,0,0,65,0,-65
13369,0,0,13,0,-13
13370,1,1,57,5262,5205
13371,0,0,7,0,-7
13372,0,0,94,0,-94
13373,1,0,84,0,-84
13374,1,0,60,0,-60
13375,1,0,3,0,-3
13376,1,0,121,0,-121
13377,1,1,99,1298,1199
13378,1,1,258,1331,1073
13379,1,0,88,0,-88
13380,1,1,153,2209,2056
13381,0,0,152,0,-152
13382,1,0,48,0,-48
13383,1,0,41,0,-41
13384,0,0,17,0,-17
13385,1,0,32,0,-32
13386,1,0,138,0,-138
13387,1,0,28,0,-28
13388,1,0,0,0,0
13389,1,1,205,1223,1018
13390,1,0,26,0,-26
13391,1,1,268,2689,2421
13392,1,0,93,0,-93
13393,1,0,20,0,-20
13394,1,0,86,0,-86
13395,0,0,5,0,-5
13396,1,1,289,1726,1437
13397,0,0,23,0,-23
13398,1,0,13,0,-13
13399,1,1,396,1221,825
13400,1,0,75,0,-75
13401,0,0,57,0,-57
13402,0,0,25,0,-25
13403,1,0,86,0,-86
13404,0,0,39,0,-39
13405,0,0,24,0,-24
13406,1,0,28,0,-28
13407,0,0,329,0,-329
13408,0,0,8,0,-8
13409,0,0,22,0,-22
13410,1,1,191,1278,1087
13411,1,0,15,0,-15
13412,1,1,335,1436,1101
13413,0,0,79,0,-79
13414,1,0,116,0,-116
13415,1,1,1068,2465,1397
13416,1,1,738,1689,951
13417,0,0,35,0,-35
13418,1,0,55,0,-55
13419,0,0,159,0,-159
13420,0,0,45,0,-45
13421,1,0,88,0,-88
13422,1,1,653,1502,849
13423,1,1,258,1491,1233
13424,1,0,22,0,-22
13425,1,0,2,0,-2
13426,0,0,89,0,-89
13427,1,1,728,5737,5009
13428,0,0,11,0,-11
13429,1,1,532,1317,785
13430,1,1,266,1257,991
13431,1,0,65,0,-65
13432,1,1,150,1452,1302
13433,0,0,165,0,-165
13434,0,0,27,0,-27
13435,1,1,1051,1667,616
13436,1,0,44,0,-44
13437,1,0,87,0,-87
13438,1,1,159,1391,1232
13439,1,0,11,0,-11
13440,1,1,303,1299,996
13441,0,0,23,0,-23
13442,1,1,895,1743,848
13443,1,1,198,1874,1676
13444,1,1,637,1335,698
13445,1,0,13,0,-13
13446,1,1,401,2412,2011
13447,1,1,82,1361,1279
13448,0,0,60,0,-60
13449,1,1,108,1421,1313
13450,0,0,38,0,-38
13451,0,0,17,0,-17
13452,1,0,28,0,-28
13453,1,0,0,0,0
13454,1,1,92,1422,1330
13455,0,0,14,0,-14
13456,0,0,31,0,-31
13457,1,1,66,1385,1319
13458,1,0,48,0,-48
13459,1,0,81,0,-81
13460,1,1,541,1355,814
13461,1,0,22,0,-22
13462,0,0,32,0,-32
13463,1,1,103,1293,1190
13464,0,0,29,0,-29
13465,0,0,84,0,-84
13466,0,0,69,0,-69
13467,1,0,24,0,-24
13468,1,0,70,0,-70
13469,1,1,386,1435,1049
13470,0,0,28,0,-28
13471,0,0,9,0,-9
13472,0,0,31,0,-31
13473,1,0,6,0,-6
13474,1,1,471,1418,947
13475,0,0,5,0,-5
13476,1,1,624,1275,651
13477,0,0,15,0,-15
13478,0,0,6,0,-6
13479,1,1,287,1204,917
13480,0,0,5,0,-5
13481,0,0,77,0,-77
13482,1,0,21,0,-21
13483,1,1,66,1608,1542
13484,0,0,6,0,-6
13485,0,0,82,0,-82
13486,0,0,25,0,-25
13487,0,0,7,0,-7
13488,0,0,6,0,-6
13489,0,0,29,0,-29
13490,1,1,399,1216,817
13491,1,1,1359,2494,1135
13492,0,0,198,0,-198
13493,1,1,534,1617,1083
13494,1,0,83,0,-83
13495,1,1,1539,1323,-216
13496,1,0,2,0,-2
13497,1,0,181,0,-181
13498,0,0,51,0,-51
13499,0,0,83,0,-83
13500,1,1,90,1408,1318
13501,1,1,141,1393,1252
13502,1,0,46,0,-46
13503,1,1,324,1509,1185
13504,0,0,12,0,-12
13505,1,1,336,1699,1363
13506,0,0,56,0,-56
13507,1,1,375,1380,1005
13508,1,1,469,1448,979
13509,1,0,43,0,-43
13510,0,0,37,0,-37
13511,1,1,194,4629,4435
13512,1,1,781,2670,1889
13513,1,0,10,0,-10
13514,0,0,3,0,-3
13515,1,0,108,0,-108
13516,1,0,120,0,-120
13517,0,0,43,0,-43
13518,1,1,246,2102,1856
13519,1,0,125,0,-125
13520,1,1,413,1298,885
13521,1,1,960,1681,721
13522,0,0,52,0,-52
13523,1,1,100,1787,1687
13524,1,1,1906,1683,-223
13525,0,0,12,0,-12
13526,1,1,141,1482,1341
13527,1,0,97,0,-97
13528,1,0,19,0,-19
13529,1,0,121,0,-121
13530,1,0,79,0,-79
13531,1,0,51,0,-51
13532,1,0,31,0,-31
13533,0,0,55,0,-55
13534,1,0,253,0,-253
13535,0,0,0,0,0
13536,0,0,91,0,-91
13537,1,1,256,1578,1322
13538,0,0,48,0,-48
13539,0,0,0,0,0
13540,0,0,20,0,-20
13541,1,0,37,0,-37
13542,0,0,23,0,-23
13543,1,1,445,1537,1092
13544,0,0,59,0,-59
13545,0,0,133,0,-133
13546,0,0,14,0,-14
13547,1,0,12,0,-12
13548,0,0,32,0,-32
13549,1,1,318,1637,1319
13550,1,0,21,0,-21
13551,1,1,316,1314,998
13552,1,1,1680,1231,-449
13553,1,1,192,1365,1173
13554,1,1,18,1526,1508
13555,1,0,22,0,-22
13556,0,0,49,0,-49
13557,0,0,46,0,-46
13558,0,0,2,0,-2
13559,0,0,8,0,-8
13560,0,0,67,0,-67
13561,1,0,10,0,-10
13562,0,0,52,0,-52
13563,1,1,254,1227,973
13564,1,1,487,1253,766
13565,1,0,54,0,-54
13566,1,1,123,1545,1422
13567,0,0,24,0,-24
13568,0,0,9,0,-9
13569,1,1,270,2085,1815
13570,1,0,54,0,-54
13571,1,0,23,0,-23
13572,0,0,1,0,-1
13573,1,1,1303,1290,-13
13574,1,0,34,0,-34
13575,1,1,882,1808,926
13576,1,0,35,0,-35
13577,1,1,137,1201,1064
13578,1,0,55,0,-55
13579,0,0,6,0,-6
13580,1,1,208,1835,1627
13581,0,0,4,0,-4
13582,1,0,67,0,-67
13583,1,0,48,0,-48
13584,1,1,16,1222,1206
13585,1,1,405,1274,869
13586,0,0,64,0,-64
13587,1,0,85,0,-85
13588,0,0,28,0,-28
13589,0,0,13,0,-13
13590,1,1,819,1249,430
13591,1,0,95,0,-95
13592,0,0,120,0,-120
13593,0,0,115,0,-115
13594,0,0,100,0,-100
13595,0,0,89,0,-89
13596,0,0,140,0,-140
13597,1,0,162,0,-162
13598,1,0,33,0,-33
13599,0,0,47,0,-47
13600,0,0,40,0,-40
13601,0,0,11,0,-11
13602,1,0,5,0,-5
13603,0,0,8,0,-8
13604,1,1,1739,1337,-402
13605,1,1,116,1812,1696
13606,0,0,2,0,-2
13607,1,0,96,0,-96
13608,1,1,134,2369,2235
13609,1,0,2,0,-2
13610,1,0,87,0,-87
13611,1,0,52,0,-52
13612,0,0,34,0,-34
13613,0,0,0,0,0
13614,1,0,27,0,-27
13615,0,0,7,0,-7
13616,1,0,19,0,-19
13617,1,1,23,1226,1203
13618,1,1,357,1776,1419
13619,0,0,22,0,-22
13620,1,1,642,1585,943
13621,1,1,114,1243,1129
13622,1,1,285,1505,1220
13623,1,1,132,1239,1107
13624,1,1,524,2080,1556
13625,1,1,250,1427,1177
13626,1,1,359,1226,867
13627,1,0,27,0,-27
13628,0,0,3,0,-3
13629,1,0,29,0,-29
13630,1,0,240,0,-240
13631,0,0,12,0,-12
13632,0,0,25,0,-25
13633,1,1,155,1351,1196
13634,1,0,178,0,-178
13635,1,0,44,0,-44
13636,0,0,23,0,-23
13637,0,0,191,0,-191
13638,1,1,600,1563,963
13639,1,0,47,0,-47
13640,0,0,43,0,-43
13641,1,0,140,0,-140
13642,1,1,504,7585,7081
13643,0,0,23,0,-23
13644,1,1,146,1526,1380
13645,1,0,20,0,-20
13646,0,0,175,0,-175
13647,1,0,33,0,-33
13648,0,0,8,0,-8
13649,1,1,760,1508,748
13650,0,0,53,0,-53
13651,0,0,15,0,-15
13652,0,0,22,0,-22
13653,0,0,37,0,-37
13654,0,0,48,0,-48
13655,1,0,32,0,-32
13656,1,0,38,0,-38
13657,0,0,124,0,-124
13658,0,0,62,0,-62
13659,0,0,32,0,-32
13660,1,1,155,1864,1709
13661,0,0,22,0,-22
13662,0,0,21,0,-21
13663,1,1,1044,1745,701
13664,0,0,102,0,-102
13665,1,1,710,1527,817
13666,1,1,155,1312,1157
13667,0,0,20,0,-20
13668,1,0,81,0,-81
13669,1,0,29,0,-29
13670,0,0,27,0,-27
13671,1,1,196,1223,1027
13672,1,1,885,1231,346
13673,0,0,11,0,-11
13674,1,0,3,0,-3
13675,0,0,1,0,-1
13676,0,0,28,0,-28
13677,0,0,29,0,-29
13678,1,1,143,1202,1059
13679,1,0,5,0,-5
13680,1,1,206,1720,1514
13681,0,0,37,0,-37
13682,1,1,26,1261,1235
13683,1,0,26,0,-26
13684,0,0,137,0,-137
13685,0,0,22,0,-22
13686,0,0,195,0,-195
13687,1,1,261,1309,1048
13688,1,0,68,0,-68
13689,0,0,37,0,-37
13690,1,1,27,1376,1349
13691,0,0,48,0,-48
13692,1,0,36,0,-36
13693,0,0,79,0,-79
13694,1,0,15,0,-15
13695,1,1,452,2442,1990
13696,1,1,310,1452,1142
13697,0,0,76,0,-76
13698,1,0,22,0,-22
13699,1,1,1686,1203,-483
13700,0,0,40,0,-40
13701,1,1,171,1824,1653
13702,0,0,41,0,-41
13703,0,0,148,0,-148
13704,0,0,31,0,-31
13705,0,0,34,0,-34
13706,1,1,1308,1248,-60
13707,0,0,45,0,-45
13708,1,0,42,0,-42
13709,0,0,83,0,-83
13710,0,0,2,0,-2
13711,0,0,12,0,-12
13712,1,0,15,0,-15
13713,1,0,2,0,-2
13714,1,0,6,0,-6
13715,1,0,55,0,-55
13716,1,0,7,0,-7
13717,0,0,41,0,-41
13718,0,0,14,0,-14
13719,0,0,62,0,-62
13720,1,1,335,1546,1211
13721,0,0,40,0,-40
13722,0,0,41,0,-41
13723,1,1,1628,1407,-221
13724,1,1,322,1310,988
13725,1,1,216,1204,988
13726,0,0,16,0,-16
13727,1,0,88,0,-88
13728,0,0,49,0,-49
13729,1,0,141,0,-141
13730,0,0,55,0,-55
13731,1,1,349,1267,918
13732,1,1,237,1470,1233
13733,1,0,11,0,-11
13734,1,1,583,1613,1030
13735,1,0,1,0,-1
13736,1,1,732,1893,1161
13737,0,0,92,0,-92
13738,0,0,29,0,-29
13739,0,0,28,0,-28
13740,0,0,69,0,-69
13741,0,0,16,0,-16
13742,0,0,53,0,-53
13743,0,0,13,0,-13
13744,0,0,23,0,-23
13745,1,1,766,1755,989
13746,0,0,71,0,-71
13747,0,0,40,0,-40
13748,1,1,208,1283,1075
13749,0,0,182,0,-182
13750,1,0,7,0,-7
13751,1,0,40,0,-40
13752,1,1,209,1371,1162
13753,0,0,38,0,-38
13754,0,0,15,0,-15
13755,1,0,1,0,-1
13756,0,0,65,0,-65
13757,0,0,165,0,-165
13758,0,0,82,0,-82
13759,0,0,67,0,-67
13760,1,1,346,1498,1152
13761,1,0,7,0,-7
13762,1,1,333,1429,1096
13763,1,1,625,1980,1355
13764,0,0,3,0,-3
13765,0,0,7,0,-7
13766,0,0,66,0,-66
13767,1,0,57,0,-57
13768,1,1,993,1272,279
13769,1,0,12,0,-12
13770,0,0,42,0,-42
13771,1,0,0,0,0
13772,0,0,15,0,-15
13773,0,0,52,0,-52
13774,1,1,315,1410,1095
13775,0,0,41,0,-41
13776,0,0,0,0,0
13777,0,0,110,0,-110
13778,0,0,82,0,-82
13779,0,0,142,0,-142
13780,1,0,1,0,-1
13781,1,1,526,1208,682
13782,1,0,34,0,-34
13783,0,0,14,0,-14
13784,0,0,52,0,-52
13785,1,0,8,0,-8
13786,1,0,69,0,-69
13787,1,0,72,0,-72
13788,1,0,33,0,-33
13789,1,0,76,0,-76
13790,0,0,64,0,-64
13791,1,1,473,1363,890
13792,1,1,304,1591,1287
13793,1,0,65,0,-65
13794,0,0,10,0,-10
13795,1,0,36,0,-36
13796,1,1,317,1747,1430
13797,1,1,170,1367,1197
13798,1,0,115,0,-115
13799,0,0,37,0,-37
13800,0,0,87,0,-87
13801,1,0,112,0,-112
13802,0,0,81,0,-81
13803,1,0,65,0,-65
13804,0,0,5,0,-5
13805,0,0,19,0,-19
13806,0,0,35,0,-35
13807,0,0,80,0,-80
13808,1,1,26,1960,1934
13809,1,1,758,1737,979
13810,1,0,61,0,-61
13811,0,0,14,0,-14
13812,1,1,182,1440,1258
13813,1,0,10,0,-10
13814,0,0,129,0,-129
13815,0,0,14,0,-14
13816,1,0,70,0,-70
13817,0,0,43,0,-43
13818,0,0,28,0,-28
13819,1,0,67,0,-67
13820,1,1,167,1282,1115
13821,0,0,24,0,-24
13822,1,0,17,0,-17
13823,1,1,153,1653,1500
13824,1,1,446,1495,1049
13825,1,1,621,1639,1018
13826,0,0,54,0,-54
13827,0,0,41,0,-41
13828,1,1,636,1636,1000
13829,0,0,8,0,-8
13830,1,0,69,0,-69
13831,1,0,5,0,-5
13832,0,0,27,0,-27
13833,1,1,417,1299,882
13834,1,1,561,1359,798
13835,1,0,19,0,-19
13836,1,1,568,1332,764
13837,1,0,74,0,-74
13838,1,1,967,1694,727
13839,1,0,27,0,-27
13840,0,0,98,0,-98
13841,0,0,62,0,-62
13842,0,0,53,0,-53
13843,1,0,11,0,-11
13844,1,0,3,0,-3
13845,1,1,93,2131,2038
13846,1,1,514,1246,732
13847,1,1,328,2122,1794
13848,0,0,1,0,-1
13849,1,0,6,0,-6
13850,1,0,126,0,-126
13851,0,0,20,0,-20
13852,1,1,391,1542,1151
13853,1,0,11,0,-11
13854,0,0,68,0,-68
13855,0,0,29,0,-29
13856,0,0,163,0,-163
13857,1,1,976,1311,335
13858,1,1,542,1391,849
13859,0,0,191,0,-191
13860,0,0,21,0,-21
13861,1,1,284,2821,2537
13862,1,1,782,1224,442
13863,1,0,134,0,-134
13864,0,0,22,0,-22
13865,0,0,106,0,-106
13866,1,0,19,0,-19
13867,1,0,13,0,-13
13868,1,0,143,0,-143
13869,1,0,63,0,-63
13870,0,0,20,0,-20
13871,0,0,28,0,-28
13872,0,0,47,0,-47
13873,0,0,3,0,-3
13874,1,0,20,0,-20
13875,0,0,41,0,-41
13876,1,1,343,1230,887
13877,1,1,334,1518,1184
13878,1,1,133,1556,1423
13879,1,1,479,1508,1029
13880,1,0,53,0,-53
13881,0,0,6,0,-6
13882,1,1,435,1363,928
13883,0,0,88,0,-88
13884,0,0,161,0,-161
13885,1,0,47,0,-47
13886,1,1,1095,1583,488
13887,1,0,10,0,-10
13888,0,0,1,0,-1
13889,0,0,15,0,-15
13890,1,0,87,0,-87
13891,1,0,84,0,-84
13892,0,0,17,0,-17
13893,1,1,276,1507,1231
13894,1,1,255,1228,973
13895,1,1,98,1394,1296
13896,1,1,1469,1340,-129
13897,0,0,14,0,-14
13898,1,0,72,0,-72
13899,0,0,31,0,-31
13900,1,0,14,0,-14
13901,1,1,155,1452,1297
13902,0,0,55,0,-55
13903,1,1,62,2036,1974
13904,1,1,402,1460,1058
13905,0,0,15,0,-15
13906,0,0,9,0,-9
13907,1,1,121,1244,1123
13908,1,0,6,0,-6
13909,1,0,0,0,0
13910,1,0,5,0,-5
13911,0,0,117,0,-117
13912,1,0,45,0,-45
13913,1,1,178,1441,1263
13914,0,0,16,0,-16
13915,1,1,554,1479,925
13916,0,0,69,0,-69
13917,1,1,197,1363,1166
13918,0,0,64,0,-64
13919,0,0,0,0,0
13920,1,0,15,0,-15
13921,1,1,326,1486,1160
13922,1,0,73,0,-73
13923,1,1,905,1727,822
13924,1,0,60,0,-60
13925,1,0,9,0,-9
13926,1,0,46,0,-46
13927,0,0,220,0,-220
13928,1,0,237,0,-237
13929,1,1,218,1540,1322
13930,1,0,1,0,-1
13931,1,1,225,1433,1208
13932,1,0,230,0,-230
13933,1,0,25,0,-25
13934,1,1,801,1222,421
13935,0,0,0,0,0
13936,1,0,98,0,-98
13937,0,0,178,0,-178
13938,0,0,37,0,-37
13939,1,0,82,0,-82
13940,1,1,504,1209,705
13941,1,1,174,1314,1140
13942,0,0,38,0,-38
13943,0,0,14,0,-14
13944,0,0,30,0,-30
13945,1,0,36,0,-36
13946,1,0,98,0,-98
13947,1,1,2156,3721,1565
13948,0,0,25,0,-25
13949,1,0,15,0,-15
13950,1,0,7,0,-7
13951,1,0,24,0,-24
13952,1,0,37,0,-37
13953,1,1,446,1657,1211
13954,1,0,45,0,-45
13955,0,0,55,0,-55
13956,1,1,479,1227,748
13957,1,0,15,0,-15
13958,0,0,76,0,-76
13959,0,0,1,0,-1
13960,1,0,118,0,-118
13961,1,0,19,0,-19
13962,0,0,14,0,-14
13963,1,0,33,0,-33
13964,1,1,741,2347,1606
13965,0,0,66,0,-66
13966,0,0,50,0,-50
13967,1,1,2788,1433,-1355
13968,1,0,20,0,-20
13969,1,1,81,1436,1355
13970,1,0,17,0,-17
13971,1,1,449,1503,1054
13972,1,0,10,0,-10
13973,1,1,480,1408,928
13974,0,0,30,0,-30
13975,1,0,5,0,-5
13976,0,0,18,0,-18
13977,0,0,66,0,-66
13978,0,0,27,0,-27
13979,0,0,44,0,-44
13980,0,0,28,0,-28
13981,0,0,33,0,-33
13982,0,0,23,0,-23
13983,1,1,64,1361,1297
13984,0,0,190,0,-190
13985,0,0,101,0,-101
13986,0,0,9,0,-9
13987,1,1,340,1661,1321
13988,1,1,335,1495,1160
13989,1,1,340,1337,997
13990,1,0,11,0,-11
13991,0,0,19,0,-19
13992,0,0,104,0,-104
13993,1,0,70,0,-70
13994,1,1,46,1427,1381
13995,1,0,55,0,-55
13996,1,0,85,0,-85
13997,0,0,34,0,-34
13998,0,0,73,0,-73
13999,1,1,108,1766,1658
14000,0,0,113,0,-113
14001,1,1,314,2118,1804
14002,1,0,60,0,-60
14003,1,1,217,1240,1023
14004,1,1,468,1434,966
14005,1,1,322,1267,945
14006,0,0,121,0,-121
14007,1,0,134,0,-134
14008,1,0,66,0,-66
14009,1,1,59,1407,1348
14010,0,0,16,0,-16
14011,1,0,70,0,-70
14012,0,0,57,0,-57
14013,1,0,3,0,-3
14014,1,1,123,1987,1864
14015,0,0,1,0,-1
14016,0,0,39,0,-39
14017,1,1,377,1295,918
14018,0,0,124,0,-124
14019,0,0,37,0,-37
14020,0,0,40,0,-40
14021,0,0,16,0,-16
14022,1,0,36,0,-36
14023,1,0,34,0,-34
14024,0,0,49,0,-49
14025,0,0,15,0,-15
14026,1,0,119,0,-119
14027,0,0,13,0,-13
14028,0,0,102,0,-102
14029,0,0,114,0,-114
14030,1,0,12,0,-12
14031,1,0,29,0,-29
14032,0,0,65,0,-65
14033,1,1,315,1344,1029
14034,0,0,251,0,-251
14035,0,0,6,0,-6
14036,0,0,33,0,-33
14037,1,1,184,2145,1961
14038,0,0,3,0,-3
14039,1,1,182,1649,1467
14040,0,0,32,0,-32
14041,1,1,187,1285,1098
14042,1,1,189,1424,1235
14043,0,0,10,0,-10
14044,0,0,115,0,-115
14045,1,1,484,1246,762
14046,0,0,342,0,-342
14047,1,1,1227,1233,6
14048,0,0,8,0,-8
14049,0,0,28,0,-28
14050,0,0,85,0,-85
14051,0,0,16,0,-16
14052,1,0,21,0,-21
14053,1,0,47,0,-47
14054,1,1,735,1472,737
14055,1,1,447,1571,1124
14056,1,1,50,1471,1421
14057,0,0,63,0,-63
14058,1,1,715,1330,615
14059,1,1,32,1226,1194
14060,1,0,6,0,-6
14061,1,1,985,2064,1079
14062,1,1,1522,1357,-165
14063,1,1,709,2176,1467
14064,1,1,763,1433,670
14065,1,1,84,1428,1344
14066,1,1,809,1367,558
14067,1,0,64,0,-64
14068,1,1,423,1659,1236
14069,1,0,34,0,-34
14070,0,0,10,0,-10
14071,1,0,38,0,-38
14072,1,0,64,0,-64
14073,0,0,43,0,-43
14074,1,0,18,0,-18
14075,0,0,89,0,-89
14076,0,0,66,0,-66
14077,1,0,55,0,-55
14078,0,0,89,0,-89
14079,0,0,140,0,-140
14080,1,1,1324,1223,-101
14081,1,1,242,1520,1278
14082,1,0,69,0,-69
14083,1,1,388,1547,1159
14084,1,1,917,1267,350
14085,0,0,5,0,-5
14086,1,1,288,2688,2400
14087,1,1,454,1237,783
14088,1,0,61,0,-61
14089,1,0,80,0,-80
14090,1,0,41,0,-41
14091,1,0,9,0,-9
14092,0,0,95,0,-95
14093,1,0,86,0,-86
14094,1,0,20,0,-20
14095,1,0,1,0,-1
14096,1,1,177,1399,1222
14097,0,0,78,0,-78
14098,0,0,0,0,0
14099,1,1,98,1202,1104
14100,0,0,11,0,-11
14101,0,0,30,0,-30
14102,1,0,199,0,-199
14103,1,0,36,0,-36
14104,0,0,9,0,-9
14105,0,0,30,0,-30
14106,1,1,87,1318,1231
14107,1,0,30,0,-30
14108,1,0,18,0,-18
14109,0,0,106,0,-106
14110,1,0,82,0,-82
14111,1,1,198,1382,1184
14112,0,0,3,0,-3
14113,1,1,803,1867,1064
14114,0,0,46,0,-46
14115,1,1,382,1213,831
14116,1,1,104,1317,1213
14117,1,1,2038,2626,588
14118,1,1,723,1212,489
14119,1,1,1034,1585,551
14120,1,0,16,0,-16
14121,1,1,43,1364,1321
14122,1,1,1038,1881,843
14123,1,1,1201,1634,433
14124,0,0,29,0,-29
14125,1,1,63,1851,1788
14126,0,0,45,0,-45
14127,0,0,116,0,-116
14128,1,0,12,0,-12
14129,1,0,68,0,-68
14130,0,0,56,0,-56
14131,1,1,274,3275,3001
14132,0,0,104,0,-104
14133,1,1,954,1212,258
14134,0,0,18,0,-18
14135,0,0,5,0,-5
14136,0,0,60,0,-60
14137,1,0,57,0,-57
14138,1,1,2129,1294,-835
14139,0,0,74,0,-74
14140,0,0,123,0,-123
14141,1,0,22,0,-22
14142,1,1,861,2180,1319
14143,1,1,425,1281,856
14144,1,1,247,1315,1068
14145,1,0,14,0,-14
14146,1,0,12,0,-12
14147,0,0,80,0,-80
14148,1,1,380,1396,1016
14149,0,0,36,0,-36
14150,1,1,2116,1395,-721
14151,1,0,0,0,0
14152,0,0,29,0,-29
14153,1,1,212,1231,1019
14154,1,0,46,0,-46
14155,0,0,14,0,-14
14156,0,0,34,0,-34
14157,1,1,742,1566,824
14158,1,0,35,0,-35
14159,0,0,48,0,-48
14160,0,0,4,0,-4
14161,1,1,1941,2099,158
14162,0,0,23,0,-23
14163,1,0,73,0,-73
14164,1,1,696,1294,598
14165,1,0,13,0,-13
14166,0,0,64,0,-64
14167,0,0,43,0,-43
14168,1,1,571,1258,687
14169,1,0,39,0,-39
14170,0,0,101,0,-101
14171,1,0,35,0,-35
14172,0,0,41,0,-41
14173,1,1,188,2193,2005
14174,1,1,1973,1236,-737
14175,1,1,1865,1200,-665
14176,1,1,66,1414,1348
14177,1,0,28,0,-28
14178,1,1,563,1394,831
14179,0,0,20,0,-20
14180,1,1,161,1465,1304
14181,1,1,956,1928,972
14182,0,0,64,0,-64
14183,1,1,200,1279,1079
14184,1,0,52,0,-52
14185,0,0,109,0,-109
14186,0,0,57,0,-57
14187,0,0,23,0,-23
14188,1,1,1104,1453,349
14189,1,0,82,0,-82
14190,0,0,48,0,-48
14191,1,0,58,0,-58
14192,0,0,11,0,-11
14193,1,0,25,0,-25
14194,1,0,87,0,-87
14195,0,0,8,0,-8
14196,0,0,17,0,-17
14197,0,0,1,0,-1
14198,1,1,13,1510,1497
14199,1,0,48,0,-48
14200,0,0,40,0,-40
14201,1,1,443,1435,992
14202,1,1,714,1219,505
14203,0,0,11,0,-11
14204,1,0,25,0,-25
14205,1,1,3081,2002,-1079
14206,1,0,9,0,-9
14207,0,0,4,0,-4
14208,1,1,835,1691,856
14209,1,0,4,0,-4
14210,1,1,1019,1909,890
14211,1,1,1164,1224,60
14212,0,0,27,0,-27
14213,1,1,1443,1570,127
14214,1,0,18,0,-18
14215,1,1,40,1691,1651
14216,1,0,117,0,-117
14217,0,0,16,0,-16
14218,1,1,107,1675,1568
14219,1,1,80,1372,1292
14220,1,1,60,1495,1435
14221,1,1,337,2155,1818
14222,0,0,46,0,-46
14223,1,0,95,0,-95
14224,1,1,880,1283,403
14225,0,0,33,0,-33
14226,1,1,269,1659,1390
14227,0,0,41,0,-41
14228,1,0,9,0,-9
14229,1,0,108,0,-108
14230,1,1,136,1498,1362
14231,0,0,1,0,-1
14232,0,0,80,0,-80
14233,0,0,5,0,-5
14234,0,0,24,0,-24
14235,1,0,20,0,-20
14236,0,0,46,0,-46
14237,0,0,61,0,-61
14238,1,1,353,1214,861
14239,1,0,162,0,-162
14240,0,0,28,0,-28
14241,0,0,18,0,-18
14242,1,1,682,1219,537
14243,1,1,1683,1218,-465
14244,1,0,15,0,-15
14245,1,1,298,1291,993
14246,1,1,2020,1216,-804
14247,1,0,23,0,-23
14248,1,1,1032,1941,909
14249,0,0,32,0,-32
14250,1,0,41,0,-41
14251,1,0,18,0,-18
14252,1,1,489,1211,722
14253,0,0,70,0,-70
14254,1,0,6,0,-6
14255,0,0,4,0,-4
14256,1,1,223,3433,3210
14257,0,0,166,0,-166
14258,1,1,429,4444,4015
14259,0,0,49,0,-49
14260,1,0,16,0,-16
14261,1,1,132,1421,1289
14262,0,0,4,0,-4
14263,0,0,72,0,-72
14264,1,1,128,1408,1280
14265,1,0,253,0,-253
14266,0,0,46,0,-46
14267,1,0,11,0,-11
14268,1,0,15,0,-15
14269,1,1,201,1869,1668
14270,1,1,326,1218,892
14271,1,0,9,0,-9
14272,1,1,554,1304,750
14273,1,0,171,0,-171
14274,1,1,211,1272,1061
14275,0,0,48,0,-48
14276,1,1,267,1448,1181
14277,0,0,95,0,-95
14278,0,0,34,0,-34
14279,0,0,59,0,-59
14280,0,0,51,0,-51
14281,1,0,118,0,-118
14282,1,0,9,0,-9
14283,1,0,34,0,-34
14284,0,0,70,0,-70
14285,1,0,20,0,-20
14286,0,0,63,0,-63
14287,1,0,66,0,-66
14288,1,0,39,0,-39
14289,1,1,135,1625,1490
14290,0,0,8,0,-8
14291,1,1,334,1431,1097
14292,1,1,24,1487,1463
14293,1,0,0,0,0
14294,1,1,1198,1274,76
14295,1,0,23,0,-23
14296,0,0,0,0,0
14297,1,0,43,0,-43
14298,0,0,187,0,-187
14299,0,0,21,0,-21
14300,1,0,39,0,-39
14301,1,0,42,0,-42
14302,0,0,214,0,-214
14303,1,0,141,0,-141
14304,1,0,113,0,-113
14305,1,1,265,1218,953
14306,1,0,44,0,-44
14307,1,0,22,0,-22
14308,1,0,35,0,-35
14309,1,0,8,0,-8
14310,0,0,87,0,-87
14311,0,0,1,0,-1
14312,1,1,1276,1873,597
14313,0,0,88,0,-88
14314,0,0,32,0,-32
14315,0,0,7,0,-7
14316,1,0,74,0,-74
14317,0,0,45,0,-45
14318,1,0,25,0,-25
14319,1,1,374,1288,914
14320,1,1,138,1439,1301
14321,0,0,15,0,-15
14322,0,0,19,0,-19
14323,0,0,261,0,-261
14324,1,1,570,1202,632
14325,1,0,47,0,-47
14326,1,0,71,0,-71
14327,0,0,22,0,-22
14328,1,1,745,1226,481
14329,0,0,13,0,-13
14330,1,1,754,1360,606
14331,1,1,507,1666,1159
14332,1,1,90,1439,1349
14333,0,0,27,0,-27
14334,1,0,63,0,-63
14335,1,1,1030,1221,191
14336,1,0,18,0,-18
14337,0,0,165,0,-165
14338,0,0,3,0,-3
14339,1,1,728,1384,656
14340,0,0,39,0,-39
14341,1,1,147,1346,1199
14342,0,0,249,0,-249
14343,0,0,26,0,-26
14344,1,0,85,0,-85
14345,1,0,49,0,-49
14346,0,0,26,0,-26
14347,0,0,15,0,-15
14348,1,0,6,0,-6
14349,1,1,1252,1593,341
14350,1,1,160,1406,1246
14351,1,0,56,0,-56
14352,1,0,36,0,-36
14353,1,1,440,1307,867
14354,0,0,97,0,-97
14355,1,0,25,0,-25
14356,1,0,42,0,-42
14357,1,0,54,0,-54
14358,0,0,6,0,-6
14359,0,0,17,0,-17
14360,1,0,103,0,-103
14361,1,0,14,0,-14
14362,1,0,53,0,-53
14363,0,0,109,0,-109
14364,1,0,8,0,-8
14365,0,0,1,0,-1
14366,1,1,624,1242,618
14367,1,0,324,0,-324
14368,1,1,545,1375,830
14369,0,0,62,0,-62
14370,1,0,52,0,-52
14371,0,0,12,0,-12
14372,1,1,1303,1410,107
14373,1,0,30,0,-30
14374,1,1,132,1542,1410
14375,1,1,308,1256,948
14376,1,0,18,0,-18
14377,1,1,198,1385,1187
14378,0,0,41,0,-41
14379,0,0,8,0,-8
14380,1,1,991,1328,337
14381,1,0,81,0,-81
14382,1,1,490,1559,1069
14383,1,1,1002,1447,445
14384,1,1,1027,1366,339
14385,0,0,25,0,-25
14386,1,0,8,0,-8
14387,0,0,20,0,-20
14388,1,0,145,0,-145
14389,1,1,726,1766,1040
14390,1,1,675,1744,1069
14391,1,0,117,0,-117
14392,0,0,131,0,-131
14393,0,0,0,0,0
14394,1,0,1,0,-1
14395,1,0,50,0,-50
14396,0,0,80,0,-80
14397,1,1,141,1356,1215
14398,1,0,48,0,-48
14399,1,0,23,0,-23
14400,0,0,92,0,-92
14401,0,0,35,0,-35
14402,0,0,18,0,-18
14403,0,0,66,0,-66
14404,0,0,4,0,-4
14405,0,0,2,0,-2
14406,1,0,0,0,0
14407,1,0,11,0,-11
14408,1,0,51,0,-51
14409,1,1,65,1368,1303
14410,0,0,46,0,-46
14411,0,0,56,0,-56
14412,0,0,14,0,-14
14413,1,0,3,0,-3
14414,1,0,7,0,-7
14415,0,0,45,0,-45
14416,1,0,105,0,-105
14417,1,0,104,0,-104
14418,0,0,142,0,-142
14419,1,0,13,0,-13
14420,0,0,11,0,-11
14421,1,1,33,1961,1928
14422,0,0,13,0,-13
14423,1,0,16,0,-16
14424,1,0,53,0,-53
14425,1,0,5,0,-5
14426,0,0,68,0,-68
14427,1,0,41,0,-41
14428,0,0,29,0,-29
14429,0,0,21,0,-21
14430,1,1,80,1418,1338
14431,1,0,6,0,-6
14432,0,0,31,0,-31
14433,1,1,970,1377,407
14434,0,0,7,0,-7
14435,1,0,43,0,-43
14436,1,1,213,1633,1420
14437,1,0,45,0,-45
14438,1,0,60,0,-60
14439,1,0,134,0,-134
14440,1,0,41,0,-41
14441,1,1,481,1393,912
14442,1,1,371,1738,1367
14443,0,0,6,0,-6
14444,1,1,903,1534,631
14445,0,0,15,0,-15
14446,0,0,10,0,-10
14447,0,0,59,0,-59
14448,0,0,90,0,-90
14449,0,0,29,0,-29
14450,0,0,117,0,-117
14451,1,1,145,1552,1407
14452,1,0,36,0,-36
14453,1,0,14,0,-14
14454,0,0,54,0,-54
14455,0,0,11,0,-11
14456,0,0,17,0,-17
14457,0,0,9,0,-9
14458,1,1,327,1517,1190
14459,0,0,168,0,-168
14460,1,0,53,0,-53
14461,1,0,5,0,-5
14462,0,0,32,0,-32
14463,1,0,15,0,-15
14464,1,0,6,0,-6
14465,0,0,55,0,-55
14466,1,0,100,0,-100
14467,1,0,87,0,-87
14468,0,0,107,0,-107
14469,1,1,950,1612,662
14470,1,0,14,0,-14
14471,1,1,304,1588,1284
14472,1,1,34,2563,2529
14473,1,1,357,1268,911
14474,0,0,116,0,-116
14475,1,0,82,0,-82
14476,0,0,51,0,-51
14477,0,0,39,0,-39
14478,1,0,116,0,-116
14479,0,0,32,0,-32
14480,1,1,173,2841,2668
14481,1,1,1142,2355,1213
14482,0,0,10,0,-10
14483,1,0,8,0,-8
14484,1,1,216,1214,998
14485,0,0,86,0,-86
14486,0,0,3,0,-3
14487,1,0,35,0,-35
14488,1,0,83,0,-83
14489,0,0,28,0,-28
14490,0,0,9,0,-9
14491,0,0,14,0,-14
14492,1,1,1179,1610,431
14493,0,0,63,0,-63
14494,0,0,8,0,-8
14495,1,1,147,1223,1076
14496,1,0,26,0,-26
14497,0,0,7,0,-7
14498,0,0,67,0,-67
14499,0,0,18,0,-18
14500,1,0,15,0,-15
14501,0,0,31,0,-31
14502,1,0,9,0,-9
14503,0,0,8,0,-8
14504,1,0,3,0,-3
14505,0,0,23,0,-23
14506,0,0,93,0,-93
14507,1,1,162,1522,1360
14508,1,1,1134,1557,423
14509,0,0,5,0,-5
14510,0,0,21,0,-21
14511,0,0,92,0,-92
14512,0,0,38,0,-38
14513,1,0,30,0,-30
14514,1,1,280,1263,983
14515,0,0,11,0,-11
14516,1,0,28,0,-28
14517,1,1,772,1335,563
14518,1,1,684,3906,3222
14519,1,1,541,2180,1639
14520,0,0,36,0,-36
14521,1,1,98,1563,1465
14522,1,0,42,0,-42
14523,1,1,156,1791,1635
14524,0,0,22,0,-22
14525,1,0,131,0,-131
14526,1,1,1263,1849,586
14527,1,0,67,0,-67
14528,0,0,37,0,-37
14529,0,0,22,0,-22
14530,1,1,1858,1275,-583
14531,0,0,9,0,-9
14532,1,0,90,0,-90
14533,0,0,22,0,-22
14534,1,1,407,1287,880
14535,1,0,25,0,-25
14536,0,0,42,0,-42
14537,0,0,25,0,-25
14538,0,0,49,0,-49
14539,1,1,1276,1233,-43
14540,0,0,6,0,-6
14541,1,0,3,0,-3
14542,1,0,23,0,-23
14543,0,0,6,0,-6
14544,0,0,8,0,-8
14545,0,0,38,0,-38
14546,1,0,22,0,-22
14547,1,0,15,0,-15
14548,1,0,10,0,-10
14549,0,0,13,0,-13
14550,0,0,3,0,-3
14551,1,1,1476,2966,1490
14552,1,0,16,0,-16
14553,0,0,16,0,-16
14554,0,0,3,0,-3
14555,1,1,259,1295,1036
14556,1,0,30,0,-30
14557,0,0,77,0,-77
14558,1,1,475,1372,897
14559,0,0,228,0,-228
14560,1,0,139,0,-139
14561,0,0,30,0,-30
14562,0,0,35,0,-35
14563,1,1,306,1210,904
14564,0,0,135,0,-135
14565,1,1,1406,1466,60
14566,1,1,952,1274,322
14567,0,0,11,0,-11
14568,0,0,22,0,-22
14569,1,0,87,0,-87
14570,1,0,15,0,-15
14571,1,1,966,1301,335
14572,0,0,63,0,-63
14573,1,1,182,1461,1279
14574,1,0,20,0,-20
14575,0,0,63,0,-63
14576,1,0,40,0,-40
14577,0,0,181,0,-181
14578,1,1,59,1278,1219
14579,0,0,13,0,-13
14580,1,1,161,1789,1628
14581,0,0,176,0,-176
14582,1,1,195,1364,1169
14583,1,0,39,0,-39
14584,0,0,13,0,-13
14585,0,0,27,0,-27
14586,1,0,14,0,-14
14587,1,1,737,1647,910
14588,1,0,32,0,-32
14589,0,0,8,0,-8
14590,0,0,14,0,-14
14591,0,0,21,0,-21
14592,1,0,41,0,-41
14593,1,1,1404,1348,-56
14594,0,0,14,0,-14
14595,1,0,69,0,-69
14596,1,1,161,1613,1452
14597,1,1,991,2904,1913
14598,1,0,58,0,-58
14599,0,0,58,0,-58
14600,0,0,62,0,-62
14601,0,0,7,0,-7
14602,1,0,151,0,-151
14603,0,0,11,0,-11
14604,1,1,191,1368,1177
14605,1,1,823,1899,1076
14606,1,0,5,0,-5
14607,1,1,879,1370,491
14608,1,1,865,1327,462
14609,1,1,427,1254,827
14610,1,0,42,0,-42
14611,1,0,71,0,-71
14612,1,0,16,0,-16
14613,1,0,3,0,-3
14614,0,0,160,0,-160
14615,0,0,4,0,-4
14616,1,1,126,1605,1479
14617,1,0,118,0,-118
14618,0,0,1,0,-1
14619,1,0,91,0,-91
14620,1,0,27,0,-27
14621,1,1,483,1853,1370
14622,1,0,9,0,-9
14623,0,0,8,0,-8
14624,0,0,173,0,-173
14625,1,0,156,0,-156
14626,0,0,38,0,-38
14627,1,1,507,1362,855
14628,0,0,44,0,-44
14629,1,1,871,1492,621
14630,0,0,78,0,-78
14631,0,0,86,0,-86
14632,1,0,31,0,-31
14633,0,0,67,0,-67
14634,0,0,51,0,-51
14635,0,0,28,0,-28
14636,1,0,16,0,-16
14637,1,0,14,0,-14
14638,0,0,67,0,-67
14639,1,0,59,0,-59
14640,1,1,80,1386,1306
14641,1,1,261,2467,2206
14642,1,1,695,1208,513
14643,0,0,27,0,-27
14644,1,0,8,0,-8
14645,0,0,4,0,-4
14646,0,0,51,0,-51
14647,0,0,26,0,-26
14648,1,0,39,0,-39
14649,0,0,25,0,-25
14650,1,1,353,1419,1066
14651,1,0,13,0,-13
14652,1,1,758,1676,918
14653,0,0,41,0,-41
14654,0,0,113,0,-113
14655,1,1,192,1451,1259
14656,1,1,248,1538,1290
14657,1,1,477,1273,796
14658,0,0,5,0,-5
14659,0,0,14,0,-14
14660,0,0,17,0,-17
14661,1,0,87,0,-87
14662,1,0,14,0,-14
14663,0,0,5,0,-5
14664,0,0,198,0,-198
14665,1,0,43,0,-43
14666,1,1,159,1618,1459
14667,1,1,662,1299,637
14668,1,0,0,0,0
14669,1,0,54,0,-54
14670,0,0,11,0,-11
14671,0,0,4,0,-4
14672,0,0,19,0,-19
14673,1,0,21,0,-21
14674,1,0,59,0,-59
14675,1,1,1989,1264,-725
14676,0,0,63,0,-63
14677,0,0,49,0,-49
14678,1,0,9,0,-9
14679,0,0,18,0,-18
14680,1,0,23,0,-23
14681,0,0,38,0,-38
14682,0,0,70,0,-70
14683,0,0,10,0,-10
14684,1,0,88,0,-88
14685,0,0,63,0,-63
14686,0,0,16,0,-16
14687,0,0,18,0,-18
14688,1,0,1,0,-1
14689,0,0,7,0,-7
14690,0,0,40,0,-40
14691,1,0,52,0,-52
14692,1,0,46,0,-46
14693,1,0,92,0,-92
14694,0,0,5,0,-5
14695,1,1,204,1660,1456
14696,1,1,138,1656,1518
14697,1,1,416,1267,851
14698,1,1,140,3082,2942
14699,1,0,10,0,-10
14700,1,1,164,1267,1103
14701,0,0,15,0,-15
14702,1,0,26,0,-26
14703,1,1,461,1258,797
14704,0,0,11,0,-11
14705,0,0,47,0,-47
14706,0,0,21,0,-21
14707,0,0,7,0,-7
14708,0,0,8,0,-8
14709,1,0,64,0,-64
14710,1,1,126,3995,3869
14711,0,0,19,0,-19
14712,1,1,409,1234,825
14713,1,0,152,0,-152
14714,1,0,77,0,-77
14715,0,0,5,0,-5
14716,1,1,251,1495,1244
14717,1,1,287,1470,1183
14718,1,1,1039,3915,2876
14719,1,1,209,1432,1223
14720,1,1,625,1249,624
14721,0,0,86,0,-86
14722,1,1,583,1322,739
14723,0,0,39,0,-39
14724,0,0,56,0,-56
14725,0,0,18,0,-18
14726,1,0,7,0,-7
14727,1,1,998,1785,787
14728,1,1,706,1281,575
14729,1,0,12,0,-12
14730,1,0,26,0,-26
14731,1,1,934,1472,538
14732,1,1,214,1461,1247
14733,1,0,27,0,-27
14734,1,0,20,0,-20
14735,0,0,49,0,-49
14736,1,1,236,1718,1482
14737,1,0,96,0,-96
14738,1,1,281,1397,1116
14739,0,0,67,0,-67
14740,1,1,309,1441,1132
14741,0,0,71,0,-71
14742,1,1,28,4289,4261
14743,1,0,20,0,-20
14744,1,0,9,0,-9
14745,1,0,57,0,-57
14746,0,0,103,0,-103
14747,1,0,86,0,-86
14748,0,0,125,0,-125
14749,1,1,923,2213,1290
14750,1,0,123,0,-123
14751,1,1,90,1578,1488
14752,0,0,79,0,-79
14753,1,0,16,0,-16
14754,1,1,567,2846,2279
14755,1,0,80,0,-80
14756,1,1,1074,1260,186
14757,0,0,60,0,-60
14758,0,0,7,0,-7
14759,0,0,82,0,-82
14760,0,0,47,0,-47
14761,1,0,65,0,-65
14762,1,1,665,2933,2268
14763,1,0,43,0,-43
14764,1,0,65,0,-65
14765,1,0,5,0,-5
14766,1,1,790,1213,423
14767,1,0,15,0,-15
14768,1,1,108,1940,1832
14769,0,0,17,0,-17
14770,0,0,58,0,-58
14771,1,1,575,1253,678
14772,1,1,53,1492,1439
14773,0,0,18,0,-18
14774,1,1,71,1360,1289
14775,1,1,1555,1501,-54
14776,0,0,43,0,-43
14777,1,0,25,0,-25
14778,0,0,77,0,-77
14779,1,0,93,0,-93
14780,0,0,25,0,-25
14781,0,0,63,0,-63
14782,1,0,36,0,-36
14783,1,1,196,1441,1245
14784,0,0,22,0,-22
14785,0,0,26,0,-26
14786,0,0,117,0,-117
14787,0,0,32,0,-32
14788,1,1,1123,1512,389
14789,0,0,6,0,-6
14790,1,1,222,3705,3483
14791,1,1,1066,1371,305
14792,0,0,7,0,-7
14793,1,0,151,0,-151
14794,1,1,872,1342,470
14795,0,0,94,0,-94
14796,1,0,28,0,-28
14797,0,0,0,0,0
14798,1,1,90,1245,1155
14799,1,1,990,3409,2419
14800,1,1,1427,3529,2102
14801,0,0,107,0,-107
14802,0,0,7,0,-7
14803,1,1,1062,1280,218
14804,1,1,32,1572,1540
14805,1,1,550,1545,995
14806,0,0,11,0,-11
14807,0,0,13,0,-13
14808,0,0,93,0,-93
14809,1,1,611,1216,605
14810,0,0,8,0,-8
14811,1,1,249,1794,1545
14812,0,0,1,0,-1
14813,1,1,622,1235,613
14814,1,0,5,0,-5
14815,0,0,49,0,-49
14816,1,0,53,0,-53
14817,1,0,19,0,-19
14818,1,1,470,1848,1378
14819,1,1,158,1223,1065
14820,1,0,0,0,0
14821,0,0,154,0,-154
14822,1,0,32,0,-32
14823,1,0,20,0,-20
14824,1,0,20,0,-20
14825,1,1,1099,1336,237
14826,1,1,67,2457,2390
14827,1,1,258,1258,1000
14828,1,0,29,0,-29
14829,0,0,22,0,-22
14830,1,0,27,0,-27
14831,0,0,31,0,-31
14832,1,1,643,1203,560
14833,1,1,1262,1770,508
14834,0,0,6,0,-6
14835,0,0,17,0,-17
14836,0,0,38,0,-38
14837,1,0,35,0,-35
14838,1,1,440,1683,1243
14839,0,0,13,0,-13
14840,1,0,68,0,-68
14841,1,1,383,1887,1504
14842,1,0,13,0,-13
14843,1,1,490,1508,1018
14844,1,1,446,1320,874
14845,0,0,11,0,-11
14846,1,1,300,1279,979
14847,1,0,0,0,0
14848,1,1,811,2792,1981
14849,1,1,424,1750,1326
14850,1,1,892,2469,1577
14851,1,1,295,3766,3471
14852,1,1,413,1329,916
14853,1,0,16,0,-16
14854,1,1,976,1454,478
14855,0,0,7,0,-7
14856,0,0,16,0,-16
14857,0,0,97,0,-97
14858,1,1,72,1590,1518
14859,0,0,13,0,-13
14860,0,0,19,0,-19
14861,1,1,1269,1227,-42
14862,1,0,30,0,-30
14863,1,0,64,0,-64
14864,1,1,272,1251,979
14865,1,1,1346,3447,2101
14866,0,0,92,0,-92
14867,1,0,43,0,-43
14868,1,1,1018,1743,725
14869,1,1,315,1618,1303
14870,0,0,33,0,-33
14871,1,1,482,1204,722
14872,0,0,0,0,0
14873,1,0,6,0,-6
14874,1,1,2597,1486,-1111
14875,1,1,1638,1310,-328
14876,1,0,88,0,-88
14877,1,1,279,1506,1227
14878,0,0,87,0,-87
14879,0,0,117,0,-117
14880,1,0,39,0,-39
14881,0,0,80,0,-80
14882,0,0,6,0,-6
14883,1,1,279,1489,1210
14884,1,1,51,1639,1588
14885,1,1,732,1253,521
14886,1,0,10,0,-10
14887,1,0,0,0,0
14888,1,0,10,0,-10
14889,1,1,362,1604,1242
14890,0,0,306,0,-306
14891,0,0,21,0,-21
14892,0,0,55,0,-55
14893,1,0,9,0,-9
14894,0,0,63,0,-63
14895,1,1,452,1335,883
14896,1,1,783,1639,856
14897,1,1,296,1238,942
14898,1,0,83,0,-83
14899,0,0,23,0,-23
14900,0,0,29,0,-29
14901,0,0,59,0,-59
14902,1,0,60,0,-60
14903,1,1,63,1472,1409
14904,0,0,275,0,-275
14905,0,0,88,0,-88
14906,1,1,233,1742,1509
14907,1,1,473,1282,809
14908,1,1,744,2304,1560
14909,1,1,442,1396,954
14910,1,0,51,0,-51
14911,1,1,633,1203,570
14912,1,0,26,0,-26
14913,0,0,11,0,-11
14914,0,0,9,0,-9
14915,1,1,507,1515,1008
14916,1,0,22,0,-22
14917,0,0,74,0,-74
14918,1,0,56,0,-56
14919,1,1,153,1217,1064
14920,1,0,42,0,-42
14921,0,0,58,0,-58
14922,1,1,338,2079,1741
14923,0,0,0,0,0
14924,1,0,74,0,-74
14925,0,0,20,0,-20
14926,1,0,3,0,-3
14927,0,0,193,0,-193
14928,1,1,891,1835,944
14929,1,0,17,0,-17
14930,1,1,193,1409,1216
14931,1,1,619,1891,1272
14932,1,0,22,0,-22
14933,1,1,208,1300,1092
14934,0,0,3,0,-3
14935,1,0,1,0,-1
14936,0,0,6,0,-6
14937,1,1,376,1496,1120
14938,1,0,4,0,-4
14939,1,0,116,0,-116
14940,1,1,88,1334,1246
14941,1,0,74,0,-74
14942,1,0,11,0,-11
14943,0,0,4,0,-4
14944,0,0,16,0,-16
14945,0,0,19,0,-19
14946,1,1,401,1326,925
14947,0,0,51,0,-51
14948,1,1,153,3078,2925
14949,0,0,74,0,-74
14950,0,0,171,0,-171
14951,1,0,21,0,-21
14952,1,0,31,0,-31
14953,1,0,17,0,-17
14954,0,0,92,0,-92
14955,0,0,1,0,-1
14956,1,0,88,0,-88
14957,1,1,310,1805,1495
14958,1,1,1051,1293,242
14959,1,1,235,1852,1617
14960,1,0,146,0,-146
14961,0,0,5,0,-5
14962,1,0,147,0,-147
14963,0,0,13,0,-13
14964,1,0,137,0,-137
14965,1,1,346,2106,1760
14966,0,0,169,0,-169
14967,1,1,1178,2559,1381
14968,1,1,270,1437,1167
14969,0,0,1,0,-1
14970,0,0,7,0,-7
14971,0,0,266,0,-266
14972,1,0,6,0,-6
14973,1,0,52,0,-52
14974,1,1,361,1314,953
14975,1,1,720,1712,992
14976,1,0,11,0,-11
14977,1,1,228,1381,1153
14978,1,0,24,0,-24
14979,1,1,940,1483,543
14980,0,0,203,0,-203
14981,1,0,3,0,-3
14982,1,1,284,1444,1160
14983,1,0,14,0,-14
14984,1,1,295,1204,909
14985,1,1,799,1569,770
14986,1,1,594,1240,646
14987,1,1,26,1805,1779
14988,0,0,58,0,-58
14989,1,0,14,0,-14
14990,0,0,63,0,-63
14991,0,0,81,0,-81
14992,1,1,417,1591,1174
14993,1,1,36,1300,1264
14994,1,0,11,0,-11
14995,0,0,52,0,-52
14996,1,0,16,0,-16
14997,1,1,142,1248,1106
14998,0,0,1,0,-1
14999,0,0,17,0,-17
15000,0,0,6,0,-6
15001,0,0,20,0,-20
15002,0,0,120,0,-120
15003,0,0,127,0,-127
15004,1,1,164,1214,1050
15005,0,0,50,0,-50
15006,0,0,23,0,-23
15007,1,1,108,2165,2057
15008,1,1,1112,1670,558
15009,0,0,187,0,-187
15010,0,0,65,0,-65
15011,1,0,6,0,-6
15012,0,0,288,0,-288
15013,0,0,54,0,-54
15014,1,0,55,0,-55
15015,1,0,9,0,-9
15016,1,1,719,1368,649
15017,1,1,197,1719,1522
15018,1,1,218,1527,1309
15019,1,1,402,1280,878
15020,0,0,29,0,-29
15021,1,1,286,1541,1255
15022,1,1,1299,1260,-39
15023,1,1,162,1764,1602
15024,0,0,19,0,-19
15025,1,0,23,0,-23
15026,0,0,113,0,-113
15027,1,1,803,1429,626
15028,1,0,40,0,-40
15029,1,1,106,1333,1227
15030,0,0,53,0,-53
15031,1,0,45,0,-45
15032,0,0,73,0,-73
15033,1,1,214,1617,1403
15034,1,0,13,0,-13
15035,1,1,1121,1653,532
15036,0,0,88,0,-88
15037,1,0,77,0,-77
15038,0,0,79,0,-79
15039,0,0,31,0,-31
15040,1,1,484,1202,718
15041,1,0,10,0,-10
15042,1,1,336,1574,1238
15043,1,0,134,0,-134
15044,1,0,39,0,-39
15045,1,1,409,1225,816
15046,1,1,205,1690,1485
15047,1,1,2831,2565,-266
15048,1,0,32,0,-32
15049,1,1,249,1400,1151
15050,1,1,367,1904,1537
15051,1,0,24,0,-24
15052,1,1,1108,1440,332
15053,1,0,36,0,-36
15054,0,0,111,0,-111
15055,0,0,65,0,-65
15056,1,0,165,0,-165
15057,0,0,12,0,-12
15058,1,1,128,1627,1499
15059,1,0,125,0,-125
15060,0,0,10,0,-10
15061,1,1,415,1352,937
15062,1,0,126,0,-126
15063,1,1,412,1295,883
15064,1,1,147,1647,1500
15065,0,0,119,0,-119
15066,1,0,1,0,-1
15067,1,1,598,1418,820
15068,0,0,50,0,-50
15069,1,1,27,1878,1851
15070,1,0,143,0,-143
15071,1,1,351,1253,902
15072,0,0,24,0,-24
15073,1,1,52,1861,1809
15074,0,0,4,0,-4
15075,1,0,7,0,-7
15076,1,0,49,0,-49
15077,1,0,10,0,-10
15078,1,0,19,0,-19
15079,0,0,33,0,-33
15080,1,0,31,0,-31
15081,1,1,1942,1557,-385
15082,1,0,34,0,-34
15083,1,1,193,1247,1054
15084,1,1,598,1344,746
15085,0,0,33,0,-33
15086,1,0,16,0,-16
15087,0,0,23,0,-23
15088,0,0,103,0,-103
15089,1,1,491,1740,1249
15090,0,0,82,0,-82
15091,1,1,246,1227,981
15092,0,0,164,0,-164
15093,1,0,30,0,-30
15094,0,0,84,0,-84
15095,1,1,604,1743,1139
15096,0,0,12,0,-12
15097,1,0,12,0,-12
15098,1,0,159,0,-159
15099,1,0,20,0,-20
15100,0,0,19,0,-19
15101,1,1,630,1230,600
15102,1,1,684,1355,671
15103,1,0,98,0,-98
15104,0,0,35,0,-35
15105,1,1,235,1252,1017
15106,0,0,55,0,-55
15107,0,0,2,0,-2
15108,1,0,19,0,-19
15109,1,1,28,1217,1189
15110,1,1,527,2891,2364
15111,1,0,44,0,-44
15112,1,0,26,0,-26
15113,1,0,141,0,-141
15114,1,0,18,0,-18
15115,1,0,23,0,-23
15116,0,0,8,0,-8
15117,0,0,147,0,-147
15118,1,0,65,0,-65
15119,1,0,30,0,-30
15120,0,0,165,0,-165
15121,1,1,1143,1380,237
15122,0,0,31,0,-31
15123,0,0,11,0,-11
15124,0,0,14,0,-14
15125,1,1,194,1908,1714
15126,1,0,25,0,-25
15127,1,1,96,1354,1258
15128,1,0,91,0,-91
15129,1,0,136,0,-136
15130,1,1,490,1207,717
15131,1,1,429,1253,824
15132,0,0,41,0,-41
15133,0,0,177,0,-177
15134,0,0,0,0,0
15135,1,0,88,0,-88
15136,0,0,31,0,-31
15137,1,1,824,1291,467
15138,1,1,1655,1545,-110
15139,0,0,1,0,-1
15140,1,0,38,0,-38
15141,0,0,8,0,-8
15142,1,1,618,1607,989
15143,0,0,41,0,-41
15144,1,0,18,0,-18
15145,1,0,64,0,-64
15146,1,1,310,1272,962
15147,0,0,55,0,-55
15148,1,0,1,0,-1
15149,1,1,327,1437,1110
15150,1,1,978,1608,630
15151,1,0,132,0,-132
15152,1,0,392,0,-392
15153,0,0,19,0,-19
15154,1,1,68,1614,1546
15155,0,0,3,0,-3
15156,1,1,732,1311,579
15157,1,1,279,1347,1068
15158,1,0,70,0,-70
15159,1,0,32,0,-32
15160,1,1,1106,2014,908
15161,0,0,78,0,-78
15162,0,0,56,0,-56
15163,0,0,49,0,-49
15164,0,0,90,0,-90
15165,1,1,165,1301,1136
15166,1,1,274,1278,1004
15167,0,0,27,0,-27
15168,1,0,14,0,-14
15169,0,0,177,0,-177
15170,0,0,104,0,-104
15171,0,0,0,0,0
15172,1,1,948,1537,589
15173,1,0,29,0,-29
15174,1,0,125,0,-125
15175,1,1,857,1675,818
15176,1,0,30,0,-30
15177,0,0,3,0,-3
15178,1,1,623,1570,947
15179,0,0,51,0,-51
15180,1,0,10,0,-10
15181,1,1,278,1353,1075
15182,1,0,16,0,-16
15183,0,0,25,0,-25
15184,0,0,84,0,-84
15185,1,1,97,1341,1244
15186,0,0,48,0,-48
15187,1,0,25,0,-25
15188,0,0,70,0,-70
15189,0,0,13,0,-13
15190,1,0,14,0,-14
15191,1,0,42,0,-42
15192,1,1,593,1493,900
15193,0,0,56,0,-56
15194,1,1,574,1319,745
15195,0,0,41,0,-41
15196,0,0,36,0,-36
15197,0,0,4,0,-4
15198,1,1,67,1234,1167
15199,1,0,74,0,-74
15200,1,0,22,0,-22
15201,1,1,57,1322,1265
15202,1,0,64,0,-64
15203,1,1,356,1412,1056
15204,1,0,42,0,-42
15205,1,0,3,0,-3
15206,0,0,45,0,-45
15207,1,0,16,0,-16
15208,1,1,697,1826,1129
15209,0,0,26,0,-26
15210,1,1,545,1736,1191
15211,1,1,798,1900,1102
15212,0,0,44,0,-44
15213,0,0,35,0,-35
15214,1,1,183,1544,1361
15215,1,1,727,1291,564
15216,0,0,2,0,-2
15217,0,0,131,0,-131
15218,1,1,89,3514,3425
15219,1,1,283,1635,1352
15220,1,1,419,1632,1213
15221,1,0,78,0,-78
15222,1,0,41,0,-41
15223,1,0,65,0,-65
15224,0,0,54,0,-54
15225,0,0,2,0,-2
15226,1,0,8,0,-8
15227,0,0,58,0,-58
15228,0,0,4,0,-4
15229,1,0,74,0,-74
15230,1,0,14,0,-14
15231,1,0,28,0,-28
15232,1,1,183,1441,1258
15233,0,0,120,0,-120
15234,1,1,273,1423,1150
15235,0,0,35,0,-35
15236,0,0,67,0,-67
15237,1,0,14,0,-14
15238,0,0,3,0,-3
15239,1,1,466,1402,936
15240,1,0,77,0,-77
15241,0,0,69,0,-69
15242,0,0,37,0,-37
15243,0,0,1,0,-1
15244,1,1,558,1388,830
15245,0,0,52,0,-52
15246,1,1,127,1432,1305
15247,1,1,1691,1473,-218
15248,0,0,334,0,-334
15249,1,0,16,0,-16
15250,0,0,45,0,-45
15251,1,0,71,0,-71
15252,0,0,64,0,-64
15253,0,0,125,0,-125
15254,0,0,4,0,-4
15255,1,1,276,1595,1319
15256,1,1,73,1322,1249
15257,1,0,12,0,-12
15258,0,0,152,0,-152
15259,1,1,149,1348,1199
15260,1,0,64,0,-64
15261,1,0,4,0,-4
15262,1,1,1092,2326,1234
15263,1,0,24,0,-24
15264,1,1,881,1537,656
15265,0,0,36,0,-36
15266,1,1,201,1870,1669
15267,0,0,68,0,-68
15268,1,1,402,2222,1820
15269,1,0,38,0,-38
15270,1,0,64,0,-64
15271,1,0,127,0,-127
15272,0,0,84,0,-84
15273,0,0,40,0,-40
15274,0,0,55,0,-55
15275,0,0,70,0,-70
15276,0,0,26,0,-26
15277,1,0,20,0,-20
15278,0,0,4,0,-4
15279,0,0,28,0,-28
15280,1,0,16,0,-16
15281,1,1,496,1279,783
15282,1,1,130,1215,1085
15283,1,1,627,2983,2356
15284,0,0,92,0,-92
15285,0,0,48,0,-48
15286,0,0,4,0,-4
15287,1,1,99,1215,1116
15288,0,0,211,0,-211
15289,1,0,110,0,-110
15290,1,1,570,1492,922
15291,0,0,43,0,-43
15292,0,0,3,0,-3
15293,0,0,42,0,-42
15294,1,0,76,0,-76
15295,1,1,144,1291,1147
15296,1,1,605,1812,1207
15297,1,1,344,1236,892
15298,1,0,181,0,-181
15299,0,0,162,0,-162
15300,1,1,109,1417,1308
15301,0,0,14,0,-14
15302,1,0,20,0,-20
15303,0,0,10,0,-10
15304,0,0,23,0,-23
15305,1,1,298,1234,936
15306,0,0,55,0,-55
15307,1,0,166,0,-166
15308,0,0,43,0,-43
15309,1,0,38,0,-38
15310,1,0,35,0,-35
15311,0,0,12,0,-12
15312,1,1,1060,1259,199
15313,0,0,2,0,-2
15314,0,0,15,0,-15
15315,1,0,42,0,-42
15316,0,0,33,0,-33
15317,0,0,34,0,-34
15318,1,1,1543,1541,-2
15319,1,0,136,0,-136
15320,1,0,91,0,-91
15321,1,0,81,0,-81
15322,1,1,496,1217,721
15323,1,1,241,1295,1054
15324,1,1,810,1529,719
15325,1,0,8,0,-8
15326,1,0,5,0,-5
15327,0,0,4,0,-4
15328,0,0,114,0,-114
15329,1,0,47,0,-47
15330,1,1,289,1746,1457
15331,0,0,5,0,-5
15332,1,0,3,0,-3
15333,0,0,58,0,-58
15334,0,0,49,0,-49
15335,1,0,13,0,-13
15336,0,0,351,0,-351
15337,1,0,17,0,-17
15338,1,0,8,0,-8
15339,1,0,24,0,-24
15340,1,0,7,0,-7
15341,0,0,111,0,-111
15342,1,0,14,0,-14
15343,1,0,62,0,-62
15344,0,0,68,0,-68
15345,0,0,50,0,-50
15346,1,0,32,0,-32
15347,0,0,34,0,-34
15348,0,0,15,0,-15
15349,1,0,69,0,-69
15350,0,0,47,0,-47
15351,0,0,11,0,-11
15352,0,0,124,0,-124
15353,1,1,786,5187,4401
15354,0,0,19,0,-19
15355,1,0,31,0,-31
15356,0,0,71,0,-71
15357,1,0,102,0,-102
15358,0,0,27,0,-27
15359,0,0,11,0,-11
15360,1,0,28,0,-28
15361,1,1,294,1254,960
15362,0,0,80,0,-80
15363,1,1,981,1304,323
15364,0,0,22,0,-22
15365,1,1,823,1417,594
15366,1,0,50,0,-50
15367,0,0,86,0,-86
15368,1,1,376,1640,1264
15369,0,0,11,0,-11
15370,1,0,21,0,-21
15371,1,0,8,0,-8
15372,0,0,17,0,-17
15373,0,0,48,0,-48
15374,0,0,20,0,-20
15375,1,1,599,1599,1000
15376,0,0,41,0,-41
15377,1,1,371,7437,7066
15378,1,0,17,0,-17
15379,0,0,11,0,-11
15380,0,0,50,0,-50
15381,1,1,766,1351,585
15382,1,0,56,0,-56
15383,1,1,175,1296,1121
15384,0,0,0,0,0
15385,0,0,36,0,-36
15386,1,1,21,1240,1219
15387,1,1,571,1239,668
15388,0,0,9,0,-9
15389,0,0,7,0,-7
15390,1,0,12,0,-12
15391,1,1,614,1220,606
15392,1,1,161,1350,1189
15393,1,0,36,0,-36
15394,1,0,285,0,-285
15395,1,1,448,1226,778
15396,1,1,81,1204,1123
15397,1,0,29,0,-29
15398,1,1,163,1292,1129
15399,1,1,115,1297,1182
15400,1,1,885,1204,319
15401,1,1,739,1554,815
15402,0,0,16,0,-16
15403,0,0,117,0,-117
15404,0,0,125,0,-125
15405,1,0,18,0,-18
15406,0,0,6,0,-6
15407,0,0,155,0,-155
15408,1,0,49,0,-49
15409,1,0,1,0,-1
15410,0,0,59,0,-59
15411,0,0,34,0,-34
15412,1,1,686,1662,976
15413,1,1,1265,1232,-33
15414,1,0,1,0,-1
15415,0,0,81,0,-81
15416,1,1,680,1398,718
15417,0,0,1,0,-1
15418,0,0,30,0,-30
15419,1,0,76,0,-76
15420,0,0,75,0,-75
15421,1,0,71,0,-71
15422,0,0,4,0,-4
15423,0,0,141,0,-141
15424,1,1,367,2563,2196
15425,0,0,92,0,-92
15426,1,0,113,0,-113
15427,1,1,634,1664,1030
15428,0,0,23,0,-23
15429,1,1,1096,1341,245
15430,0,0,88,0,-88
15431,1,0,53,0,-53
15432,1,0,40,0,-40
15433,0,0,17,0,-17
15434,0,0,3,0,-3
15435,0,0,13,0,-13
15436,0,0,2,0,-2
15437,0,0,24,0,-24
15438,1,1,450,2073,1623
15439,1,1,188,1537,1349
15440,1,1,122,1456,1334
15441,0,0,3,0,-3
15442,1,0,94,0,-94
15443,1,1,369,1297,928
15444,1,1,33,1373,1340
15445,1,1,334,1319,985
15446,0,0,71,0,-71
15447,1,0,64,0,-64
15448,1,0,8,0,-8
15449,1,0,74,0,-74
15450,1,1,62,1208,1146
15451,0,0,11,0,-11
15452,1,0,68,0,-68
15453,0,0,84,0,-84
15454,0,0,76,0,-76
15455,1,0,60,0,-60
15456,1,1,272,1429,1157
15457,1,0,22,0,-22
15458,0,0,66,0,-66
15459,0,0,3,0,-3
15460,0,0,64,0,-64
15461,0,0,65,0,-65
15462,0,0,139,0,-139
15463,0,0,9,0,-9
15464,1,1,796,3105,2309
15465,0,0,46,0,-46
15466,0,0,24,0,-24
15467,1,0,70,0,-70
15468,1,0,103,0,-103
15469,1,0,4,0,-4
15470,1,0,190,0,-190
15471,0,0,13,0,-13
15472,0,0,48,0,-48
15473,0,0,0,0,0
15474,1,1,411,1247,836
15475,1,0,49,0,-49
15476,1,0,49,0,-49
15477,1,0,42,0,-42
15478,0,0,24,0,-24
15479,1,0,8,0,-8
15480,1,0,194,0,-194
15481,1,1,2004,1477,-527
15482,0,0,17,0,-17
15483,0,0,25,0,-25
15484,1,1,192,1510,1318
15485,1,1,1079,1636,557
15486,1,1,76,1298,1222
15487,1,0,93,0,-93
15488,1,1,574,2059,1485
15489,1,1,363,2619,2256
15490,1,0,29,0,-29
15491,1,1,293,1280,987
15492,0,0,52,0,-52
15493,1,1,71,1241,1170
15494,1,0,226,0,-226
15495,1,0,10,0,-10
15496,0,0,64,0,-64
15497,1,1,758,1535,777
15498,1,0,21,0,-21
15499,1,1,714,1902,1188
15500,0,0,48,0,-48
15501,1,0,20,0,-20
15502,1,1,773,1368,595
15503,0,0,4,0,-4
15504,0,0,46,0,-46
15505,1,0,88,0,-88
15506,1,0,296,0,-296
15507,1,1,392,1338,946
15508,1,1,31,1660,1629
15509,0,0,1,0,-1
15510,1,0,58,0,-58
15511,1,0,47,0,-47
15512,0,0,177,0,-177
15513,0,0,48,0,-48
15514,0,0,13,0,-13
15515,1,0,46,0,-46
15516,1,1,83,1278,1195
15517,1,1,385,1495,1110
15518,0,0,21,0,-21
15519,0,0,51,0,-51
15520,0,0,175,0,-175
15521,0,0,120,0,-120
15522,1,0,55,0,-55
15523,0,0,7,0,-7
15524,0,0,55,0,-55
15525,0,0,31,0,-31
15526,1,1,697,1440,743
15527,1,0,27,0,-27
15528,1,0,14,0,-14
15529,0,0,21,0,-21
15530,0,0,3,0,-3
15531,1,0,171,0,-171
15532,1,1,393,1318,925
15533,1,1,915,1419,504
15534,0,0,2,0,-2
15535,0,0,27,0,-27
15536,1,0,8,0,-8
15537,1,0,81,0,-81
15538,1,0,24,0,-24
15539,1,0,103,0,-103
15540,1,1,396,2338,1942
15541,1,0,230,0,-230
15542,1,0,208,0,-208
15543,1,1,162,1202,1040
15544,1,1,225,1445,1220
15545,1,1,183,1278,1095
15546,0,0,4,0,-4
15547,0,0,100,0,-100
15548,1,1,646,2913,2267
15549,1,0,7,0,-7
15550,1,0,244,0,-244
15551,0,0,5,0,-5
15552,1,1,1144,2355,1211
15553,0,0,78,0,-78
15554,1,1,658,1241,583
15555,0,0,64,0,-64
15556,0,0,5,0,-5
15557,1,0,16,0,-16
15558,1,1,1355,1239,-116
15559,1,1,201,2371,2170
15560,0,0,65,0,-65
15561,0,0,29,0,-29
15562,1,1,4437,1714,-2723
15563,1,1,508,1211,703
15564,1,1,307,3733,3426
15565,0,0,4,0,-4
15566,0,0,95,0,-95
15567,1,1,78,1293,1215
15568,0,0,8,0,-8
15569,0,0,22,0,-22
15570,0,0,2,0,-2
15571,0,0,113,0,-113
15572,1,0,3,0,-3
15573,0,0,66,0,-66
15574,0,0,51,0,-51
15575,1,0,1,0,-1
15576,1,0,82,0,-82
15577,1,1,730,1968,1238
15578,1,0,9,0,-9
15579,1,0,1,0,-1
15580,0,0,44,0,-44
15581,1,0,42,0,-42
15582,0,0,15,0,-15
15583,0,0,7,0,-7
15584,1,0,61,0,-61
15585,1,1,977,1294,317
15586,1,1,98,1305,1207
15587,0,0,41,0,-41
15588,1,1,266,1202,936
15589,1,1,200,1931,1731
15590,0,0,60,0,-60
15591,1,0,61,0,-61
15592,1,0,33,0,-33
15593,1,0,12,0,-12
15594,0,0,6,0,-6
15595,1,0,101,0,-101
15596,0,0,30,0,-30
15597,0,0,9,0,-9
15598,0,0,145,0,-145
15599,0,0,20,0,-20
15600,1,1,867,1305,438
15601,1,0,17,0,-17
15602,1,0,16,0,-16
15603,1,1,604,1345,741
15604,1,0,17,0,-17
15605,0,0,11,0,-11
15606,1,0,13,0,-13
15607,1,1,165,1840,1675
15608,1,1,412,1819,1407
15609,0,0,24,0,-24
15610,0,0,72,0,-72
15611,0,0,34,0,-34
15612,1,1,811,1412,601
15613,0,0,18,0,-18
15614,1,0,24,0,-24
15615,1,1,586,1419,833
15616,0,0,16,0,-16
15617,1,1,1658,1267,-391
15618,1,0,151,0,-151
15619,1,1,209,1549,1340
15620,1,0,20,0,-20
15621,1,1,175,1656,1481
15622,1,1,599,1237,638
15623,0,0,39,0,-39
15624,1,0,36,0,-36
15625,1,1,1169,1200,31
15626,0,0,37,0,-37
15627,1,1,546,1362,816
15628,1,0,46,0,-46
15629,1,0,19,0,-19
15630,0,0,5,0,-5
15631,0,0,33,0,-33
15632,0,0,121,0,-121
15633,0,0,28,0,-28
15634,0,0,19,0,-19
15635,1,1,213,1200,987
15636,0,0,21,0,-21
15637,1,1,668,1236,568
15638,1,1,1098,1291,193
15639,1,0,14,0,-14
15640,1,0,14,0,-14
15641,0,0,50,0,-50
15642,0,0,7,0,-7
15643,1,0,28,0,-28
15644,1,1,157,1734,1577
15645,1,1,387,2212,1825
15646,1,1,605,1449,844
15647,0,0,4,0,-4
15648,0,0,58,0,-58
15649,0,0,51,0,-51
15650,0,0,129,0,-129
15651,0,0,28,0,-28
15652,0,0,4,0,-4
15653,0,0,40,0,-40
15654,0,0,21,0,-21
15655,0,0,90,0,-90
15656,1,0,120,0,-120
15657,1,1,1626,1553,-73
15658,1,1,424,1843,1419
15659,1,0,15,0,-15
15660,0,0,4,0,-4
15661,1,1,189,1863,1674
15662,0,0,68,0,-68
15663,1,1,910,1409,499
15664,1,0,72,0,-72
15665,1,1,64,1355,1291
15666,0,0,239,0,-239
15667,1,1,470,1225,755
15668,1,0,28,0,-28
15669,0,0,97,0,-97
15670,1,0,0,0,0
15671,1,1,974,1689,715
15672,0,0,131,0,-131
15673,0,0,24,0,-24
15674,0,0,2,0,-2
15675,1,0,27,0,-27
15676,0,0,16,0,-16
15677,1,0,9,0,-9
15678,1,1,780,1437,657
15679,1,1,661,1596,935
15680,1,0,261,0,-261
15681,0,0,126,0,-126
15682,1,1,526,1832,1306
15683,1,1,153,1535,1382
15684,0,0,50,0,-50
15685,0,0,19,0,-19
15686,1,0,9,0,-9
15687,1,1,516,2209,1693
15688,1,1,76,1376,1300
15689,1,0,126,0,-126
15690,0,0,9,0,-9
15691,0,0,27,0,-27
15692,1,0,14,0,-14
15693,0,0,49,0,-49
15694,0,0,53,0,-53
15695,0,0,11,0,-11
15696,1,1,1186,2080,894
15697,1,0,50,0,-50
15698,1,1,2254,1765,-489
15699,1,0,248,0,-248
15700,1,1,575,1404,829
15701,0,0,136,0,-136
15702,1,1,124,1232,1108
15703,0,0,49,0,-49
15704,1,0,7,0,-7
15705,0,0,0,0,0
15706,0,0,59,0,-59
15707,1,1,135,1858,1723
15708,1,1,185,3855,3670
15709,1,1,424,1229,805
15710,0,0,20,0,-20
15711,1,1,314,1499,1185
15712,1,0,215,0,-215
15713,1,1,115,1577,1462
15714,0,0,55,0,-55
15715,1,0,223,0,-223
15716,0,0,42,0,-42
15717,0,0,29,0,-29
15718,0,0,10,0,-10
15719,0,0,42,0,-42
15720,1,1,165,3129,2964
15721,0,0,36,0,-36
15722,1,0,7,0,-7
15723,0,0,127,0,-127
15724,0,0,11,0,-11
15725,1,1,2134,1907,-227
15726,1,1,341,3342,3001
15727,1,1,217,1249,1032
15728,0,0,11,0,-11
15729,1,1,211,1763,1552
15730,0,0,2,0,-2
15731,0,0,105,0,-105
15732,1,1,460,1356,896
15733,1,1,379,1334,955
15734,1,0,12,0,-12
15735,1,0,166,0,-166
15736,0,0,29,0,-29
15737,1,0,2,0,-2
15738,1,0,28,0,-28
15739,0,0,92,0,-92
15740,0,0,7,0,-7
15741,0,0,72,0,-72
15742,0,0,40,0,-40
15743,0,0,125,0,-125
15744,0,0,1,0,-1
15745,1,1,327,1244,917
15746,0,0,25,0,-25
15747,0,0,36,0,-36
15748,0,0,56,0,-56
15749,0,0,57,0,-57
15750,1,1,770,1821,1051
15751,0,0,53,0,-53
15752,1,0,55,0,-55
15753,1,1,485,1391,906
15754,1,0,89,0,-89
15755,1,1,770,1262,492
15756,0,0,75,0,-75
15757,0,0,31,0,-31
15758,1,0,39,0,-39
15759,1,1,552,1213,661
15760,1,1,214,2204,1990
15761,1,1,975,1409,434
15762,0,0,6,0,-6
15763,0,0,3,0,-3
15764,0,0,83,0,-83
15765,1,1,76,1262,1186
15766,0,0,8,0,-8
15767,1,0,57,0,-57
15768,0,0,49,0,-49
15769,0,0,59,0,-59
15770,1,0,4,0,-4
15771,1,1,237,2440,2203
15772,0,0,57,0,-57
15773,0,0,33,0,-33
15774,0,0,73,0,-73
15775,0,0,36,0,-36
15776,0,0,147,0,-147
15777,1,1,238,1289,1051
15778,0,0,25,0,-25
15779,1,1,574,1588,1014
15780,0,0,38,0,-38
15781,1,1,784,2144,1360
15782,1,0,3,0,-3
15783,1,0,43,0,-43
15784,1,0,129,0,-129
15785,1,0,30,0,-30
15786,0,0,13,0,-13
15787,0,0,10,0,-10
15788,0,0,107,0,-107
15789,1,1,536,1257,721
15790,1,1,139,1432,1293
15791,1,0,95,0,-95
15792,1,1,249,1569,1320
15793,0,0,121,0,-121
15794,1,0,62,0,-62
15795,1,1,818,1402,584
15796,0,0,27,0,-27
15797,0,0,9,0,-9
15798,1,1,1174,1250,76
15799,0,0,23,0,-23
15800,1,0,17,0,-17
15801,0,0,0,0,0
15802,0,0,27,0,-27
15803,1,1,955,1317,362
15804,1,0,0,0,0
15805,1,1,222,1245,1023
15806,1,0,8,0,-8
15807,1,0,64,0,-64
15808,0,0,46,0,-46
15809,1,1,107,1655,1548
15810,0,0,12,0,-12
15811,1,1,216,1336,1120
15812,1,0,120,0,-120
15813,1,0,1,0,-1
15814,1,1,490,1232,742
15815,1,1,282,1354,1072
15816,1,0,6,0,-6
15817,1,0,0,0,0
15818,1,1,704,1248,544
15819,0,0,8,0,-8
15820,0,0,28,0,-28
15821,1,0,3,0,-3
15822,1,0,3,0,-3
15823,1,1,1200,1666,466
15824,1,0,6,0,-6
15825,0,0,21,0,-21
15826,0,0,26,0,-26
15827,0,0,86,0,-86
15828,0,0,6,0,-6
15829,1,1,694,1208,514
15830,1,1,248,1339,1091
15831,0,0,48,0,-48
15832,1,1,670,1332,662
15833,0,0,48,0,-48
15834,1,1,1108,1486,378
15835,1,1,849,1204,355
15836,0,0,9,0,-9
15837,0,0,93,0,-93
15838,0,0,67,0,-67
15839,0,0,10,0,-10
15840,1,0,21,0,-21
15841,0,0,8,0,-8
15842,1,0,6,0,-6
15843,0,0,11,0,-11
15844,1,1,92,2386,2294
15845,0,0,63,0,-63
15846,1,0,0,0,0
15847,1,0,5,0,-5
15848,0,0,6,0,-6
15849,0,0,60,0,-60
15850,1,1,41,1644,1603
15851,0,0,89,0,-89
15852,1,0,14,0,-14
15853,1,0,18,0,-18
15854,1,1,600,1676,1076
15855,0,0,27,0,-27
15856,0,0,107,0,-107
15857,1,0,20,0,-20
15858,0,0,30,0,-30
15859,0,0,40,0,-40
15860,1,1,23,1795,1772
15861,0,0,37,0,-37
15862,1,1,78,1256,1178
15863,1,1,222,1267,1045
15864,1,1,517,1276,759
15865,0,0,54,0,-54
15866,1,0,8,0,-8
15867,1,1,372,1440,1068
15868,0,0,141,0,-141
15869,1,0,25,0,-25
15870,1,0,17,0,-17
15871,0,0,21,0,-21
15872,1,1,792,1356,564
15873,1,1,565,2428,1863
15874,1,1,124,1350,1226
15875,1,0,68,0,-68
15876,0,0,49,0,-49
15877,0,0,39,0,-39
15878,1,0,9,0,-9
15879,0,0,16,0,-16
15880,1,1,1112,1395,283
15881,1,1,294,1409,1115
15882,1,1,120,2097,1977
15883,0,0,75,0,-75
15884,0,0,85,0,-85
15885,0,0,7,0,-7
15886,0,0,21,0,-21
15887,1,0,19,0,-19
15888,0,0,41,0,-41
15889,0,0,0,0,0
15890,1,0,73,0,-73
15891,1,1,118,2283,2165
15892,0,0,10,0,-10
15893,1,0,93,0,-93
15894,1,0,7,0,-7
15895,1,1,687,1241,554
15896,1,1,127,1210,1083
15897,1,1,1289,1503,214
15898,0,0,19,0,-19
15899,1,0,53,0,-53
15900,1,0,7,0,-7
15901,1,0,0,0,0
15902,1,1,326,1271,945
15903,1,0,47,0,-47
15904,1,1,164,1578,1414
15905,1,1,1145,2306,1161
15906,1,0,24,0,-24
15907,0,0,46,0,-46
15908,0,0,176,0,-176
15909,1,0,21,0,-21
15910,1,1,544,2036,1492
15911,0,0,17,0,-17
15912,0,0,26,0,-26
15913,1,0,8,0,-8
15914,0,0,34,0,-34
15915,0,0,12,0,-12
15916,1,0,28,0,-28
15917,1,1,113,1505,1392
15918,1,0,1,0,-1
15919,1,1,1579,1704,125
15920,1,1,64,1951,1887
15921,1,0,44,0,-44
15922,0,0,26,0,-26
15923,0,0,263,0,-263
15924,1,0,2,0,-2
15925,1,1,87,2122,2035
15926,1,0,55,0,-55
15927,0,0,13,0,-13
15928,1,1,891,2609,1718
15929,0,0,17,0,-17
15930,1,1,467,2231,1764
15931,0,0,95,0,-95
15932,1,1,378,1218,840
15933,0,0,6,0,-6
15934,1,1,916,1251,335
15935,1,1,405,1245,840
15936,0,0,27,0,-27
15937,1,0,12,0,-12
15938,0,0,81,0,-81
15939,1,0,8,0,-8
15940,0,0,16,0,-16
15941,0,0,22,0,-22
15942,0,0,20,0,-20
15943,1,0,116,0,-116
15944,0,0,19,0,-19
15945,1,1,2001,1389,-612
15946,1,1,35,1262,1227
15947,0,0,1,0,-1
15948,1,1,162,1470,1308
15949,0,0,40,0,-40
15950,1,0,68,0,-68
15951,1,0,37,0,-37
15952,1,0,26,0,-26
15953,1,1,276,1502,1226
15954,1,0,16,0,-16
15955,0,0,20,0,-20
15956,1,1,382,1215,833
15957,1,0,123,0,-123
15958,0,0,161,0,-161
15959,0,0,4,0,-4
15960,0,0,141,0,-141
15961,1,1,109,1383,1274
15962,0,0,48,0,-48
15963,0,0,142,0,-142
15964,1,0,82,0,-82
15965,0,0,23,0,-23
15966,1,1,165,1517,1352
15967,0,0,74,0,-74
15968,0,0,108,0,-108
15969,1,0,85,0,-85
15970,0,0,44,0,-44
15971,1,0,88,0,-88
15972,1,0,99,0,-99
15973,0,0,33,0,-33
15974,0,0,16,0,-16
15975,0,0,81,0,-81
15976,1,1,168,1347,1179
15977,1,1,82,1360,1278
15978,1,1,1865,1569,-296
15979,1,0,5,0,-5
15980,1,0,154,0,-154
15981,1,1,369,1752,1383
15982,0,0,17,0,-17
15983,1,0,214,0,-214
15984,1,0,7,0,-7
15985,1,0,40,0,-40
15986,0,0,29,0,-29
15987,0,0,5,0,-5
15988,1,0,13,0,-13
15989,1,0,7,0,-7
15990,0,0,76,0,-76
15991,1,1,200,1476,1276
15992,1,1,201,1348,1147
15993,1,1,172,1548,1376
15994,1,0,4,0,-4
15995,1,0,26,0,-26
15996,1,0,41,0,-41
15997,1,0,75,0,-75
15998,0,0,19,0,-19
15999,0,0,61,0,-61
16000,0,0,9,0,-9
16001,1,1,1001,2420,1419
16002,1,1,331,1696,1365
16003,1,0,7,0,-7
16004,0,0,70,0,-70
16005,1,1,885,1448,563
16006,0,0,54,0,-54
16007,1,0,149,0,-149
16008,1,1,189,1725,1536
16009,1,0,102,0,-102
16010,0,0,18,0,-18
16011,0,0,20,0,-20
16012,1,1,206,1259,1053
16013,0,0,22,0,-22
16014,1,1,71,1251,1180
16015,0,0,129,0,-129
16016,0,0,16,0,-16
16017,0,0,18,0,-18
16018,1,1,159,1800,1641
16019,0,0,94,0,-94
16020,1,1,1358,1611,253
16021,1,0,7,0,-7
16022,0,0,16,0,-16
16023,1,0,8,0,-8
16024,1,0,27,0,-27
16025,1,0,40,0,-40
16026,0,0,48,0,-48
16027,1,0,156,0,-156
16028,0,0,28,0,-28
16029,1,1,1253,1293,40
16030,0,0,87,0,-87
16031,1,0,158,0,-158
16032,1,0,57,0,-57
16033,1,1,1050,1284,234
16034,1,1,334,2210,1876
16035,0,0,2,0,-2
16036,0,0,3,0,-3
16037,1,1,255,1290,1035
16038,0,0,3,0,-3
16039,1,0,8,0,-8
16040,1,1,1961,1366,-595
16041,0,0,11,0,-11
16042,1,0,148,0,-148
16043,0,0,143,0,-143
16044,1,0,50,0,-50
16045,1,1,759,1484,725
16046,1,1,120,1575,1455
16047,0,0,19,0,-19
16048,1,1,561,1275,714
16049,1,1,878,1494,616
16050,1,0,25,0,-25
16051,0,0,2,0,-2
16052,0,0,40,0,-40
16053,1,1,192,1352,1160
16054,1,0,11,0,-11
16055,1,1,44,1542,1498
16056,1,0,29,0,-29
16057,1,1,1024,1488,464
16058,1,0,25,0,-25
16059,0,0,1,0,-1
16060,1,0,43,0,-43
16061,1,1,107,1407,1300
16062,0,0,62,0,-62
16063,0,0,2,0,-2
16064,0,0,17,0,-17
16065,0,0,25,0,-25
16066,1,1,302,1473,1171
16067,1,1,221,1363,1142
16068,1,0,21,0,-21
16069,0,0,0,0,0
16070,0,0,4,0,-4
16071,1,1,667,1381,714
16072,1,0,7,0,-7
16073,0,0,103,0,-103
16074,0,0,97,0,-97
16075,1,0,41,0,-41
16076,1,1,223,1345,1122
16077,1,1,139,1491,1352
16078,0,0,31,0,-31
16079,1,0,7,0,-7
16080,0,0,75,0,-75
16081,1,0,131,0,-131
16082,0,0,21,0,-21
16083,0,0,2,0,-2
16084,1,0,44,0,-44
16085,1,1,1313,1461,148
16086,0,0,28,0,-28
16087,1,0,5,0,-5
16088,1,1,256,1200,944
16089,1,1,69,1278,1209
16090,0,0,43,0,-43
16091,0,0,78,0,-78
16092,0,0,125,0,-125
16093,0,0,3,0,-3
16094,1,1,396,1280,884
16095,0,0,49,0,-49
16096,1,0,76,0,-76
16097,1,1,2283,1424,-859
16098,1,1,1263,1529,266
16099,0,0,204,0,-204
16100,1,1,740,1787,1047
16101,0,0,62,0,-62
16102,1,0,53,0,-53
16103,1,1,67,1375,1308
16104,1,1,454,1255,801
16105,0,0,6,0,-6
16106,0,0,179,0,-179
16107,1,0,95,0,-95
16108,1,0,7,0,-7
16109,1,0,32,0,-32
16110,1,0,0,0,0
16111,1,1,46,1346,1300
16112,1,0,23,0,-23
16113,0,0,11,0,-11
16114,0,0,78,0,-78
16115,0,0,58,0,-58
16116,1,0,41,0,-41
16117,0,0,75,0,-75
16118,1,1,373,2443,2070
16119,1,1,1131,1204,73
16120,1,0,21,0,-21
16121,0,0,22,0,-22
16122,0,0,41,0,-41
16123,1,0,26,0,-26
16124,1,0,35,0,-35
16125,0,0,127,0,-127
16126,1,0,25,0,-25
16127,0,0,37,0,-37
16128,1,0,39,0,-39
16129,0,0,5,0,-5
16130,1,1,1322,1361,39
16131,1,1,667,1452,785
16132,1,1,613,1693,1080
16133,1,0,15,0,-15
16134,1,0,23,0,-23
16135,0,0,69,0,-69
16136,0,0,43,0,-43
16137,1,1,289,1242,953
16138,0,0,45,0,-45
16139,1,0,30,0,-30
16140,0,0,40,0,-40
16141,1,1,70,1575,1505
16142,0,0,108,0,-108
16143,0,0,24,0,-24
16144,1,0,47,0,-47
16145,1,1,291,1531,1240
16146,1,1,390,1591,1201
16147,1,0,25,0,-25
16148,0,0,26,0,-26
16149,0,0,77,0,-77
16150,1,1,1066,1356,290
16151,0,0,41,0,-41
16152,1,0,6,0,-6
16153,1,1,138,1279,1141
16154,1,1,436,1851,1415
16155,0,0,27,0,-27
16156,0,0,40,0,-40
16157,0,0,37,0,-37
16158,0,0,79,0,-79
16159,0,0,104,0,-104
16160,0,0,73,0,-73
16161,1,0,45,0,-45
16162,1,1,592,1201,609
16163,0,0,7,0,-7
16164,1,0,31,0,-31
16165,1,0,38,0,-38
16166,0,0,26,0,-26
16167,0,0,84,0,-84
16168,1,1,1474,1241,-233
16169,0,0,4,0,-4
16170,0,0,7,0,-7
16171,1,1,608,1361,753
16172,1,0,76,0,-76
16173,1,1,1307,1335,28
16174,1,1,871,1458,587
16175,0,0,92,0,-92
16176,1,0,107,0,-107
16177,0,0,39,0,-39
16178,0,0,45,0,-45
16179,1,0,151,0,-151
16180,0,0,49,0,-49
16181,0,0,13,0,-13
16182,1,0,164,0,-164
16183,1,1,197,2049,1852
16184,0,0,4,0,-4
16185,0,0,122,0,-122
16186,1,1,95,1352,1257
16187,1,1,109,1268,1159
16188,0,0,86,0,-86
16189,0,0,94,0,-94
16190,1,0,84,0,-84
16191,1,1,357,1375,1018
16192,1,0,46,0,-46
16193,1,0,4,0,-4
16194,1,0,73,0,-73
16195,1,0,36,0,-36
16196,1,0,20,0,-20
16197,0,0,16,0,-16
16198,1,0,30,0,-30
16199,1,1,332,3870,3538
16200,1,1,164,1833,1669
16201,1,1,901,1824,923
16202,1,0,20,0,-20
16203,0,0,69,0,-69
16204,0,0,237,0,-237
16205,1,0,11,0,-11
16206,1,0,42,0,-42
16207,1,0,21,0,-21
16208,1,1,69,1527,1458
16209,1,1,544,1667,1123
16210,0,0,22,0,-22
16211,0,0,71,0,-71
16212,1,1,121,1268,1147
16213,1,1,897,1441,544
16214,1,0,51,0,-51
16215,0,0,45,0,-45
16216,0,0,13,0,-13
16217,1,0,48,0,-48
16218,1,1,2415,1367,-1048
16219,1,0,61,0,-61
16220,0,0,9,0,-9
16221,0,0,1,0,-1
16222,0,0,11,0,-11
16223,0,0,15,0,-15
16224,1,0,34,0,-34
16225,1,1,363,1489,1126
16226,0,0,138,0,-138
16227,1,1,442,1598,1156
16228,1,1,64,2344,2280
16229,1,1,134,1312,1178
16230,0,0,31,0,-31
16231,1,0,4,0,-4
16232,0,0,6,0,-6
16233,0,0,20,0,-20
16234,1,0,19,0,-19
16235,1,0,10,0,-10
16236,1,0,2,0,-2
16237,1,0,7,0,-7
16238,1,1,320,1346,1026
16239,1,0,37,0,-37
16240,0,0,29,0,-29
16241,0,0,146,0,-146
16242,1,0,30,0,-30
16243,1,1,65,2140,2075
16244,0,0,26,0,-26
16245,1,0,10,0,-10
16246,1,0,41,0,-41
16247,0,0,18,0,-18
16248,1,0,29,0,-29
16249,0,0,29,0,-29
16250,1,0,75,0,-75
16251,1,0,52,0,-52
16252,1,1,216,1624,1408
16253,1,0,3,0,-3
16254,0,0,35,0,-35
16255,1,1,831,1647,816
16256,1,0,17,0,-17
16257,0,0,95,0,-95
16258,0,0,3,0,-3
16259,1,0,25,0,-25
16260,1,0,21,0,-21
16261,1,0,14,0,-14
16262,0,0,20,0,-20
16263,1,0,7,0,-7
16264,1,1,862,1626,764
16265,0,0,97,0,-97
16266,1,0,114,0,-114
16267,0,0,22,0,-22
16268,1,0,7,0,-7
16269,0,0,233,0,-233
16270,1,1,412,1273,861
16271,0,0,122,0,-122
16272,0,0,0,0,0
16273,0,0,10,0,-10
16274,0,0,4,0,-4
16275,1,1,116,1553,1437
16276,1,1,453,1253,800
16277,0,0,96,0,-96
16278,1,1,848,1474,626
16279,0,0,6,0,-6
16280,0,0,117,0,-117
16281,1,0,23,0,-23
16282,1,1,392,1406,1014
16283,1,1,57,2020,1963
16284,1,1,861,1405,544
16285,0,0,31,0,-31
16286,1,1,351,1586,1235
16287,1,1,317,2188,1871
16288,1,1,292,1351,1059
16289,1,1,269,1618,1349
16290,1,0,89,0,-89
16291,0,0,88,0,-88
16292,1,1,1162,1229,67
16293,0,0,17,0,-17
16294,0,0,123,0,-123
16295,0,0,127,0,-127
16296,0,0,5,0,-5
16297,1,0,34,0,-34
16298,1,1,112,1413,1301
16299,1,0,1,0,-1
16300,1,1,697,1791,1094
16301,0,0,78,0,-78
16302,1,0,44,0,-44
16303,1,0,23,0,-23
16304,0,0,105,0,-105
16305,1,0,22,0,-22
16306,0,0,2,0,-2
16307,1,1,290,1761,1471
16308,1,0,1,0,-1
16309,1,0,21,0,-21
16310,0,0,187,0,-187
16311,0,0,36,0,-36
16312,1,1,109,1583,1474
16313,0,0,83,0,-83
16314,1,0,28,0,-28
16315,1,0,9,0,-9
16316,1,1,105,1522,1417
16317,0,0,55,0,-55
16318,1,0,16,0,-16
16319,1,1,1308,1970,662
16320,1,0,98,0,-98
16321,1,0,78,0,-78
16322,1,0,2,0,-2
16323,1,0,13,0,-13
16324,0,0,237,0,-237
16325,1,1,159,2081,1922
16326,0,0,90,0,-90
16327,0,0,49,0,-49
16328,1,0,68,0,-68
16329,0,0,2,0,-2
16330,0,0,75,0,-75
16331,1,1,302,1376,1074
16332,0,0,61,0,-61
16333,0,0,59,0,-59
16334,0,0,16,0,-16
16335,0,0,29,0,-29
16336,1,0,75,0,-75
16337,1,1,94,1799,1705
16338,0,0,67,0,-67
16339,0,0,98,0,-98
16340,1,0,3,0,-3
16341,1,0,30,0,-30
16342,1,1,1666,1323,-343
16343,1,0,76,0,-76
16344,1,1,415,1320,905
16345,0,0,10,0,-10
16346,0,0,6,0,-6
16347,0,0,41,0,-41
16348,1,1,394,1239,845
16349,0,0,46,0,-46
16350,0,0,18,0,-18
16351,1,1,359,1617,1258
16352,1,0,9,0,-9
16353,0,0,42,0,-42
16354,1,0,66,0,-66
16355,1,0,9,0,-9
16356,1,1,131,1207,1076
16357,0,0,71,0,-71
16358,1,0,5,0,-5
16359,0,0,100,0,-100
16360,1,1,1511,1493,-18
16361,1,0,8,0,-8
16362,0,0,18,0,-18
16363,1,0,8,0,-8
16364,0,0,0,0,0
16365,1,0,7,0,-7
16366,0,0,13,0,-13
16367,0,0,25,0,-25
16368,1,0,5,0,-5
16369,1,1,222,1250,1028
16370,1,1,339,1698,1359
16371,0,0,58,0,-58
16372,1,1,617,1480,863
16373,0,0,14,0,-14
16374,0,0,7,0,-7
16375,0,0,45,0,-45
16376,0,0,44,0,-44
16377,1,1,467,1256,789
16378,1,1,27,1643,1616
16379,0,0,51,0,-51
16380,1,0,45,0,-45
16381,1,0,33,0,-33
16382,1,0,193,0,-193
16383,0,0,7,0,-7
16384,0,0,42,0,-42
16385,0,0,118,0,-118
16386,0,0,81,0,-81
16387,0,0,4,0,-4
16388,1,0,65,0,-65
16389,1,0,59,0,-59
16390,1,0,7,0,-7
16391,1,0,3,0,-3
16392,0,0,33,0,-33
16393,1,1,532,1249,717
16394,0,0,23,0,-23
16395,1,0,153,0,-153
16396,1,0,0,0,0
16397,1,1,590,1400,810
16398,1,1,464,1325,861
16399,1,0,13,0,-13
16400,0,0,19,0,-19
16401,1,1,127,1985,1858
16402,0,0,31,0,-31
16403,1,0,79,0,-79
16404,0,0,62,0,-62
16405,1,1,285,1428,1143
16406,1,0,61,0,-61
16407,1,1,60,1712,1652
16408,1,0,83,0,-83
16409,0,0,10,0,-10
16410,0,0,38,0,-38
16411,0,0,47,0,-47
16412,1,1,108,1293,1185
16413,1,0,4,0,-4
16414,0,0,101,0,-101
16415,0,0,9,0,-9
16416,0,0,35,0,-35
16417,1,0,25,0,-25
16418,1,1,43,1427,1384
16419,1,0,250,0,-250
16420,0,0,6,0,-6
16421,1,1,31,1499,1468
16422,1,1,548,2305,1757
16423,1,1,417,1601,1184
16424,0,0,37,0,-37
16425,1,1,73,1499,1426
16426,0,0,41,0,-41
16427,1,0,11,0,-11
16428,1,0,0,0,0
16429,0,0,51,0,-51
16430,0,0,6,0,-6
16431,0,0,40,0,-40
16432,0,0,52,0,-52
16433,0,0,41,0,-41
16434,1,1,793,1261,468
16435,1,0,8,0,-8
16436,1,1,287,1333,1046
16437,1,0,46,0,-46
16438,1,1,388,1491,1103
16439,1,1,214,1957,1743
16440,0,0,31,0,-31
16441,1,0,117,0,-117
16442,0,0,24,0,-24
16443,1,0,95,0,-95
16444,1,1,261,1678,1417
16445,1,1,430,2435,2005
16446,0,0,9,0,-9
16447,1,0,140,0,-140
16448,0,0,140,0,-140
16449,0,0,13,0,-13
16450,1,0,64,0,-64
16451,0,0,122,0,-122
16452,0,0,22,0,-22
16453,1,0,14,0,-14
16454,0,0,61,0,-61
16455,1,0,13,0,-13
16456,0,0,56,0,-56
16457,1,0,24,0,-24
16458,1,1,10,1539,1529
16459,1,1,328,1503,1175
16460,0,0,34,0,-34
16461,0,0,106,0,-106
16462,0,0,16,0,-16
16463,1,0,5,0,-5
16464,1,1,752,1644,892
16465,1,1,147,1449,1302
16466,0,0,74,0,-74
16467,1,1,55,1457,1402
16468,1,1,20,3416,3396
16469,0,0,32,0,-32
16470,0,0,10,0,-10
16471,1,1,243,1212,969
16472,0,0,103,0,-103
16473,0,0,7,0,-7
16474,0,0,43,0,-43
16475,0,0,3,0,-3
16476,1,0,77,0,-77
16477,1,1,367,1337,970
16478,1,1,315,1411,1096
16479,1,1,860,1317,457
16480,1,1,105,2099,1994
16481,1,0,88,0,-88
16482,0,0,30,0,-30
16483,0,0,39,0,-39
16484,1,1,580,1400,820
16485,0,0,46,0,-46
16486,0,0,1,0,-1
16487,1,1,1256,1660,404
16488,0,0,1,0,-1
16489,0,0,196,0,-196
16490,0,0,14,0,-14
16491,1,0,30,0,-30
16492,1,0,34,0,-34
16493,1,0,8,0,-8
16494,1,0,19,0,-19
16495,0,0,57,0,-57
16496,0,0,6,0,-6
16497,1,0,25,0,-25
16498,1,0,16,0,-16
16499,0,0,77,0,-77
16500,1,0,65,0,-65
16501,1,1,635,1596,961
16502,1,1,572,1627,1055
16503,1,1,1362,1498,136
16504,1,0,57,0,-57
16505,1,0,2,0,-2
16506,1,0,9,0,-9
16507,0,0,8,0,-8
16508,1,0,15,0,-15
16509,1,1,331,1450,1119
16510,1,1,516,1295,779
16511,1,1,300,1719,1419
16512,0,0,4,0,-4
16513,1,1,638,2953,2315
16514,1,0,1,0,-1
16515,0,0,56,0,-56
16516,0,0,110,0,-110
16517,1,0,18,0,-18
16518,0,0,69,0,-69
16519,1,0,101,0,-101
16520,1,0,25,0,-25
16521,1,1,672,1435,763
16522,0,0,44,0,-44
16523,0,0,6,0,-6
16524,0,0,48,0,-48
16525,1,0,87,0,-87
16526,0,0,17,0,-17
16527,0,0,10,0,-10
16528,1,0,20,0,-20
16529,1,1,409,1326,917
16530,1,1,658,1315,657
16531,0,0,3,0,-3
16532,0,0,18,0,-18
16533,0,0,48,0,-48
16534,1,1,750,1681,931
16535,1,1,313,1568,1255
16536,0,0,22,0,-22
16537,0,0,10,0,-10
16538,0,0,66,0,-66
16539,1,0,116,0,-116
16540,1,0,63,0,-63
16541,0,0,44,0,-44
16542,0,0,53,0,-53
16543,0,0,5,0,-5
16544,1,1,1345,1219,-126
16545,0,0,32,0,-32
16546,0,0,96,0,-96
16547,0,0,6,0,-6
16548,1,1,649,1312,663
16549,0,0,30,0,-30
16550,1,0,10,0,-10
16551,1,0,247,0,-247
16552,1,1,145,1484,1339
16553,0,0,40,0,-40
16554,0,0,54,0,-54
16555,1,1,124,1668,1544
16556,0,0,20,0,-20
16557,0,0,55,0,-55
16558,1,0,21,0,-21
16559,1,0,77,0,-77
16560,0,0,15,0,-15
16561,0,0,77,0,-77
16562,1,1,611,2042,1431
16563,1,1,2379,1877,-502
16564,0,0,20,0,-20
16565,1,0,22,0,-22
16566,0,0,10,0,-10
16567,1,1,351,1604,1253
16568,1,0,45,0,-45
16569,1,0,9,0,-9
16570,1,0,3,0,-3
16571,0,0,6,0,-6
16572,0,0,59,0,-59
16573,0,0,1,0,-1
16574,0,0,121,0,-121
16575,1,0,10,0,-10
16576,0,0,3,0,-3
16577,1,0,172,0,-172
16578,1,1,1267,2043,776
16579,0,0,41,0,-41
16580,0,0,19,0,-19
16581,0,0,76,0,-76
16582,0,0,57,0,-57
16583,1,0,69,0,-69
16584,0,0,14,0,-14
16585,1,0,17,0,-17
16586,0,0,7,0,-7
16587,0,0,124,0,-124
16588,1,0,62,0,-62
16589,0,0,162,0,-162
16590,1,0,12,0,-12
16591,0,0,52,0,-52
16592,1,0,79,0,-79
16593,1,0,49,0,-49
16594,1,1,892,2576,1684
16595,1,0,116,0,-116
16596,0,0,35,0,-35
16597,1,1,88,1478,1390
16598,0,0,38,0,-38
16599,0,0,117,0,-117
16600,1,0,10,0,-10
16601,1,1,353,1217,864
16602,0,0,71,0,-71
16603,0,0,168,0,-168
16604,1,0,152,0,-152
16605,1,0,16,0,-16
16606,1,1,864,1205,341
16607,1,0,68,0,-68
16608,1,0,28,0,-28
16609,0,0,22,0,-22
16610,1,1,406,1327,921
16611,1,1,51,1589,1538
16612,1,1,150,1761,1611
16613,1,1,94,1215,1121
16614,1,1,681,1326,645
16615,0,0,99,0,-99
16616,1,1,348,1421,1073
16617,0,0,139,0,-139
16618,1,1,1321,1724,403
16619,0,0,127,0,-127
16620,1,1,840,1569,729
16621,1,1,325,1765,1440
16622,0,0,15,0,-15
16623,0,0,61,0,-61
16624,0,0,5,0,-5
16625,1,1,742,1713,971
16626,0,0,56,0,-56
16627,0,0,32,0,-32
16628,1,1,1283,2131,848
16629,0,0,205,0,-205
16630,0,0,183,0,-183
16631,1,1,2620,1395,-1225
16632,1,0,27,0,-27
16633,0,0,26,0,-26
16634,1,1,456,1520,1064
16635,1,0,109,0,-109
16636,0,0,35,0,-35
16637,1,1,36,1249,1213
16638,0,0,97,0,-97
16639,1,0,3,0,-3
16640,0,0,26,0,-26
16641,0,0,158,0,-158
16642,0,0,56,0,-56
16643,1,0,28,0,-28
16644,1,1,45,1250,1205
16645,0,0,57,0,-57
16646,1,1,617,1211,594
16647,1,0,39,0,-39
16648,1,0,69,0,-69
16649,0,0,23,0,-23
16650,1,1,755,1204,449
16651,1,0,3,0,-3
16652,1,0,10,0,-10
16653,1,1,288,1670,1382
16654,0,0,76,0,-76
16655,1,0,104,0,-104
16656,1,1,281,1223,942
16657,0,0,110,0,-110
16658,1,1,152,1290,1138
16659,0,0,43,0,-43
16660,0,0,29,0,-29
16661,1,1,431,1653,1222
16662,1,0,0,0,0
16663,0,0,33,0,-33
16664,1,1,1824,1335,-489
16665,1,0,0,0,0
16666,0,0,80,0,-80
16667,0,0,101,0,-101
16668,1,1,59,1262,1203
16669,1,0,11,0,-11
16670,1,0,14,0,-14
16671,1,0,48,0,-48
16672,1,1,216,1515,1299
16673,0,0,18,0,-18
16674,1,0,55,0,-55
16675,1,0,42,0,-42
16676,0,0,0,0,0
16677,1,1,296,1513,1217
16678,0,0,21,0,-21
16679,1,1,200,1242,1042
16680,1,0,36,0,-36
16681,0,0,18,0,-18
16682,0,0,5,0,-5
16683,1,0,17,0,-17
16684,1,1,81,1227,1146
16685,0,0,8,0,-8
16686,0,0,11,0,-11
16687,1,0,24,0,-24
16688,1,1,774,1212,438
16689,0,0,57,0,-57
16690,1,1,281,1437,1156
16691,0,0,53,0,-53
16692,0,0,78,0,-78
16693,1,1,100,1263,1163
16694,1,1,1853,1578,-275
16695,1,0,42,0,-42
16696,1,1,437,1357,920
16697,1,1,184,1344,1160
16698,0,0,69,0,-69
16699,0,0,1,0,-1
16700,0,0,34,0,-34
16701,0,0,60,0,-60
16702,0,0,45,0,-45
16703,1,0,10,0,-10
16704,1,0,29,0,-29
16705,1,0,15,0,-15
16706,1,0,74,0,-74
16707,0,0,6,0,-6
16708,0,0,26,0,-26
16709,1,1,187,1618,1431
16710,1,1,230,1318,1088
16711,0,0,96,0,-96
16712,1,1,713,1203,490
16713,1,1,73,1556,1483
16714,1,1,326,1270,944
16715,1,0,2,0,-2
16716,0,0,26,0,-26
16717,0,0,23,0,-23
16718,1,1,922,1619,697
16719,1,1,98,1324,1226
16720,1,1,418,1713,1295
16721,0,0,12,0,-12
16722,1,1,1274,2039,765
16723,1,1,504,1221,717
16724,1,1,4363,1345,-3018
16725,1,1,344,1393,1049
16726,0,0,101,0,-101
16727,0,0,224,0,-224
16728,0,0,31,0,-31
16729,1,1,541,1259,718
16730,0,0,44,0,-44
16731,1,0,101,0,-101
16732,1,1,835,1641,806
16733,1,0,40,0,-40
16734,1,0,133,0,-133
16735,1,1,1171,1225,54
16736,1,1,95,1312,1217
16737,0,0,29,0,-29
16738,1,0,13,0,-13
16739,1,0,19,0,-19
16740,1,0,14,0,-14
16741,1,1,283,1248,965
16742,1,0,46,0,-46
16743,0,0,2,0,-2
16744,0,0,37,0,-37
16745,1,0,19,0,-19
16746,0,0,39,0,-39
16747,1,1,276,1735,1459
16748,0,0,118,0,-118
16749,1,0,126,0,-126
16750,1,1,2045,1316,-729
16751,0,0,124,0,-124
16752,0,0,51,0,-51
16753,0,0,34,0,-34
16754,0,0,12,0,-12
16755,0,0,9,0,-9
16756,1,1,215,1244,1029
16757,1,0,5,0,-5
16758,1,1,455,1219,764
16759,1,0,66,0,-66
16760,0,0,193,0,-193
16761,0,0,16,0,-16
16762,1,1,18,1677,1659
16763,1,1,274,1207,933
16764,1,1,500,1532,1032
16765,1,0,0,0,0
16766,1,1,859,1234,375
16767,1,0,73,0,-73
16768,0,0,24,0,-24
16769,1,1,63,1450,1387
16770,1,1,22,1223,1201
16771,1,0,38,0,-38
16772,0,0,36,0,-36
16773,0,0,65,0,-65
16774,0,0,71,0,-71
16775,0,0,16,0,-16
16776,0,0,60,0,-60
16777,0,0,46,0,-46
16778,1,0,4,0,-4
16779,0,0,28,0,-28
16780,0,0,47,0,-47
16781,0,0,47,0,-47
16782,1,0,30,0,-30
16783,0,0,138,0,-138
16784,1,1,47,1836,1789
16785,1,1,1065,1248,183
16786,1,1,1198,1377,179
16787,1,1,1174,1653,479
16788,0,0,95,0,-95
16789,1,0,79,0,-79
16790,1,0,2,0,-2
16791,0,0,38,0,-38
16792,1,1,505,1522,1017
16793,1,0,4,0,-4
16794,1,0,27,0,-27
16795,0,0,17,0,-17
16796,0,0,117,0,-117
16797,0,0,9,0,-9
16798,1,0,121,0,-121
16799,0,0,15,0,-15
16800,0,0,1,0,-1
16801,0,0,140,0,-140
16802,1,1,400,1230,830
16803,1,0,19,0,-19
16804,1,0,55,0,-55
16805,0,0,25,0,-25
16806,1,0,7,0,-7
16807,0,0,58,0,-58
16808,0,0,40,0,-40
16809,1,0,59,0,-59
16810,1,0,245,0,-245
16811,0,0,3,0,-3
16812,1,1,9,1251,1242
16813,1,1,44,1884,1840
16814,0,0,1,0,-1
16815,1,0,24,0,-24
16816,0,0,161,0,-161
16817,1,0,25,0,-25
16818,0,0,20,0,-20
16819,1,0,60,0,-60
16820,0,0,56,0,-56
16821,0,0,50,0,-50
16822,1,1,337,1346,1009
16823,1,0,116,0,-116
16824,1,0,14,0,-14
16825,1,0,23,0,-23
16826,1,1,2679,1448,-1231
16827,1,1,1159,1369,210
16828,0,0,59,0,-59
16829,1,1,1078,3317,2239
16830,1,0,67,0,-67
16831,0,0,79,0,-79
16832,0,0,47,0,-47
16833,1,1,913,1534,621
16834,1,1,114,1331,1217
16835,1,0,39,0,-39
16836,0,0,81,0,-81
16837,1,1,1409,1566,157
16838,1,0,8,0,-8
16839,1,0,28,0,-28
16840,0,0,71,0,-71
16841,1,0,24,0,-24
16842,0,0,34,0,-34
16843,0,0,9,0,-9
16844,1,0,9,0,-9
16845,0,0,34,0,-34
16846,1,1,267,2016,1749
16847,0,0,126,0,-126
16848,0,0,102,0,-102
16849,0,0,28,0,-28
16850,1,0,56,0,-56
16851,1,1,459,1792,1333
16852,0,0,27,0,-27
16853,0,0,11,0,-11
16854,0,0,85,0,-85
16855,1,1,239,1271,1032
16856,0,0,38,0,-38
16857,0,0,114,0,-114
16858,1,1,508,1998,1490
16859,1,1,648,1288,640
16860,0,0,48,0,-48
16861,1,0,74,0,-74
16862,0,0,64,0,-64
16863,1,0,64,0,-64
16864,0,0,26,0,-26
16865,0,0,9,0,-9
16866,1,1,303,2460,2157
16867,1,1,239,1774,1535
16868,0,0,24,0,-24
16869,0,0,122,0,-122
16870,1,1,336,1226,890
16871,0,0,39,0,-39
16872,0,0,12,0,-12
16873,1,1,1046,1329,283
16874,1,1,641,2442,1801
16875,1,1,136,1691,1555
16876,1,1,316,1265,949
16877,1,0,78,0,-78
16878,0,0,12,0,-12
16879,0,0,70,0,-70
16880,0,0,20,0,-20
16881,1,1,174,1244,1070
16882,1,0,61,0,-61
16883,1,0,130,0,-130
16884,1,1,1417,1395,-22
16885,0,0,11,0,-11
16886,0,0,5,0,-5
16887,1,0,1,0,-1
16888,1,1,224,1249,1025
16889,1,0,30,0,-30
16890,1,1,1049,1564,515
16891,1,0,15,0,-15
16892,0,0,19,0,-19
16893,0,0,67,0,-67
16894,1,1,1485,1303,-182
16895,0,0,90,0,-90
16896,1,0,78,0,-78
16897,1,0,29,0,-29
16898,1,0,55,0,-55
16899,1,0,147,0,-147
16900,1,0,9,0,-9
16901,0,0,134,0,-134
16902,0,0,28,0,-28
16903,1,1,531,2368,1837
16904,1,0,13,0,-13
16905,1,1,299,1438,1139
16906,1,1,67,1250,1183
16907,1,0,30,0,-30
16908,0,0,69,0,-69
16909,1,0,16,0,-16
16910,1,1,534,1602,1068
16911,0,0,123,0,-123
16912,1,1,133,1206,1073
16913,1,0,124,0,-124
16914,1,1,673,1819,1146
16915,0,0,173,0,-173
16916,1,0,54,0,-54
16917,0,0,32,0,-32
16918,1,0,35,0,-35
16919,1,1,886,2960,2074
16920,1,1,236,1762,1526
16921,1,1,154,1438,1284
16922,0,0,17,0,-17
16923,1,1,795,1241,446
16924,1,1,641,2546,1905
16925,0,0,62,0,-62
16926,1,0,214,0,-214
16927,0,0,37,0,-37
16928,1,0,26,0,-26
16929,1,1,86,1857,1771
16930,0,0,18,0,-18
16931,0,0,182,0,-182
16932,0,0,80,0,-80
16933,0,0,141,0,-141
16934,0,0,18,0,-18
16935,0,0,63,0,-63
16936,1,0,60,0,-60
16937,1,0,5,0,-5
16938,1,0,163,0,-163
16939,1,1,773,1361,588
16940,0,0,15,0,-15
16941,1,0,18,0,-18
16942,0,0,7,0,-7
16943,0,0,56,0,-56
16944,0,0,70,0,-70
16945,1,0,76,0,-76
16946,1,1,85,1295,1210
16947,1,0,119,0,-119
16948,0,0,16,0,-16
16949,0,0,0,0,0
16950,1,0,41,0,-41
16951,1,1,666,1838,1172
16952,1,1,74,1274,1200
16953,0,0,12,0,-12
16954,0,0,9,0,-9
16955,1,0,9,0,-9
16956,1,0,46,0,-46
16957,0,0,21,0,-21
16958,0,0,138,0,-138
16959,1,1,696,1380,684
16960,1,1,47,1246,1199
16961,0,0,56,0,-56
16962,1,1,837,1250,413
16963,0,0,2,0,-2
16964,0,0,58,0,-58
16965,1,0,4,0,-4
16966,1,0,130,0,-130
16967,0,0,126,0,-126
16968,1,1,650,1255,605
16969,0,0,44,0,-44
16970,1,1,111,1271,1160
16971,1,0,1,0,-1
16972,1,0,60,0,-60
16973,0,0,66,0,-66
16974,1,1,347,1695,1348
16975,0,0,5,0,-5
16976,1,1,321,1310,989
16977,0,0,11,0,-11
16978,1,0,106,0,-106
16979,1,0,96,0,-96
16980,1,0,43,0,-43
16981,1,0,228,0,-228
16982,1,1,406,1647,1241
16983,1,1,1070,1259,189
16984,1,1,868,2038,1170
16985,1,0,6,0,-6
16986,0,0,173,0,-173
16987,1,0,18,0,-18
16988,1,1,329,1473,1144
16989,1,1,301,1347,1046
16990,0,0,131,0,-131
16991,0,0,80,0,-80
16992,1,1,339,1672,1333
16993,0,0,11,0,-11
16994,0,0,15,0,-15
16995,1,1,417,1342,925
16996,1,0,61,0,-61
16997,1,0,21,0,-21
16998,1,0,13,0,-13
16999,1,0,32,0,-32
17000,0,0,28,0,-28
17001,1,0,9,0,-9
17002,1,1,829,1304,475
17003,1,1,725,1223,498
17004,1,1,459,1297,838
17005,1,0,73,0,-73
17006,0,0,3,0,-3
17007,0,0,100,0,-100
17008,1,1,194,1263,1069
17009,1,0,20,0,-20
17010,1,1,34,1379,1345
17011,1,1,121,1668,1547
17012,0,0,52,0,-52
17013,1,0,51,0,-51
17014,0,0,89,0,-89
17015,0,0,47,0,-47
17016,1,1,617,1879,1262
17017,0,0,89,0,-89
17018,1,1,172,2781,2609
17019,0,0,59,0,-59
17020,1,1,838,1270,432
17021,0,0,7,0,-7
17022,1,0,1,0,-1
17023,1,0,74,0,-74
17024,1,1,102,1619,1517
17025,1,0,93,0,-93
17026,1,0,45,0,-45
17027,0,0,130,0,-130
17028,0,0,65,0,-65
17029,1,0,52,0,-52
17030,1,0,77,0,-77
17031,0,0,2,0,-2
17032,0,0,22,0,-22
17033,1,0,68,0,-68
17034,1,1,242,1208,966
17035,1,0,14,0,-14
17036,0,0,95,0,-95
17037,0,0,8,0,-8
17038,1,1,2111,1200,-911
17039,0,0,74,0,-74
17040,1,1,197,2009,1812
17041,1,0,21,0,-21
17042,0,0,29,0,-29
17043,1,1,95,1336,1241
17044,0,0,55,0,-55
17045,1,1,163,1814,1651
17046,1,1,1022,1420,398
17047,0,0,95,0,-95
17048,0,0,202,0,-202
17049,1,1,474,1755,1281
17050,1,0,164,0,-164
17051,1,0,48,0,-48
17052,1,1,210,2915,2705
17053,1,1,629,1271,642
17054,0,0,10,0,-10
17055,1,1,905,1300,395
17056,1,1,214,1531,1317
17057,1,1,296,1204,908
17058,0,0,69,0,-69
17059,0,0,50,0,-50
17060,0,0,115,0,-115
17061,1,1,794,1767,973
17062,1,1,126,1555,1429
17063,1,1,5481,1281,-4200
17064,1,0,12,0,-12
17065,0,0,70,0,-70
17066,0,0,76,0,-76
17067,1,1,184,3655,3471
17068,0,0,128,0,-128
17069,0,0,13,0,-13
17070,1,0,3,0,-3
17071,1,0,15,0,-15
17072,0,0,93,0,-93
17073,0,0,52,0,-52
17074,0,0,18,0,-18
17075,1,1,240,2157,1917
17076,0,0,55,0,-55
17077,1,1,748,1222,474
17078,0,0,25,0,-25
17079,1,0,15,0,-15
17080,0,0,145,0,-145
17081,1,1,738,1395,657
17082,1,1,505,2393,1888
17083,1,0,32,0,-32
17084,0,0,28,0,-28
17085,0,0,13,0,-13
17086,1,0,13,0,-13
17087,1,0,91,0,-91
17088,1,0,96,0,-96
17089,1,0,66,0,-66
17090,1,1,526,1597,1071
17091,0,0,1,0,-1
17092,1,0,4,0,-4
17093,1,0,23,0,-23
17094,0,0,35,0,-35
17095,0,0,19,0,-19
17096,1,1,85,1695,1610
17097,1,1,1903,1314,-589
17098,1,0,8,0,-8
17099,1,0,34,0,-34
17100,0,0,45,0,-45
17101,0,0,38,0,-38
17102,1,0,10,0,-10
17103,1,0,17,0,-17
17104,0,0,118,0,-118
17105,1,0,20,0,-20
17106,1,0,32,0,-32
17107,1,0,50,0,-50
17108,0,0,23,0,-23
17109,1,1,513,3252,2739
17110,1,1,540,1559,1019
17111,1,0,65,0,-65
17112,0,0,20,0,-20
17113,1,0,7,0,-7
17114,0,0,21,0,-21
17115,1,1,345,1895,1550
17116,1,0,26,0,-26
17117,0,0,40,0,-40
17118,0,0,0,0,0
17119,0,0,49,0,-49
17120,1,0,31,0,-31
17121,0,0,12,0,-12
17122,1,0,95,0,-95
17123,0,0,38,0,-38
17124,1,0,9,0,-9
17125,0,0,7,0,-7
17126,1,1,961,1650,689
17127,0,0,85,0,-85
17128,1,1,856,1250,394
17129,0,0,19,0,-19
17130,0,0,37,0,-37
17131,1,1,163,1212,1049
17132,1,0,33,0,-33
17133,1,0,58,0,-58
17134,1,0,12,0,-12
17135,0,0,1,0,-1
17136,0,0,3,0,-3
17137,1,1,401,1270,869
17138,1,1,554,2837,2283
17139,1,1,636,2237,1601
17140,0,0,30,0,-30
17141,0,0,17,0,-17
17142,1,1,69,1251,1182
17143,1,0,36,0,-36
17144,0,0,46,0,-46
17145,0,0,1,0,-1
17146,1,1,370,2229,1859
17147,1,0,123,0,-123
17148,0,0,4,0,-4
17149,1,0,63,0,-63
17150,0,0,117,0,-117
17151,1,0,60,0,-60
17152,0,0,5,0,-5
17153,1,1,117,1477,1360
17154,0,0,115,0,-115
17155,0,0,61,0,-61
17156,1,0,137,0,-137
17157,0,0,29,0,-29
17158,0,0,62,0,-62
17159,1,0,14,0,-14
17160,0,0,35,0,-35
17161,1,0,13,0,-13
17162,0,0,180,0,-180
17163,0,0,113,0,-113
17164,0,0,21,0,-21
17165,1,0,79,0,-79
17166,0,0,36,0,-36
17167,0,0,12,0,-12
17168,1,1,900,2041,1141
17169,1,1,1120,1527,407
17170,1,0,12,0,-12
17171,1,0,79,0,-79
17172,1,1,143,1508,1365
17173,0,0,121,0,-121
17174,0,0,56,0,-56
17175,1,1,395,1384,989
17176,1,1,316,1410,1094
17177,1,0,9,0,-9
17178,1,1,319,1260,941
17179,1,1,110,1534,1424
17180,1,0,22,0,-22
17181,0,0,1,0,-1
17182,1,1,65,1437,1372
17183,0,0,6,0,-6
17184,1,1,579,1482,903
17185,0,0,17,0,-17
17186,1,0,55,0,-55
17187,1,1,265,1399,1134
17188,1,1,188,1568,1380
17189,1,0,20,0,-20
17190,1,1,64,1212,1148
17191,1,0,70,0,-70
17192,1,0,3,0,-3
17193,1,0,36,0,-36
17194,1,1,332,1591,1259
17195,0,0,113,0,-113
17196,0,0,53,0,-53
17197,0,0,110,0,-110
17198,1,1,244,1991,1747
17199,0,0,6,0,-6
17200,0,0,22,0,-22
17201,1,1,2817,1362,-1455
17202,0,0,78,0,-78
17203,0,0,94,0,-94
17204,1,0,6,0,-6
17205,0,0,29,0,-29
17206,1,1,598,1826,1228
17207,1,1,272,1243,971
17208,1,1,893,1226,333
17209,0,0,61,0,-61
17210,1,0,13,0,-13
17211,1,1,205,1250,1045
17212,1,0,72,0,-72
17213,1,1,252,1472,1220
17214,1,1,674,1317,643
17215,0,0,40,0,-40
17216,1,1,219,1220,1001
17217,0,0,14,0,-14
17218,1,1,680,1248,568
17219,1,1,2843,1927,-916
17220,1,0,105,0,-105
17221,1,1,384,1517,1133
17222,1,1,1487,2285,798
17223,1,0,20,0,-20
17224,0,0,33,0,-33
17225,1,1,2511,1398,-1113
17226,1,0,3,0,-3
17227,0,0,20,0,-20
17228,1,1,341,2448,2107
17229,1,0,116,0,-116
17230,0,0,152,0,-152
17231,1,1,610,1290,680
17232,0,0,10,0,-10
17233,0,0,4,0,-4
17234,1,1,280,1479,1199
17235,1,0,72,0,-72
17236,0,0,68,0,-68
17237,1,0,3,0,-3
17238,0,0,34,0,-34
17239,0,0,10,0,-10
17240,1,1,13,3292,3279
17241,0,0,0,0,0
17242,1,0,61,0,-61
17243,0,0,11,0,-11
17244,1,0,45,0,-45
17245,0,0,132,0,-132
17246,1,1,379,2407,2028
17247,1,0,56,0,-56
17248,1,1,156,1203,1047
17249,1,0,88,0,-88
17250,1,0,38,0,-38
17251,1,1,602,1718,1116
17252,0,0,18,0,-18
17253,1,0,30,0,-30
17254,1,0,66,0,-66
17255,0,0,86,0,-86
17256,1,0,192,0,-192
17257,0,0,43,0,-43
17258,1,0,9,0,-9
17259,0,0,36,0,-36
17260,1,0,250,0,-250
17261,1,1,184,1698,1514
17262,0,0,1,0,-1
17263,1,1,975,1692,717
17264,1,1,494,3021,2527
17265,1,0,17,0,-17
17266,1,1,136,1825,1689
17267,1,1,119,1325,1206
17268,0,0,10,0,-10
17269,1,1,1215,1445,230
17270,1,1,191,1298,1107
17271,0,0,8,0,-8
17272,0,0,34,0,-34
17273,1,1,876,1856,980
17274,1,0,102,0,-102
17275,0,0,35,0,-35
17276,1,0,99,0,-99
17277,0,0,53,0,-53
17278,0,0,80,0,-80
17279,1,0,2,0,-2
17280,1,1,114,1765,1651
17281,1,0,85,0,-85
17282,1,0,80,0,-80
17283,1,1,474,1454,980
17284,1,0,62,0,-62
17285,1,1,610,1340,730
17286,0,0,11,0,-11
17287,1,1,661,1853,1192
17288,0,0,11,0,-11
17289,1,0,26,0,-26
17290,0,0,4,0,-4
17291,1,0,51,0,-51
17292,0,0,41,0,-41
17293,0,0,1,0,-1
17294,0,0,12,0,-12
17295,1,0,28,0,-28
17296,1,0,91,0,-91
17297,1,1,531,1302,771
17298,1,0,24,0,-24
17299,0,0,0,0,0
17300,0,0,0,0,0
17301,0,0,44,0,-44
17302,1,0,7,0,-7
17303,0,0,45,0,-45
17304,1,0,64,0,-64
17305,0,0,85,0,-85
17306,1,1,334,2339,2005
17307,1,0,36,0,-36
17308,1,1,176,1302,1126
17309,0,0,105,0,-105
17310,0,0,52,0,-52
17311,1,1,377,1805,1428
17312,1,0,68,0,-68
17313,0,0,62,0,-62
17314,0,0,119,0,-119
17315,0,0,135,0,-135
17316,1,0,89,0,-89
17317,0,0,14,0,-14
17318,0,0,14,0,-14
17319,0,0,64,0,-64
17320,1,1,500,1399,899
17321,0,0,60,0,-60
17322,0,0,12,0,-12
17323,0,0,50,0,-50
17324,1,1,1470,1345,-125
17325,0,0,1,0,-1
17326,0,0,42,0,-42
17327,0,0,130,0,-130
17328,1,1,237,1573,1336
17329,0,0,40,0,-40
17330,1,0,146,0,-146
17331,0,0,10,0,-10
17332,0,0,36,0,-36
17333,1,0,127,0,-127
17334,1,0,88,0,-88
17335,0,0,25,0,-25
17336,1,1,311,1200,889
17337,0,0,26,0,-26
17338,1,0,127,0,-127
17339,1,0,30,0,-30
17340,1,0,2,0,-2
17341,0,0,25,0,-25
17342,0,0,80,0,-80
17343,1,1,356,1211,855
17344,0,0,14,0,-14
17345,1,1,111,1221,1110
17346,0,0,59,0,-59
17347,1,0,34,0,-34
17348,1,1,1183,4966,3783
17349,0,0,146,0,-146
17350,1,0,153,0,-153
17351,1,0,50,0,-50
17352,1,0,1,0,-1
17353,0,0,12,0,-12
17354,1,0,114,0,-114
17355,1,1,40,1856,1816
17356,0,0,73,0,-73
17357,1,0,47,0,-47
17358,1,1,481,1366,885
17359,1,0,19,0,-19
17360,1,1,209,1752,1543
17361,1,1,572,1218,646
17362,1,1,281,3009,2728
17363,1,0,3,0,-3
17364,0,0,81,0,-81
17365,1,0,18,0,-18
17366,0,0,25,0,-25
17367,0,0,42,0,-42
17368,1,1,44,3899,3855
17369,0,0,6,0,-6
17370,1,1,107,1423,1316
17371,0,0,3,0,-3
17372,1,0,49,0,-49
17373,1,1,979,1449,470
17374,1,0,29,0,-29
17375,1,0,51,0,-51
17376,0,0,47,0,-47
17377,0,0,8,0,-8
17378,0,0,7,0,-7
17379,0,0,35,0,-35
17380,1,1,177,1331,1154
17381,1,1,683,1211,528
17382,0,0,3,0,-3
17383,1,1,178,1424,1246
17384,1,1,799,1503,704
17385,0,0,129,0,-129
17386,1,0,11,0,-11
17387,1,1,502,1903,1401
17388,1,1,191,1532,1341
17389,1,1,1425,1516,91
17390,1,0,57,0,-57
17391,1,1,2313,1211,-1102
17392,0,0,6,0,-6
17393,1,1,1884,1441,-443
17394,1,1,758,1230,472
17395,1,0,0,0,0
17396,0,0,34,0,-34
17397,1,0,113,0,-113
17398,1,0,38,0,-38
17399,1,1,337,1539,1202
17400,1,0,76,0,-76
17401,1,1,240,1853,1613
17402,0,0,18,0,-18
17403,1,1,757,1347,590
17404,1,1,990,1248,258
17405,1,0,24,0,-24
17406,0,0,50,0,-50
17407,1,0,16,0,-16
17408,1,0,30,0,-30
17409,0,0,1,0,-1
17410,1,0,2,0,-2
17411,1,1,625,1202,577
17412,1,0,62,0,-62
17413,0,0,78,0,-78
17414,1,1,232,1232,1000
17415,0,0,29,0,-29
17416,1,0,33,0,-33
17417,1,0,164,0,-164
17418,1,1,196,1425,1229
17419,1,0,1,0,-1
17420,1,1,522,1285,763
17421,0,0,26,0,-26
17422,1,1,412,1593,1181
17423,1,0,33,0,-33
17424,1,0,69,0,-69
17425,1,0,49,0,-49
17426,1,1,1373,1291,-82
17427,1,0,66,0,-66
17428,0,0,3,0,-3
17429,1,1,809,1979,1170
17430,0,0,18,0,-18
17431,0,0,109,0,-109
17432,1,0,2,0,-2
17433,0,0,139,0,-139
17434,1,1,877,1511,634
17435,1,1,119,3028,2909
17436,1,0,123,0,-123
17437,1,0,78,0,-78
17438,1,1,202,1483,1281
17439,1,1,1021,1343,322
17440,0,0,120,0,-120
17441,1,1,95,2458,2363
17442,0,0,69,0,-69
17443,1,1,1316,1884,568
17444,0,0,13,0,-13
17445,1,0,68,0,-68
17446,0,0,123,0,-123
17447,1,0,29,0,-29
17448,1,0,15,0,-15
17449,0,0,94,0,-94
17450,1,0,15,0,-15
17451,1,0,2,0,-2
17452,0,0,33,0,-33
17453,0,0,82,0,-82
17454,1,0,228,0,-228
17455,1,1,1534,1230,-304
17456,1,0,11,0,-11
17457,1,0,59,0,-59
17458,0,0,40,0,-40
17459,1,0,115,0,-115
17460,0,0,11,0,-11
17461,0,0,20,0,-20
17462,0,0,41,0,-41
17463,1,1,830,1687,857
17464,0,0,15,0,-15
17465,1,0,22,0,-22
17466,1,1,158,1622,1464
17467,1,1,793,1562,769
17468,0,0,49,0,-49
17469,1,1,194,1238,1044
17470,1,1,407,1221,814
17471,0,0,44,0,-44
17472,1,0,3,0,-3
17473,0,0,17,0,-17
17474,1,1,213,1290,1077
17475,1,0,53,0,-53
17476,1,1,750,1203,453
17477,1,0,24,0,-24
17478,0,0,29,0,-29
17479,0,0,48,0,-48
17480,1,0,52,0,-52
17481,1,0,51,0,-51
17482,0,0,8,0,-8
17483,1,1,474,2069,1595
17484,1,1,42,1783,1741
17485,1,1,518,2322,1804
17486,0,0,44,0,-44
17487,1,0,115,0,-115
17488,0,0,90,0,-90
17489,1,1,152,1405,1253
17490,0,0,8,0,-8
17491,1,1,568,1501,933
17492,1,0,25,0,-25
17493,1,1,478,2732,2254
17494,1,0,2,0,-2
17495,0,0,10,0,-10
17496,0,0,34,0,-34
17497,0,0,43,0,-43
17498,0,0,61,0,-61
17499,1,1,1433,1297,-136
17500,0,0,61,0,-61
17501,0,0,97,0,-97
17502,1,0,4,0,-4
17503,0,0,139,0,-139
17504,1,1,465,1513,1048
17505,0,0,151,0,-151
17506,1,0,5,0,-5
17507,0,0,78,0,-78
17508,1,0,36,0,-36
17509,1,1,1762,1220,-542
17510,1,0,203,0,-203
17511,0,0,0,0,0
17512,1,0,9,0,-9
17513,1,0,20,0,-20
17514,1,0,0,0,0
17515,0,0,29,0,-29
17516,1,1,397,1239,842
17517,1,0,0,0,0
17518,1,0,126,0,-126
17519,0,0,103,0,-103
17520,1,1,543,1693,1150
17521,1,0,12,0,-12
17522,1,0,35,0,-35
17523,1,0,7,0,-7
17524,1,0,106,0,-106
17525,0,0,51,0,-51
17526,0,0,85,0,-85
17527,0,0,9,0,-9
17528,0,0,115,0,-115
17529,1,1,691,1259,568
17530,1,0,5,0,-5
17531,1,1,1041,1901,860
17532,0,0,60,0,-60
17533,1,0,3,0,-3
17534,0,0,32,0,-32
17535,0,0,5,0,-5
17536,0,0,26,0,-26
17537,0,0,204,0,-204
17538,0,0,9,0,-9
17539,0,0,10,0,-10
17540,1,0,9,0,-9
17541,1,1,65,1579,1514
17542,0,0,28,0,-28
17543,0,0,202,0,-202
17544,1,1,285,1692,1407
17545,0,0,19,0,-19
17546,1,1,812,1206,394
17547,1,0,47,0,-47
17548,1,1,395,1231,836
17549,1,1,657,1345,688
17550,0,0,108,0,-108
17551,0,0,27,0,-27
17552,0,0,21,0,-21
17553,0,0,14,0,-14
17554,1,1,1672,1321,-351
17555,0,0,62,0,-62
17556,1,1,221,2160,1939
17557,0,0,10,0,-10
17558,0,0,118,0,-118
17559,1,1,88,1601,1513
17560,1,0,7,0,-7
17561,0,0,49,0,-49
17562,0,0,21,0,-21
17563,1,0,9,0,-9
17564,1,1,167,1827,1660
17565,1,1,464,1691,1227
17566,1,1,330,2256,1926
17567,0,0,16,0,-16
17568,1,1,176,1217,1041
17569,1,0,22,0,-22
17570,0,0,25,0,-25
17571,1,1,758,1203,445
17572,0,0,10,0,-10
17573,1,0,33,0,-33
17574,0,0,19,0,-19
17575,1,0,42,0,-42
17576,0,0,2,0,-2
17577,1,1,941,1399,458
17578,0,0,36,0,-36
17579,1,1,423,1447,1024
17580,1,0,124,0,-124
17581,1,1,178,1273,1095
17582,1,0,76,0,-76
17583,1,0,21,0,-21
17584,1,1,266,1966,1700
17585,0,0,241,0,-241
17586,0,0,72,0,-72
17587,1,1,153,1245,1092
17588,1,1,1412,4644,3232
17589,1,0,83,0,-83
17590,1,1,101,1258,1157
17591,1,0,16,0,-16
17592,0,0,7,0,-7
17593,1,0,39,0,-39
17594,1,1,1061,2739,1678
17595,0,0,46,0,-46
17596,0,0,54,0,-54
17597,1,1,700,1522,822
17598,1,1,576,1955,1379
17599,1,1,900,1344,444
17600,1,1,1099,1334,235
17601,0,0,62,0,-62
17602,1,0,90,0,-90
17603,1,1,40,1230,1190
17604,1,0,27,0,-27
17605,1,1,219,1418,1199
17606,0,0,27,0,-27
17607,0,0,18,0,-18
17608,1,1,1685,1385,-300
17609,0,0,55,0,-55
17610,1,1,1149,1715,566
17611,1,0,23,0,-23
17612,1,0,20,0,-20
17613,1,0,23,0,-23
17614,1,0,4,0,-4
17615,1,0,55,0,-55
17616,1,0,107,0,-107
17617,1,0,41,0,-41
17618,0,0,35,0,-35
17619,0,0,38,0,-38
17620,1,1,104,1604,1500
17621,0,0,45,0,-45
17622,1,0,87,0,-87
17623,0,0,53,0,-53
17624,1,1,103,1295,1192
17625,0,0,28,0,-28
17626,1,0,12,0,-12
17627,1,1,29,1459,1430
17628,1,1,127,1471,1344
17629,1,0,80,0,-80
17630,0,0,87,0,-87
17631,1,1,807,1456,649
17632,1,0,50,0,-50
17633,0,0,74,0,-74
17634,1,0,2,0,-2
17635,1,0,24,0,-24
17636,1,0,70,0,-70
17637,0,0,7,0,-7
17638,1,0,78,0,-78
17639,1,0,12,0,-12
17640,0,0,60,0,-60
17641,0,0,94,0,-94
17642,1,1,1630,1368,-262
17643,1,1,177,1370,1193
17644,1,1,43,1277,1234
17645,1,0,15,0,-15
17646,0,0,14,0,-14
17647,0,0,61,0,-61
17648,0,0,7,0,-7
17649,1,0,54,0,-54
17650,0,0,78,0,-78
17651,0,0,98,0,-98
17652,1,1,188,1403,1215
17653,1,1,660,1299,639
17654,1,1,311,1361,1050
17655,0,0,19,0,-19
17656,1,1,663,1309,646
17657,0,0,32,0,-32
17658,0,0,112,0,-112
17659,0,0,0,0,0
17660,0,0,12,0,-12
17661,1,1,853,2659,1806
17662,1,1,1194,1226,32
17663,1,0,21,0,-21
17664,1,1,667,1214,547
17665,0,0,103,0,-103
17666,1,1,126,2595,2469
17667,1,1,719,1640,921
17668,0,0,9,0,-9
17669,1,1,395,1290,895
17670,0,0,13,0,-13
17671,1,1,984,1526,542
17672,0,0,139,0,-139
17673,1,0,61,0,-61
17674,0,0,41,0,-41
17675,1,1,129,1244,1115
17676,1,1,85,2493,2408
17677,0,0,6,0,-6
17678,0,0,19,0,-19
17679,1,0,54,0,-54
17680,1,0,26,0,-26
17681,1,1,1303,1508,205
17682,0,0,200,0,-200
17683,0,0,51,0,-51
17684,1,0,50,0,-50
17685,0,0,28,0,-28
17686,0,0,29,0,-29
17687,1,1,67,1204,1137
17688,0,0,52,0,-52
17689,1,1,717,1752,1035
17690,1,0,70,0,-70
17691,0,0,47,0,-47
17692,1,0,7,0,-7
17693,0,0,116,0,-116
17694,0,0,15,0,-15
17695,1,0,57,0,-57
17696,1,0,21,0,-21
17697,1,1,416,1264,848
17698,1,0,82,0,-82
17699,1,1,945,1236,291
17700,1,1,88,1256,1168
17701,1,1,276,1320,1044
17702,0,0,3,0,-3
17703,0,0,42,0,-42
17704,0,0,17,0,-17
17705,1,1,249,1357,1108
17706,1,1,191,2965,2774
17707,0,0,45,0,-45
17708,1,1,31,2068,2037
17709,0,0,68,0,-68
17710,0,0,9,0,-9
17711,1,1,345,8830,8485
17712,1,0,12,0,-12
17713,1,0,152,0,-152
17714,1,1,317,1221,904
17715,1,1,265,1951,1686
17716,0,0,8,0,-8
17717,1,0,41,0,-41
17718,0,0,48,0,-48
17719,0,0,20,0,-20
17720,0,0,236,0,-236
17721,0,0,12,0,-12
17722,1,1,162,1617,1455
17723,0,0,11,0,-11
17724,1,0,90,0,-90
17725,0,0,62,0,-62
17726,1,0,34,0,-34
17727,1,0,98,0,-98
17728,1,1,598,2739,2141
17729,1,1,105,1430,1325
17730,0,0,17,0,-17
17731,1,0,0,0,0
17732,1,1,976,1516,540
17733,1,0,64,0,-64
17734,0,0,56,0,-56
17735,0,0,182,0,-182
17736,0,0,39,0,-39
17737,0,0,17,0,-17
17738,1,0,3,0,-3
17739,1,0,8,0,-8
17740,1,0,28,0,-28
17741,0,0,48,0,-48
17742,1,0,4,0,-4
17743,0,0,30,0,-30
17744,0,0,4,0,-4
17745,1,1,182,1271,1089
17746,1,0,5,0,-5
17747,0,0,22,0,-22
17748,1,0,67,0,-67
17749,1,0,28,0,-28
17750,1,0,11,0,-11
17751,0,0,85,0,-85
17752,0,0,4,0,-4
17753,1,1,464,1555,1091
17754,0,0,33,0,-33
17755,1,0,81,0,-81
17756,1,0,109,0,-109
17757,0,0,170,0,-170
17758,1,1,818,2230,1412
17759,0,0,4,0,-4
17760,0,0,39,0,-39
17761,1,0,120,0,-120
17762,1,0,18,0,-18
17763,1,1,714,1919,1205
17764,1,0,7,0,-7
17765,1,0,196,0,-196
17766,0,0,62,0,-62
17767,0,0,16,0,-16
17768,1,1,210,1449,1239
17769,0,0,32,0,-32
17770,1,0,128,0,-128
17771,1,1,593,1532,939
17772,0,0,10,0,-10
17773,1,1,2788,2458,-330
17774,1,0,42,0,-42
17775,1,1,450,8718,8268
17776,0,0,1,0,-1
17777,1,1,149,1219,1070
17778,0,0,8,0,-8
17779,1,0,11,0,-11
17780,1,1,756,1498,742
17781,0,0,8,0,-8
17782,1,1,134,1375,1241
17783,0,0,45,0,-45
17784,1,1,288,1255,967
17785,1,1,28,1700,1672
17786,1,1,355,2734,2379
17787,0,0,4,0,-4
17788,0,0,16,0,-16
17789,0,0,48,0,-48
17790,1,1,252,1559,1307
17791,1,1,163,1283,1120
17792,0,0,1,0,-1
17793,1,1,1546,1338,-208
17794,0,0,69,0,-69
17795,0,0,0,0,0
17796,1,0,49,0,-49
17797,0,0,47,0,-47
17798,1,0,81,0,-81
17799,1,0,121,0,-121
17800,0,0,93,0,-93
17801,0,0,62,0,-62
17802,0,0,3,0,-3
17803,0,0,0,0,0
17804,1,1,393,1451,1058
17805,1,1,199,1263,1064
17806,1,0,23,0,-23
17807,1,0,61,0,-61
17808,0,0,17,0,-17
17809,1,1,613,1255,642
17810,1,0,37,0,-37
17811,1,0,157,0,-157
17812,0,0,0,0,0
17813,1,0,52,0,-52
17814,1,1,466,1623,1157
17815,1,1,462,1442,980
17816,0,0,1,0,-1
17817,1,0,2,0,-2
17818,0,0,10,0,-10
17819,0,0,12,0,-12
17820,1,1,417,1311,894
17821,0,0,21,0,-21
17822,1,1,600,1362,762
17823,1,0,95,0,-95
17824,0,0,4,0,-4
17825,1,1,499,1666,1167
17826,1,0,19,0,-19
17827,1,1,356,1359,1003
17828,1,0,48,0,-48
17829,1,1,557,2183,1626
17830,0,0,22,0,-22
17831,1,0,1,0,-1
17832,1,0,7,0,-7
17833,1,1,289,1638,1349
17834,1,0,8,0,-8
17835,1,1,216,1318,1102
17836,1,1,1177,1772,595
17837,0,0,0,0,0
17838,1,0,35,0,-35
17839,0,0,19,0,-19
17840,1,0,46,0,-46
17841,0,0,124,0,-124
17842,1,1,287,2789,2502
17843,1,0,36,0,-36
17844,1,0,24,0,-24
17845,1,1,392,1245,853
17846,0,0,79,0,-79
17847,1,0,48,0,-48
17848,0,0,1,0,-1
17849,1,0,18,0,-18
17850,0,0,12,0,-12
17851,1,1,205,1241,1036
17852,1,1,1880,1351,-529
17853,1,0,63,0,-63
17854,1,0,23,0,-23
17855,0,0,211,0,-211
17856,1,1,264,1632,1368
17857,1,1,383,1269,886
17858,0,0,0,0,0
17859,0,0,52,0,-52
17860,0,0,13,0,-13
17861,1,0,158,0,-158
17862,0,0,60,0,-60
17863,0,0,64,0,-64
17864,0,0,35,0,-35
17865,1,1,1582,1617,35
17866,1,0,12,0,-12
17867,1,0,61,0,-61
17868,1,0,68,0,-68
17869,0,0,77,0,-77
17870,1,0,11,0,-11
17871,1,1,230,1277,1047
17872,0,0,33,0,-33
17873,1,1,399,1406,1007
17874,1,0,3,0,-3
17875,0,0,74,0,-74
17876,1,0,11,0,-11
17877,1,0,8,0,-8
17878,1,1,360,1201,841
17879,1,1,108,1426,1318
17880,0,0,7,0,-7
17881,1,0,2,0,-2
17882,0,0,31,0,-31
17883,0,0,1,0,-1
17884,1,1,227,1302,1075
17885,1,0,0,0,0
17886,1,0,143,0,-143
17887,1,1,14,1259,1245
17888,0,0,32,0,-32
17889,0,0,9,0,-9
17890,1,0,8,0,-8
17891,1,0,133,0,-133
17892,0,0,3,0,-3
17893,0,0,4,0,-4
17894,1,1,813,1401,588
17895,0,0,113,0,-113
17896,1,0,45,0,-45
17897,1,1,122,3137,3015
17898,0,0,39,0,-39
17899,1,1,308,1576,1268
17900,1,1,680,1538,858
17901,1,1,54,1285,1231
17902,1,0,114,0,-114
17903,1,0,14,0,-14
17904,1,1,5,1234,1229
17905,1,0,56,0,-56
17906,1,0,18,0,-18
17907,1,0,132,0,-132
17908,1,0,44,0,-44
17909,1,1,410,1330,920
17910,1,0,64,0,-64
17911,0,0,6,0,-6
17912,1,1,389,1467,1078
17913,1,0,63,0,-63
17914,0,0,41,0,-41
17915,0,0,61,0,-61
17916,1,0,63,0,-63
17917,0,0,82,0,-82
17918,1,0,107,0,-107
17919,1,1,959,1388,429
17920,0,0,15,0,-15
17921,1,0,71,0,-71
17922,0,0,3,0,-3
17923,1,1,210,1467,1257
17924,0,0,48,0,-48
17925,1,1,167,3982,3815
17926,0,0,215,0,-215
17927,0,0,50,0,-50
17928,0,0,43,0,-43
17929,0,0,33,0,-33
17930,0,0,3,0,-3
17931,1,1,53,1278,1225
17932,1,0,25,0,-25
17933,0,0,54,0,-54
17934,1,0,84,0,-84
17935,1,1,501,1517,1016
17936,1,1,302,2715,2413
17937,0,0,90,0,-90
17938,1,1,713,1582,869
17939,1,0,15,0,-15
17940,1,1,1149,1207,58
17941,1,1,220,1317,1097
17942,0,0,35,0,-35
17943,1,0,137,0,-137
17944,0,0,3,0,-3
17945,1,1,78,1394,1316
17946,1,0,57,0,-57
17947,1,1,307,1658,1351
17948,1,0,50,0,-50
17949,1,0,8,0,-8
17950,1,1,87,1337,1250
17951,0,0,26,0,-26
17952,0,0,27,0,-27
17953,1,0,82,0,-82
17954,0,0,0,0,0
17955,1,0,12,0,-12
17956,0,0,66,0,-66
17957,1,0,88,0,-88
17958,1,1,43,1293,1250
17959,1,1,116,1839,1723
17960,0,0,20,0,-20
17961,1,0,36,0,-36
17962,1,1,1352,1386,34
17963,0,0,2,0,-2
17964,0,0,32,0,-32
17965,1,0,39,0,-39
17966,1,0,11,0,-11
17967,0,0,0,0,0
17968,1,0,25,0,-25
17969,0,0,17,0,-17
17970,0,0,31,0,-31
17971,0,0,3,0,-3
17972,1,1,578,1922,1344
17973,1,0,26,0,-26
17974,0,0,58,0,-58
17975,1,0,3,0,-3
17976,0,0,28,0,-28
17977,1,1,197,2020,1823
17978,0,0,148,0,-148
17979,0,0,39,0,-39
17980,0,0,34,0,-34
17981,1,0,29,0,-29
17982,1,1,145,1276,1131
17983,1,0,95,0,-95
17984,1,1,1269,1488,219
17985,1,0,18,0,-18
17986,0,0,29,0,-29
17987,1,1,238,1252,1014
17988,1,1,179,1222,1043
17989,0,0,83,0,-83
17990,1,1,276,1935,1659
17991,0,0,22,0,-22
17992,0,0,62,0,-62
17993,1,0,50,0,-50
17994,1,1,62,1726,1664
17995,1,0,48,0,-48
17996,0,0,3,0,-3
17997,0,0,7,0,-7
17998,0,0,12,0,-12
17999,1,0,52,0,-52
18000,0,0,17,0,-17
18001,1,1,390,2201,1811
18002,0,0,38,0,-38
18003,0,0,46,0,-46
18004,0,0,26,0,-26
18005,1,1,116,1240,1124
18006,1,0,11,0,-11
18007,0,0,58,0,-58
18008,1,0,24,0,-24
18009,0,0,59,0,-59
18010,1,1,291,1359,1068
18011,1,0,248,0,-248
18012,1,1,293,3000,2707
18013,1,1,234,1871,1637
18014,0,0,5,0,-5
18015,1,0,21,0,-21
18016,1,0,23,0,-23
18017,1,1,1886,2133,247
18018,1,0,89,0,-89
18019,0,0,18,0,-18
18020,0,0,10,0,-10
18021,0,0,4,0,-4
18022,1,1,158,1327,1169
18023,0,0,60,0,-60
18024,1,0,103,0,-103
18025,1,1,398,1276,878
18026,0,0,43,0,-43
18027,0,0,9,0,-9
18028,1,1,85,1403,1318
18029,0,0,32,0,-32
18030,1,1,754,1319,565
18031,0,0,63,0,-63
18032,0,0,176,0,-176
18033,1,1,65,3055,2990
18034,1,1,180,1513,1333
18035,1,0,30,0,-30
18036,1,0,74,0,-74
18037,0,0,71,0,-71
18038,0,0,51,0,-51
18039,1,0,205,0,-205
18040,1,1,299,1415,1116
18041,0,0,25,0,-25
18042,0,0,57,0,-57
18043,0,0,7,0,-7
18044,1,0,35,0,-35
18045,1,0,103,0,-103
18046,1,0,84,0,-84
18047,1,0,1,0,-1
18048,0,0,129,0,-129
18049,0,0,29,0,-29
18050,1,0,25,0,-25
18051,1,1,776,1271,495
18052,1,1,892,2699,1807
18053,0,0,12,0,-12
18054,0,0,15,0,-15
18055,1,1,221,1230,1009
18056,1,1,65,1430,1365
18057,0,0,37,0,-37
18058,1,0,38,0,-38
18059,1,1,812,1724,912
18060,0,0,77,0,-77
18061,0,0,62,0,-62
18062,0,0,71,0,-71
18063,0,0,21,0,-21
18064,0,0,10,0,-10
18065,0,0,16,0,-16
18066,1,0,40,0,-40
18067,1,0,88,0,-88
18068,1,1,262,1635,1373
18069,1,0,8,0,-8
18070,0,0,2,0,-2
18071,1,1,421,1342,921
18072,1,1,116,1518,1402
18073,0,0,52,0,-52
18074,1,0,23,0,-23
18075,0,0,145,0,-145
18076,1,1,356,2056,1700
18077,1,0,72,0,-72
18078,1,1,225,1253,1028
18079,1,1,370,1380,1010
18080,1,1,731,1227,496
18081,0,0,8,0,-8
18082,0,0,95,0,-95
18083,1,1,250,1243,993
18084,0,0,68,0,-68
18085,1,0,74,0,-74
18086,0,0,25,0,-25
18087,0,0,2,0,-2
18088,1,1,267,1615,1348
18089,1,0,12,0,-12
18090,1,0,62,0,-62
18091,1,0,36,0,-36
18092,1,1,1252,1246,-6
18093,0,0,138,0,-138
18094,0,0,102,0,-102
18095,1,0,46,0,-46
18096,1,1,587,1348,761
18097,1,1,306,2054,1748
18098,1,0,26,0,-26
18099,1,0,37,0,-37
18100,1,0,15,0,-15
18101,1,1,241,1337,1096
18102,0,0,13,0,-13
18103,0,0,66,0,-66
18104,1,1,125,1500,1375
18105,0,0,71,0,-71
18106,0,0,117,0,-117
18107,0,0,34,0,-34
18108,1,1,41,1533,1492
18109,0,0,4,0,-4
18110,1,1,16,1661,1645
18111,0,0,10,0,-10
18112,0,0,1,0,-1
18113,0,0,120,0,-120
18114,0,0,0,0,0
18115,0,0,15,0,-15
18116,1,0,181,0,-181
18117,1,0,42,0,-42
18118,0,0,84,0,-84
18119,1,1,1051,1252,201
18120,0,0,34,0,-34
18121,1,0,3,0,-3
18122,1,0,24,0,-24
18123,1,0,31,0,-31
18124,0,0,33,0,-33
18125,1,0,9,0,-9
18126,1,0,123,0,-123
18127,1,1,1366,1728,362
18128,0,0,5,0,-5
18129,0,0,32,0,-32
18130,0,0,29,0,-29
18131,1,1,388,2783,2395
18132,0,0,52,0,-52
18133,1,0,7,0,-7
18134,0,0,15,0,-15
18135,0,0,59,0,-59
18136,0,0,19,0,-19
18137,1,1,307,1654,1347
18138,1,1,291,1280,989
18139,0,0,156,0,-156
18140,1,0,2,0,-2
18141,1,0,18,0,-18
18142,1,0,19,0,-19
18143,1,0,18,0,-18
18144,1,0,49,0,-49
18145,0,0,122,0,-122
18146,1,0,1,0,-1
18147,0,0,112,0,-112
18148,1,1,190,1294,1104
18149,1,1,1215,1273,58
18150,1,1,179,1386,1207
18151,1,0,52,0,-52
18152,0,0,0,0,0
18153,1,0,30,0,-30
18154,1,1,1735,1520,-215
18155,1,1,211,1701,1490
18156,1,1,725,1550,825
18157,0,0,34,0,-34
18158,0,0,114,0,-114
18159,1,0,115,0,-115
18160,1,1,87,1275,1188
18161,0,0,44,0,-44
18162,0,0,277,0,-277
18163,1,0,190,0,-190
18164,0,0,0,0,0
18165,1,1,152,1280,1128
18166,0,0,67,0,-67
18167,1,0,103,0,-103
18168,1,0,52,0,-52
18169,0,0,26,0,-26
18170,1,0,11,0,-11
18171,1,1,333,1238,905
18172,0,0,66,0,-66
18173,1,0,40,0,-40
18174,0,0,28,0,-28
18175,0,0,59,0,-59
18176,0,0,5,0,-5
18177,0,0,50,0,-50
18178,1,0,8,0,-8
18179,1,1,569,1313,744
18180,1,1,117,1446,1329
18181,0,0,28,0,-28
18182,0,0,47,0,-47
18183,1,1,936,1679,743
18184,1,0,7,0,-7
18185,0,0,56,0,-56
18186,1,0,75,0,-75
18187,1,1,1064,1790,726
18188,1,0,4,0,-4
18189,0,0,34,0,-34
18190,0,0,5,0,-5
18191,1,0,142,0,-142
18192,1,0,8,0,-8
18193,1,0,90,0,-90
18194,1,1,505,1245,740
18195,1,1,649,1491,842
18196,0,0,87,0,-87
18197,0,0,17,0,-17
18198,1,1,1890,1426,-464
18199,1,1,315,1209,894
18200,1,1,442,1802,1360
18201,1,0,23,0,-23
18202,1,0,40,0,-40
18203,1,1,714,2156,1442
18204,1,1,355,1566,1211
18205,1,1,271,1257,986
18206,1,1,198,1351,1153
18207,1,0,82,0,-82
18208,0,0,62,0,-62
18209,1,1,429,1276,847
18210,0,0,41,0,-41
18211,1,0,11,0,-11
18212,1,0,3,0,-3
18213,1,0,130,0,-130
18214,1,0,4,0,-4
18215,1,1,810,1355,545
18216,0,0,1,0,-1
18217,0,0,1,0,-1
18218,1,1,208,1309,1101
18219,1,1,365,1773,1408
18220,1,0,9,0,-9
18221,0,0,16,0,-16
18222,1,1,71,1566,1495
18223,0,0,22,0,-22
18224,1,1,294,1332,1038
18225,0,0,23,0,-23
18226,0,0,3,0,-3
18227,1,1,909,1212,303
18228,0,0,9,0,-9
18229,0,0,7,0,-7
18230,0,0,32,0,-32
18231,0,0,1,0,-1
18232,1,0,140,0,-140
18233,1,0,44,0,-44
18234,1,1,1540,1601,61
18235,1,0,14,0,-14
18236,0,0,32,0,-32
18237,1,0,20,0,-20
18238,0,0,30,0,-30
18239,0,0,3,0,-3
18240,0,0,31,0,-31
18241,1,1,1627,1687,60
18242,1,0,16,0,-16
18243,0,0,137,0,-137
18244,1,1,37,1204,1167
18245,1,1,512,1503,991
18246,1,0,70,0,-70
18247,0,0,49,0,-49
18248,1,1,1154,5137,3983
18249,0,0,4,0,-4
18250,0,0,24,0,-24
18251,0,0,101,0,-101
18252,1,0,65,0,-65
18253,0,0,51,0,-51
18254,1,1,844,1210,366
18255,0,0,40,0,-40
18256,1,1,865,1743,878
18257,0,0,35,0,-35
18258,1,1,1995,1622,-373
18259,1,0,16,0,-16
18260,1,0,24,0,-24
18261,0,0,16,0,-16
18262,0,0,35,0,-35
18263,0,0,35,0,-35
18264,1,0,58,0,-58
18265,1,0,161,0,-161
18266,0,0,40,0,-40
18267,1,1,100,1509,1409
18268,0,0,94,0,-94
18269,1,0,32,0,-32
18270,1,1,786,1225,439
18271,1,1,50,1789,1739
18272,1,1,235,1595,1360
18273,1,0,18,0,-18
18274,1,0,8,0,-8
18275,1,1,163,1201,1038
18276,1,0,12,0,-12
18277,1,0,48,0,-48
18278,0,0,38,0,-38
18279,1,1,827,2202,1375
18280,1,0,12,0,-12
18281,1,0,78,0,-78
18282,0,0,126,0,-126
18283,1,0,80,0,-80
18284,1,0,52,0,-52
18285,1,0,67,0,-67
18286,0,0,29,0,-29
18287,1,1,73,3688,3615
18288,1,0,21,0,-21
18289,0,0,117,0,-117
18290,1,0,53,0,-53
18291,0,0,20,0,-20
18292,1,0,27,0,-27
18293,1,1,648,1443,795
18294,1,1,105,3692,3587
18295,0,0,1,0,-1
18296,1,0,9,0,-9
18297,0,0,101,0,-101
18298,1,0,48,0,-48
18299,1,0,44,0,-44
18300,1,1,656,2497,1841
18301,0,0,12,0,-12
18302,1,0,204,0,-204
18303,0,0,136,0,-136
18304,0,0,0,0,0
18305,1,0,12,0,-12
18306,0,0,2,0,-2
18307,0,0,133,0,-133
18308,0,0,27,0,-27
18309,1,1,147,2895,2748
18310,1,0,1,0,-1
18311,0,0,5,0,-5
18312,1,0,13,0,-13
18313,0,0,28,0,-28
18314,1,1,1244,1206,-38
18315,0,0,24,0,-24
18316,1,0,46,0,-46
18317,0,0,18,0,-18
18318,1,0,118,0,-118
18319,1,0,84,0,-84
18320,1,1,376,1225,849
18321,0,0,117,0,-117
18322,0,0,58,0,-58
18323,1,1,556,1262,706
18324,1,1,519,2260,1741
18325,0,0,38,0,-38
18326,0,0,30,0,-30
18327,0,0,9,0,-9
18328,1,0,147,0,-147
18329,0,0,14,0,-14
18330,0,0,1,0,-1
18331,1,0,175,0,-175
18332,0,0,10,0,-10
18333,1,1,1401,1574,173
18334,1,1,319,1246,927
18335,1,0,24,0,-24
18336,1,0,110,0,-110
18337,1,1,475,1536,1061
18338,1,0,13,0,-13
18339,1,1,691,2821,2130
18340,1,1,853,1353,500
18341,0,0,13,0,-13
18342,1,0,66,0,-66
18343,1,0,93,0,-93
18344,1,1,975,1754,779
18345,1,0,42,0,-42
18346,0,0,7,0,-7
18347,1,0,7,0,-7
18348,0,0,68,0,-68
18349,1,1,1149,1254,105
18350,1,1,419,1362,943
18351,1,1,383,1333,950
18352,1,1,4247,1458,-2789
18353,0,0,43,0,-43
18354,1,1,636,1469,833
18355,1,0,15,0,-15
18356,0,0,7,0,-7
18357,0,0,141,0,-141
18358,1,0,108,0,-108
18359,0,0,74,0,-74
18360,1,0,13,0,-13
18361,1,1,721,1459,738
18362,1,0,23,0,-23
18363,1,0,139,0,-139
18364,1,0,48,0,-48
18365,1,1,266,1610,1344
18366,1,1,54,1521,1467
18367,0,0,39,0,-39
18368,0,0,96,0,-96
18369,1,1,247,4202,3955
18370,1,0,166,0,-166
18371,1,0,32,0,-32
18372,1,1,322,1446,1124
18373,1,1,129,1217,1088
18374,1,1,690,1952,1262
18375,1,1,1084,1254,170
18376,1,1,402,1409,1007
18377,0,0,37,0,-37
18378,1,1,580,1301,721
18379,1,0,9,0,-9
18380,1,1,1152,1229,77
18381,1,0,30,0,-30
18382,1,1,405,1641,1236
18383,1,0,9,0,-9
18384,1,0,35,0,-35
18385,1,0,19,0,-19
18386,1,1,236,1503,1267
18387,1,0,11,0,-11
18388,0,0,9,0,-9
18389,1,0,134,0,-134
18390,1,0,61,0,-61
18391,1,0,42,0,-42
18392,0,0,107,0,-107
18393,0,0,70,0,-70
18394,0,0,66,0,-66
18395,1,0,79,0,-79
18396,0,0,2,0,-2
18397,1,1,122,1607,1485
18398,0,0,8,0,-8
18399,0,0,37,0,-37
18400,1,1,515,1217,702
18401,1,0,30,0,-30
18402,1,0,94,0,-94
18403,1,0,64,0,-64
18404,1,1,239,2304,2065
18405,0,0,87,0,-87
18406,1,1,416,1283,867
18407,1,1,1037,1440,403
18408,0,0,1,0,-1
18409,0,0,49,0,-49
18410,1,0,20,0,-20
18411,1,1,553,1425,872
18412,1,1,186,1637,1451
18413,0,0,10,0,-10
18414,0,0,3,0,-3
18415,1,0,9,0,-9
18416,1,1,1744,1433,-311
18417,0,0,198,0,-198
18418,1,1,629,1671,1042
18419,0,0,78,0,-78
18420,1,0,23,0,-23
18421,1,0,7,0,-7
18422,1,1,124,1252,1128
18423,1,1,1111,1493,382
18424,0,0,9,0,-9
18425,1,0,20,0,-20
18426,1,0,11,0,-11
18427,1,0,15,0,-15
18428,1,1,214,2173,1959
18429,1,0,53,0,-53
18430,1,0,13,0,-13
18431,0,0,33,0,-33
18432,0,0,97,0,-97
18433,1,1,309,1230,921
18434,1,1,353,1507,1154
18435,0,0,4,0,-4
18436,0,0,46,0,-46
18437,1,1,790,1774,984
18438,1,1,537,1318,781
18439,1,1,355,2954,2599
18440,0,0,95,0,-95
18441,1,0,49,0,-49
18442,1,0,13,0,-13
18443,0,0,27,0,-27
18444,1,1,672,1518,846
18445,1,1,884,1259,375
18446,0,0,29,0,-29
18447,1,0,81,0,-81
18448,0,0,124,0,-124
18449,1,1,1750,1405,-345
18450,1,1,54,1760,1706
18451,1,1,2245,2560,315
18452,0,0,121,0,-121
18453,1,1,447,1436,989
18454,0,0,77,0,-77
18455,0,0,35,0,-35
18456,0,0,67,0,-67
18457,1,0,70,0,-70
18458,1,0,166,0,-166
18459,1,1,1053,1609,556
18460,1,0,10,0,-10
18461,1,0,24,0,-24
18462,1,1,67,2075,2008
18463,0,0,18,0,-18
18464,0,0,21,0,-21
18465,1,1,729,1203,474
18466,0,0,101,0,-101
18467,0,0,0,0,0
18468,0,0,19,0,-19
18469,1,1,270,2091,1821
18470,1,1,97,1371,1274
18471,1,1,467,1395,928
18472,0,0,70,0,-70
18473,1,1,557,1235,678
18474,1,1,1218,1207,-11
18475,0,0,15,0,-15
18476,0,0,81,0,-81
18477,1,1,1892,1772,-120
18478,1,1,173,1991,1818
18479,1,0,22,0,-22
18480,1,0,45,0,-45
18481,0,0,2,0,-2
18482,0,0,10,0,-10
18483,1,1,103,1230,1127
18484,0,0,10,0,-10
18485,1,0,4,0,-4
18486,1,1,223,1236,1013
18487,1,0,72,0,-72
18488,1,1,944,1725,781
18489,1,0,171,0,-171
18490,1,1,456,1402,946
18491,1,0,8,0,-8
18492,1,0,6,0,-6
18493,0,0,82,0,-82
18494,0,0,5,0,-5
18495,0,0,6,0,-6
18496,1,1,606,2257,1651
18497,1,0,138,0,-138
18498,1,1,635,1394,759
18499,1,0,51,0,-51
18500,0,0,32,0,-32
18501,0,0,88,0,-88
18502,0,0,45,0,-45
18503,1,1,846,1314,468
18504,1,0,2,0,-2
18505,0,0,8,0,-8
18506,1,1,126,1508,1382
18507,1,1,1051,1470,419
18508,0,0,35,0,-35
18509,1,0,20,0,-20
18510,1,0,0,0,0
18511,1,1,216,1258,1042
18512,1,0,25,0,-25
18513,1,1,611,2667,2056
18514,0,0,25,0,-25
18515,0,0,101,0,-101
18516,0,0,10,0,-10
18517,0,0,69,0,-69
18518,1,0,134,0,-134
18519,1,0,60,0,-60
18520,1,1,1204,1231,27
18521,0,0,2,0,-2
18522,1,0,17,0,-17
18523,0,0,35,0,-35
18524,1,0,91,0,-91
18525,0,0,15,0,-15
18526,1,1,275,1548,1273
18527,1,1,306,2856,2550
18528,1,0,64,0,-64
18529,1,1,614,1606,992
18530,0,0,82,0,-82
18531,0,0,81,0,-81
18532,1,1,222,1394,1172
18533,1,1,527,1345,818
18534,1,1,114,1954,1840
18535,0,0,35,0,-35
18536,1,0,6,0,-6
18537,1,0,58,0,-58
18538,1,1,386,1564,1178
18539,0,0,7,0,-7
18540,1,1,652,2052,1400
18541,1,0,12,0,-12
18542,1,1,168,1791,1623
18543,1,0,50,0,-50
18544,1,1,1099,1679,580
18545,0,0,48,0,-48
18546,1,0,2,0,-2
18547,0,0,32,0,-32
18548,0,0,83,0,-83
18549,0,0,78,0,-78
18550,1,0,15,0,-15
18551,1,0,82,0,-82
18552,0,0,78,0,-78
18553,1,1,2399,1319,-1080
18554,0,0,100,0,-100
18555,1,0,157,0,-157
18556,1,0,138,0,-138
18557,0,0,16,0,-16
18558,0,0,22,0,-22
18559,1,1,158,2433,2275
18560,1,1,199,1246,1047
18561,0,0,13,0,-13
18562,0,0,178,0,-178
18563,1,1,75,1336,1261
18564,1,0,62,0,-62
18565,1,1,713,1753,1040
18566,0,0,185,0,-185
18567,1,1,790,1538,748
18568,1,0,45,0,-45
18569,1,1,365,2234,1869
18570,1,0,30,0,-30
18571,0,0,15,0,-15
18572,1,1,1688,1300,-388
18573,1,1,876,1330,454
18574,0,0,38,0,-38
18575,0,0,3,0,-3
18576,1,1,327,3493,3166
18577,1,1,320,1630,1310
18578,0,0,48,0,-48
18579,0,0,87,0,-87
18580,1,1,236,2225,1989
18581,0,0,3,0,-3
18582,1,1,910,1574,664
18583,1,1,966,1509,543
18584,0,0,115,0,-115
18585,1,1,243,1444,1201
18586,1,0,34,0,-34
18587,1,1,217,1221,1004
18588,1,1,1646,1221,-425
18589,0,0,19,0,-19
18590,1,0,47,0,-47
18591,1,1,2026,1705,-321
18592,0,0,34,0,-34
18593,0,0,57,0,-57
18594,1,1,285,3433,3148
18595,0,0,15,0,-15
18596,1,0,13,0,-13
18597,0,0,38,0,-38
18598,1,1,1500,1257,-243
18599,1,1,1085,1560,475
18600,1,0,48,0,-48
18601,1,0,40,0,-40
18602,1,1,674,1364,690
18603,0,0,18,0,-18
18604,0,0,230,0,-230
18605,0,0,58,0,-58
18606,1,1,1108,1486,378
18607,1,0,57,0,-57
18608,0,0,33,0,-33
18609,1,0,64,0,-64
18610,1,0,7,0,-7
18611,0,0,2,0,-2
18612,0,0,3,0,-3
18613,1,0,34,0,-34
18614,0,0,43,0,-43
18615,1,1,76,1530,1454
18616,0,0,75,0,-75
18617,1,1,180,1394,1214
18618,1,1,1123,1701,578
18619,0,0,4,0,-4
18620,0,0,164,0,-164
18621,1,0,57,0,-57
18622,0,0,69,0,-69
18623,1,0,10,0,-10
18624,1,0,5,0,-5
18625,1,0,62,0,-62
18626,1,1,179,1706,1527
18627,1,0,19,0,-19
18628,1,0,2,0,-2
18629,1,0,48,0,-48
18630,1,1,190,1499,1309
18631,0,0,98,0,-98
18632,1,0,94,0,-94
18633,1,0,2,0,-2
18634,1,1,456,1625,1169
18635,0,0,19,0,-19
18636,0,0,43,0,-43
18637,0,0,51,0,-51
18638,1,0,17,0,-17
18639,0,0,9,0,-9
18640,0,0,69,0,-69
18641,0,0,6,0,-6
18642,0,0,25,0,-25
18643,0,0,15,0,-15
18644,0,0,16,0,-16
18645,1,0,17,0,-17
18646,1,1,97,1597,1500
18647,1,0,10,0,-10
18648,1,1,545,1974,1429
18649,1,0,14,0,-14
18650,1,1,699,2380,1681
18651,1,0,90,0,-90
18652,1,0,9,0,-9
18653,0,0,2,0,-2
18654,1,1,140,1255,1115
18655,1,1,209,1964,1755
18656,0,0,79,0,-79
18657,0,0,8,0,-8
18658,1,0,11,0,-11
18659,0,0,67,0,-67
18660,1,0,32,0,-32
18661,1,0,65,0,-65
18662,1,0,95,0,-95
18663,1,1,1303,1228,-75
18664,1,1,436,1320,884
18665,0,0,8,0,-8
18666,1,1,1494,4316,2822
18667,0,0,11,0,-11
18668,0,0,21,0,-21
18669,0,0,49,0,-49
18670,0,0,17,0,-17
18671,1,0,16,0,-16
18672,1,0,27,0,-27
18673,1,1,1348,1650,302
18674,1,1,801,1207,406
18675,0,0,1,0,-1
18676,1,1,264,1287,1023
18677,0,0,33,0,-33
18678,1,1,18,2170,2152
18679,0,0,45,0,-45
18680,1,0,85,0,-85
18681,1,0,71,0,-71
18682,0,0,81,0,-81
18683,1,1,1170,1223,53
18684,0,0,32,0,-32
18685,1,0,42,0,-42
18686,1,0,73,0,-73
18687,1,1,1585,1240,-345
18688,0,0,11,0,-11
18689,1,0,104,0,-104
18690,1,1,648,2048,1400
18691,0,0,49,0,-49
18692,1,1,909,1376,467
18693,1,1,144,1242,1098
18694,0,0,47,0,-47
18695,1,0,68,0,-68
18696,1,1,1388,1542,154
18697,0,0,31,0,-31
18698,1,0,71,0,-71
18699,1,1,508,1657,1149
18700,1,1,634,1344,710
18701,0,0,24,0,-24
18702,1,0,7,0,-7
18703,1,0,26,0,-26
18704,1,0,108,0,-108
18705,0,0,8,0,-8
18706,1,0,45,0,-45
18707,0,0,2,0,-2
18708,1,0,153,0,-153
18709,1,0,89,0,-89
18710,1,0,4,0,-4
18711,1,1,486,1902,1416
18712,0,0,93,0,-93
18713,0,0,246,0,-246
18714,1,0,169,0,-169
18715,1,1,605,1276,671
18716,0,0,14,0,-14
18717,1,0,6,0,-6
18718,1,0,45,0,-45
18719,1,0,14,0,-14
18720,1,1,223,1706,1483
18721,0,0,171,0,-171
18722,1,0,12,0,-12
18723,1,0,24,0,-24
18724,0,0,11,0,-11
18725,1,0,82,0,-82
18726,0,0,11,0,-11
18727,1,0,58,0,-58
18728,1,1,478,1344,866
18729,0,0,25,0,-25
18730,1,1,327,1697,1370
18731,1,0,16,0,-16
18732,1,1,205,1536,1331
18733,0,0,40,0,-40
18734,0,0,99,0,-99
18735,1,0,72,0,-72
18736,0,0,98,0,-98
18737,1,0,1,0,-1
18738,1,1,86,1861,1775
18739,0,0,100,0,-100
18740,1,0,81,0,-81
18741,1,1,65,3201,3136
18742,0,0,12,0,-12
18743,0,0,11,0,-11
18744,1,0,76,0,-76
18745,0,0,35,0,-35
18746,1,1,1290,1934,644
18747,1,1,213,1265,1052
18748,1,1,636,1672,1036
18749,1,1,1049,1417,368
18750,1,1,77,1355,1278
18751,0,0,18,0,-18
18752,0,0,40,0,-40
18753,1,0,47,0,-47
18754,0,0,102,0,-102
18755,1,1,880,2088,1208
18756,1,1,367,1950,1583
18757,0,0,70,0,-70
18758,0,0,13,0,-13
18759,0,0,9,0,-9
18760,1,1,107,1346,1239
18761,1,1,40,1729,1689
18762,1,0,42,0,-42
18763,0,0,13,0,-13
18764,0,0,69,0,-69
18765,0,0,43,0,-43
18766,1,0,34,0,-34
18767,0,0,21,0,-21
18768,1,0,51,0,-51
18769,1,1,287,1550,1263
18770,0,0,2,0,-2
18771,1,1,2001,1284,-717
18772,0,0,51,0,-51
18773,1,0,38,0,-38
18774,1,0,42,0,-42
18775,0,0,2,0,-2
18776,1,0,56,0,-56
18777,0,0,52,0,-52
18778,0,0,45,0,-45
18779,0,0,33,0,-33
18780,0,0,7,0,-7
18781,1,1,1368,1229,-139
18782,0,0,45,0,-45
18783,1,0,33,0,-33
18784,1,1,513,1248,735
18785,0,0,31,0,-31
18786,1,1,860,4265,3405
18787,1,1,1025,1295,270
18788,1,0,130,0,-130
18789,1,1,67,1346,1279
18790,1,1,501,1273,772
18791,0,0,33,0,-33
18792,1,1,665,1632,967
18793,0,0,89,0,-89
18794,0,0,45,0,-45
18795,1,0,85,0,-85
18796,1,1,740,1342,602
18797,1,1,1196,1254,58
18798,0,0,59,0,-59
18799,0,0,163,0,-163
18800,1,0,70,0,-70
18801,1,1,1603,1266,-337
18802,1,1,263,1430,1167
18803,0,0,4,0,-4
18804,0,0,21,0,-21
18805,1,1,316,1224,908
18806,0,0,39,0,-39
18807,0,0,56,0,-56
18808,0,0,15,0,-15
18809,1,0,5,0,-5
18810,0,0,106,0,-106
18811,1,1,1381,1259,-122
18812,1,1,940,1992,1052
18813,0,0,7,0,-7
18814,1,0,60,0,-60
18815,1,1,372,1208,836
18816,0,0,49,0,-49
18817,1,0,155,0,-155
18818,1,0,43,0,-43
18819,0,0,42,0,-42
18820,1,0,11,0,-11
18821,1,0,4,0,-4
18822,1,1,275,1489,1214
18823,1,1,1193,1235,42
18824,1,1,1155,1712,557
18825,1,0,15,0,-15
18826,1,0,149,0,-149
18827,1,1,170,2324,2154
18828,1,0,9,0,-9
18829,0,0,32,0,-32
18830,1,0,31,0,-31
18831,1,0,226,0,-226
18832,1,1,152,1295,1143
18833,1,0,2,0,-2
18834,0,0,38,0,-38
18835,1,0,49,0,-49
18836,0,0,0,0,0
18837,0,0,68,0,-68
18838,1,0,47,0,-47
18839,0,0,77,0,-77
18840,0,0,68,0,-68
18841,0,0,33,0,-33
18842,0,0,11,0,-11
18843,1,1,107,1236,1129
18844,1,0,37,0,-37
18845,1,1,194,1348,1154
18846,0,0,56,0,-56
18847,1,0,13,0,-13
18848,1,0,38,0,-38
18849,1,1,139,1550,1411
18850,1,1,23,1800,1777
18851,0,0,3,0,-3
18852,0,0,47,0,-47
18853,1,1,893,1513,620
18854,1,0,92,0,-92
18855,0,0,8,0,-8
18856,0,0,58,0,-58
18857,1,0,41,0,-41
18858,1,0,76,0,-76
18859,1,0,36,0,-36
18860,0,0,2,0,-2
18861,1,0,134,0,-134
18862,0,0,1,0,-1
18863,1,0,246,0,-246
18864,0,0,15,0,-15
18865,0,0,40,0,-40
18866,0,0,5,0,-5
18867,1,0,40,0,-40
18868,1,0,21,0,-21
18869,1,1,542,1631,1089
18870,1,0,63,0,-63
18871,0,0,35,0,-35
18872,0,0,119,0,-119
18873,1,0,34,0,-34
18874,1,0,51,0,-51
18875,1,0,7,0,-7
18876,1,1,227,1508,1281
18877,0,0,36,0,-36
18878,0,0,28,0,-28
18879,1,0,23,0,-23
18880,0,0,68,0,-68
18881,1,1,136,1381,1245
18882,1,1,435,1235,800
18883,0,0,84,0,-84
18884,1,1,264,1515,1251
18885,0,0,12,0,-12
18886,0,0,21,0,-21
18887,1,0,64,0,-64
18888,0,0,11,0,-11
18889,0,0,40,0,-40
18890,1,1,3801,1226,-2575
18891,1,0,100,0,-100
18892,0,0,88,0,-88
18893,1,1,369,1706,1337
18894,0,0,10,0,-10
18895,1,0,69,0,-69
18896,0,0,48,0,-48
18897,0,0,18,0,-18
18898,1,1,317,1243,926
18899,1,0,52,0,-52
18900,1,1,591,1251,660
18901,0,0,25,0,-25
18902,1,1,123,1892,1769
18903,1,1,166,2701,2535
18904,0,0,11,0,-11
18905,1,1,2122,1238,-884
18906,0,0,140,0,-140
18907,0,0,119,0,-119
18908,0,0,2,0,-2
18909,0,0,22,0,-22
18910,1,0,136,0,-136
18911,1,1,420,1214,794
18912,1,0,54,0,-54
18913,0,0,21,0,-21
18914,0,0,27,0,-27
18915,0,0,6,0,-6
18916,1,1,692,1222,530
18917,1,0,4,0,-4
18918,1,1,209,1238,1029
18919,0,0,42,0,-42
18920,0,0,114,0,-114
18921,1,1,456,1244,788
18922,1,0,44,0,-44
18923,0,0,74,0,-74
18924,1,1,242,1588,1346
18925,0,0,71,0,-71
18926,1,0,80,0,-80
18927,0,0,44,0,-44
18928,1,1,989,3714,2725
18929,1,0,9,0,-9
18930,1,1,214,1855,1641
18931,0,0,2,0,-2
18932,1,1,672,1280,608
18933,0,0,147,0,-147
18934,1,0,21,0,-21
18935,0,0,26,0,-26
18936,0,0,28,0,-28
18937,0,0,5,0,-5
18938,1,0,33,0,-33
18939,0,0,11,0,-11
18940,0,0,39,0,-39
18941,0,0,0,0,0
18942,0,0,21,0,-21
18943,1,1,286,1571,1285
18944,1,1,279,1334,1055
18945,1,1,365,1309,944
18946,1,0,21,0,-21
18947,1,0,29,0,-29
18948,1,0,14,0,-14
18949,1,1,1765,1219,-546
18950,0,0,58,0,-58
18951,1,0,32,0,-32
18952,0,0,10,0,-10
18953,0,0,67,0,-67
18954,0,0,23,0,-23
18955,1,0,40,0,-40
18956,1,1,228,2115,1887
18957,1,1,1210,1241,31
18958,0,0,48,0,-48
18959,1,1,347,1282,935
18960,0,0,43,0,-43
18961,1,1,585,2299,1714
18962,0,0,65,0,-65
18963,0,0,34,0,-34
18964,1,1,314,1285,971
18965,1,1,176,1687,1511
18966,0,0,159,0,-159
18967,0,0,27,0,-27
18968,0,0,9,0,-9
18969,1,0,29,0,-29
18970,1,1,546,1485,939
18971,1,0,52,0,-52
18972,0,0,120,0,-120
18973,0,0,209,0,-209
18974,0,0,4,0,-4
18975,1,1,238,2742,2504
18976,1,1,172,1530,1358
18977,1,1,806,1374,568
18978,1,0,5,0,-5
18979,1,1,929,1712,783
18980,0,0,12,0,-12
18981,0,0,3,0,-3
18982,1,0,111,0,-111
18983,0,0,42,0,-42
18984,0,0,169,0,-169
18985,0,0,8,0,-8
18986,0,0,8,0,-8
18987,0,0,9,0,-9
18988,1,1,1047,1272,225
18989,0,0,21,0,-21
18990,1,0,5,0,-5
18991,1,0,9,0,-9
18992,0,0,18,0,-18
18993,1,0,26,0,-26
18994,0,0,52,0,-52
18995,1,0,18,0,-18
18996,1,0,17,0,-17
18997,1,0,7,0,-7
18998,1,0,75,0,-75
18999,1,1,54,1268,1214
19000,1,1,93,1214,1121
19001,0,0,10,0,-10
19002,1,0,167,0,-167
19003,1,1,949,1493,544
19004,1,0,80,0,-80
19005,1,0,6,0,-6
19006,0,0,75,0,-75
19007,1,1,68,1719,1651
19008,1,0,32,0,-32
19009,1,1,617,1650,1033
19010,0,0,7,0,-7
19011,1,0,45,0,-45
19012,1,1,2067,1284,-783
19013,0,0,84,0,-84
19014,0,0,30,0,-30
19015,0,0,23,0,-23
19016,0,0,3,0,-3
19017,0,0,15,0,-15
19018,1,0,45,0,-45
19019,1,1,234,1296,1062
19020,0,0,39,0,-39
19021,0,0,28,0,-28
19022,1,1,128,1216,1088
19023,1,1,614,1233,619
19024,1,0,35,0,-35
19025,1,1,86,1698,1612
19026,0,0,87,0,-87
19027,1,0,23,0,-23
19028,1,1,451,1381,930
19029,0,0,83,0,-83
19030,1,1,611,1219,608
19031,1,1,416,1219,803
19032,1,0,34,0,-34
19033,1,0,88,0,-88
19034,1,0,109,0,-109
19035,1,1,37,1505,1468
19036,1,1,121,2488,2367
19037,1,1,160,1259,1099
19038,1,0,70,0,-70
19039,1,0,18,0,-18
19040,1,0,83,0,-83
19041,1,1,596,2645,2049
19042,0,0,73,0,-73
19043,1,1,85,1209,1124
19044,1,0,118,0,-118
19045,0,0,57,0,-57
19046,1,1,154,1829,1675
19047,1,1,3054,1689,-1365
19048,1,0,5,0,-5
19049,0,0,47,0,-47
19050,0,0,69,0,-69
19051,1,0,73,0,-73
19052,0,0,22,0,-22
19053,0,0,1,0,-1
19054,0,0,43,0,-43
19055,1,1,174,1333,1159
19056,1,0,16,0,-16
19057,1,0,80,0,-80
19058,0,0,49,0,-49
19059,0,0,21,0,-21
19060,1,1,171,1345,1174
19061,1,1,318,1795,1477
19062,1,0,21,0,-21
19063,0,0,142,0,-142
19064,1,0,107,0,-107
19065,0,0,108,0,-108
19066,1,1,933,1540,607
19067,0,0,5,0,-5
19068,1,1,30,1208,1178
19069,1,0,0,0,0
19070,0,0,20,0,-20
19071,1,1,876,1424,548
19072,1,0,299,0,-299
19073,1,1,341,1273,932
19074,1,1,59,1269,1210
19075,1,1,113,1399,1286
19076,0,0,29,0,-29
19077,0,0,48,0,-48
19078,0,0,56,0,-56
19079,1,1,265,1239,974
19080,0,0,2,0,-2
19081,1,1,715,1511,796
19082,1,1,11,1200,1189
19083,1,0,9,0,-9
19084,1,0,45,0,-45
19085,1,1,300,1796,1496
19086,0,0,55,0,-55
19087,0,0,10,0,-10
19088,0,0,140,0,-140
19089,1,1,325,1233,908
19090,0,0,65,0,-65
19091,1,1,452,1381,929
19092,1,1,285,1477,1192
19093,1,0,80,0,-80
19094,0,0,63,0,-63
19095,0,0,196,0,-196
19096,1,1,59,1369,1310
19097,1,1,530,1394,864
19098,1,0,49,0,-49
19099,0,0,58,0,-58
19100,1,0,52,0,-52
19101,1,0,98,0,-98
19102,0,0,18,0,-18
19103,1,1,528,1299,771
19104,0,0,28,0,-28
19105,0,0,17,0,-17
19106,1,1,111,1331,1220
19107,1,0,11,0,-11
19108,0,0,63,0,-63
19109,0,0,36,0,-36
19110,0,0,28,0,-28
19111,1,1,106,1239,1133
19112,0,0,44,0,-44
19113,0,0,76,0,-76
19114,0,0,70,0,-70
19115,1,1,135,2140,2005
19116,1,1,487,1411,924
19117,1,1,88,1289,1201
19118,0,0,11,0,-11
19119,0,0,78,0,-78
19120,0,0,6,0,-6
19121,0,0,31,0,-31
19122,1,0,52,0,-52
19123,0,0,152,0,-152
19124,1,0,24,0,-24
19125,1,0,16,0,-16
19126,0,0,16,0,-16
19127,1,1,1220,1710,490
19128,1,1,28,1508,1480
19129,1,0,219,0,-219
19130,1,0,79,0,-79
19131,1,0,1,0,-1
19132,1,1,198,1660,1462
19133,0,0,19,0,-19
19134,1,1,49,1227,1178
19135,0,0,7,0,-7
19136,1,0,0,0,0
19137,1,1,982,1543,561
19138,1,0,48,0,-48
19139,0,0,22,0,-22
19140,0,0,84,0,-84
19141,0,0,114,0,-114
19142,1,0,11,0,-11
19143,1,0,115,0,-115
19144,1,1,661,1548,887
19145,0,0,2,0,-2
19146,1,0,92,0,-92
19147,1,0,20,0,-20
19148,1,0,20,0,-20
19149,0,0,44,0,-44
19150,1,1,341,1316,975
19151,0,0,124,0,-124
19152,1,1,882,1541,659
19153,0,0,99,0,-99
19154,0,0,32,0,-32
19155,0,0,24,0,-24
19156,0,0,75,0,-75
19157,0,0,25,0,-25
19158,1,0,16,0,-16
19159,0,0,16,0,-16
19160,1,0,50,0,-50
19161,1,0,139,0,-139
19162,0,0,17,0,-17
19163,1,1,838,1264,426
19164,1,0,55,0,-55
19165,1,0,18,0,-18
19166,0,0,3,0,-3
19167,0,0,90,0,-90
19168,0,0,3,0,-3
19169,0,0,68,0,-68
19170,1,0,7,0,-7
19171,1,1,36,1407,1371
19172,0,0,22,0,-22
19173,0,0,8,0,-8
19174,1,0,94,0,-94
19175,0,0,17,0,-17
19176,0,0,72,0,-72
19177,1,0,11,0,-11
19178,0,0,19,0,-19
19179,1,1,1244,1411,167
19180,0,0,87,0,-87
19181,1,1,485,1567,1082
19182,1,1,1038,1896,858
19183,1,1,56,1847,1791
19184,1,0,18,0,-18
19185,0,0,26,0,-26
19186,1,0,61,0,-61
19187,0,0,57,0,-57
19188,0,0,12,0,-12
19189,0,0,50,0,-50
19190,1,1,150,1527,1377
19191,1,0,85,0,-85
19192,1,0,74,0,-74
19193,1,0,13,0,-13
19194,1,0,119,0,-119
19195,1,1,319,1383,1064
19196,1,1,53,1471,1418
19197,1,1,223,1220,997
19198,0,0,33,0,-33
19199,1,0,10,0,-10
19200,1,1,664,2159,1495
19201,1,1,123,1727,1604
19202,0,0,3,0,-3
19203,1,0,4,0,-4
19204,1,0,5,0,-5
19205,1,0,20,0,-20
19206,1,0,71,0,-71
19207,1,1,279,1406,1127
19208,0,0,23,0,-23
19209,1,0,8,0,-8
19210,0,0,53,0,-53
19211,1,0,30,0,-30
19212,1,1,424,1280,856
19213,1,0,12,0,-12
19214,0,0,74,0,-74
19215,1,0,48,0,-48
19216,0,0,9,0,-9
19217,1,0,1,0,-1
19218,1,0,90,0,-90
19219,0,0,111,0,-111
19220,1,0,14,0,-14
19221,0,0,56,0,-56
19222,1,0,29,0,-29
19223,1,0,89,0,-89
19224,0,0,134,0,-134
19225,0,0,18,0,-18
19226,1,1,126,1606,1480
19227,1,0,87,0,-87
19228,1,0,63,0,-63
19229,0,0,75,0,-75
19230,1,0,21,0,-21
19231,1,1,206,1315,1109
19232,1,0,30,0,-30
19233,1,1,7,1253,1246
19234,1,0,42,0,-42
19235,1,1,769,1400,631
19236,0,0,27,0,-27
19237,0,0,29,0,-29
19238,1,1,355,1649,1294
19239,0,0,18,0,-18
19240,1,0,123,0,-123
19241,1,0,96,0,-96
19242,1,0,48,0,-48
19243,1,0,21,0,-21
19244,1,1,315,2263,1948
19245,1,1,100,1625,1525
19246,1,1,1259,1327,68
19247,0,0,66,0,-66
19248,1,1,298,1847,1549
19249,0,0,10,0,-10
19250,0,0,21,0,-21
19251,1,1,920,2001,1081
19252,0,0,86,0,-86
19253,1,0,13,0,-13
19254,1,1,113,1939,1826
19255,0,0,29,0,-29
19256,0,0,72,0,-72
19257,1,1,952,1504,552
19258,0,0,48,0,-48
19259,0,0,104,0,-104
19260,1,1,879,1220,341
19261,1,0,34,0,-34
19262,0,0,40,0,-40
19263,1,0,81,0,-81
19264,0,0,2,0,-2
19265,1,1,934,1341,407
19266,1,1,346,1329,983
19267,0,0,175,0,-175
19268,0,0,22,0,-22
19269,0,0,2,0,-2
19270,0,0,9,0,-9
19271,0,0,4,0,-4
19272,1,0,44,0,-44
19273,0,0,119,0,-119
19274,0,0,21,0,-21
19275,0,0,34,0,-34
19276,0,0,44,0,-44
19277,1,1,1058,1482,424
19278,1,1,145,1394,1249
19279,0,0,127,0,-127
19280,1,1,10,2228,2218
19281,0,0,74,0,-74
19282,1,1,368,1467,1099
19283,1,1,43,1562,1519
19284,0,0,40,0,-40
19285,1,0,1,0,-1
19286,1,0,21,0,-21
19287,1,1,497,1430,933
19288,1,0,4,0,-4
19289,1,0,25,0,-25
19290,1,1,24,1474,1450
19291,0,0,21,0,-21
19292,1,1,180,1668,1488
19293,1,1,796,1277,481
19294,0,0,5,0,-5
19295,0,0,4,0,-4
19296,1,0,17,0,-17
19297,1,1,875,3096,2221
19298,0,0,8,0,-8
19299,1,0,115,0,-115
19300,0,0,101,0,-101
19301,1,0,34,0,-34
19302,0,0,166,0,-166
19303,0,0,39,0,-39
19304,1,0,39,0,-39
19305,1,1,277,2538,2261
19306,0,0,7,0,-7
19307,0,0,21,0,-21
19308,1,0,4,0,-4
19309,0,0,23,0,-23
19310,0,0,143,0,-143
19311,0,0,46,0,-46
19312,1,1,215,1317,1102
19313,1,1,92,1635,1543
19314,1,1,938,1251,313
19315,1,0,92,0,-92
19316,1,1,94,1418,1324
19317,0,0,35,0,-35
19318,0,0,2,0,-2
19319,0,0,16,0,-16
19320,1,0,79,0,-79
19321,1,1,98,1585,1487
19322,0,0,53,0,-53
19323,1,1,573,1561,988
19324,1,0,13,0,-13
19325,1,0,4,0,-4
19326,1,0,50,0,-50
19327,1,0,14,0,-14
19328,0,0,6,0,-6
19329,1,1,375,1291,916
19330,0,0,16,0,-16
19331,1,0,25,0,-25
19332,1,0,55,0,-55
19333,1,1,134,1858,1724
19334,1,0,62,0,-62
19335,1,0,52,0,-52
19336,0,0,10,0,-10
19337,0,0,20,0,-20
19338,0,0,70,0,-70
19339,0,0,25,0,-25
19340,1,0,68,0,-68
19341,1,1,221,1254,1033
19342,0,0,22,0,-22
19343,1,0,76,0,-76
19344,0,0,0,0,0
19345,0,0,110,0,-110
19346,0,0,54,0,-54
19347,0,0,116,0,-116
19348,1,0,4,0,-4
19349,1,1,452,1349,897
19350,0,0,20,0,-20
19351,1,1,1213,1329,116
19352,1,1,122,1280,1158
19353,0,0,18,0,-18
19354,1,0,121,0,-121
19355,0,0,8,0,-8
19356,0,0,61,0,-61
19357,1,0,38,0,-38
19358,1,1,195,1206,1011
19359,0,0,1,0,-1
19360,1,1,113,2373,2260
19361,1,0,24,0,-24
19362,0,0,17,0,-17
19363,1,0,16,0,-16
19364,0,0,154,0,-154
19365,0,0,15,0,-15
19366,1,1,1008,3717,2709
19367,1,1,149,1314,1165
19368,1,0,77,0,-77
19369,0,0,50,0,-50
19370,1,1,743,1821,1078
19371,1,0,109,0,-109
19372,1,1,1367,1667,300
19373,1,1,1406,1613,207
19374,0,0,23,0,-23
19375,1,1,122,1648,1526
19376,0,0,55,0,-55
19377,1,1,454,1781,1327
19378,1,0,21,0,-21
19379,0,0,33,0,-33
19380,1,1,30,1511,1481
19381,0,0,5,0,-5
19382,0,0,9,0,-9
19383,1,0,92,0,-92
19384,1,1,175,1291,1116
19385,0,0,39,0,-39
19386,1,1,325,1471,1146
19387,1,1,224,1775,1551
19388,1,0,35,0,-35
19389,0,0,28,0,-28
19390,1,1,89,1287,1198
19391,0,0,36,0,-36
19392,0,0,102,0,-102
19393,1,1,604,1746,1142
19394,0,0,68,0,-68
19395,0,0,6,0,-6
19396,0,0,23,0,-23
19397,0,0,28,0,-28
19398,0,0,83,0,-83
19399,1,1,84,2357,2273
19400,1,1,415,1683,1268
19401,0,0,19,0,-19
19402,1,0,1,0,-1
19403,1,0,4,0,-4
19404,1,0,9,0,-9
19405,1,1,848,1336,488
19406,1,1,269,1388,1119
19407,1,1,594,1387,793
19408,1,0,60,0,-60
19409,1,0,32,0,-32
19410,1,1,198,1625,1427
19411,1,0,52,0,-52
19412,1,1,749,1350,601
19413,1,0,135,0,-135
19414,1,0,68,0,-68
19415,0,0,26,0,-26
19416,1,1,590,1768,1178
19417,1,1,518,2033,1515
19418,0,0,125,0,-125
19419,1,1,137,1417,1280
19420,0,0,98,0,-98
19421,1,0,22,0,-22
19422,1,1,494,1212,718
19423,0,0,14,0,-14
19424,1,1,159,1322,1163
19425,0,0,16,0,-16
19426,0,0,48,0,-48
19427,1,1,535,1288,753
19428,0,0,6,0,-6
19429,1,1,362,1359,997
19430,1,1,355,1757,1402
19431,1,1,1057,1323,266
19432,1,1,248,1214,966
19433,1,0,14,0,-14
19434,1,1,1972,1348,-624
19435,1,1,102,1686,1584
19436,0,0,24,0,-24
19437,0,0,40,0,-40
19438,0,0,32,0,-32
19439,1,1,25,2045,2020
19440,1,0,45,0,-45
19441,1,0,100,0,-100
19442,1,1,433,1409,976
19443,1,1,809,1533,724
19444,1,1,2211,2380,169
19445,0,0,17,0,-17
19446,0,0,97,0,-97
19447,1,0,0,0,0
19448,1,0,16,0,-16
19449,1,0,58,0,-58
19450,1,0,80,0,-80
19451,1,0,79,0,-79
19452,1,1,237,1375,1138
19453,1,0,2,0,-2
19454,1,0,74,0,-74
19455,1,0,12,0,-12
19456,1,0,26,0,-26
19457,0,0,104,0,-104
19458,0,0,85,0,-85
19459,0,0,63,0,-63
19460,1,0,66,0,-66
19461,1,1,171,1288,1117
19462,1,1,492,1209,717
19463,1,1,778,1235,457
19464,1,0,3,0,-3
19465,1,0,1,0,-1
19466,1,1,356,1485,1129
19467,0,0,1,0,-1
19468,1,0,46,0,-46
19469,1,1,401,1579,1178
19470,1,1,435,1347,912
19471,0,0,4,0,-4
19472,1,1,100,1210,1110
19473,1,0,10,0,-10
19474,1,0,19,0,-19
19475,0,0,31,0,-31
19476,0,0,10,0,-10
19477,1,1,119,1683,1564
19478,1,0,69,0,-69
19479,1,1,456,1299,843
19480,1,0,0,0,0
19481,0,0,22,0,-22
19482,1,1,200,1252,1052
19483,0,0,57,0,-57
19484,1,1,582,1215,633
19485,0,0,2,0,-2
19486,1,0,37,0,-37
19487,1,1,3105,1249,-1856
19488,0,0,26,0,-26
19489,0,0,30,0,-30
19490,1,0,52,0,-52
19491,0,0,37,0,-37
19492,0,0,56,0,-56
19493,1,1,502,3245,2743
19494,0,0,38,0,-38
19495,0,0,92,0,-92
19496,0,0,72,0,-72
19497,1,0,26,0,-26
19498,1,0,183,0,-183
19499,1,1,134,1598,1464
19500,0,0,7,0,-7
19501,1,0,12,0,-12
19502,1,1,2443,1229,-1214
19503,1,0,30,0,-30
19504,1,0,26,0,-26
19505,1,0,28,0,-28
19506,1,0,38,0,-38
19507,1,0,0,0,0
19508,1,1,851,1283,432
19509,1,0,25,0,-25
19510,1,1,981,1356,375
19511,0,0,27,0,-27
19512,0,0,41,0,-41
19513,0,0,103,0,-103
19514,1,0,56,0,-56
19515,1,1,230,1720,1490
19516,1,1,405,1511,1106
19517,1,1,296,1629,1333
19518,0,0,40,0,-40
19519,1,0,15,0,-15
19520,1,1,1301,1694,393
19521,0,0,54,0,-54
19522,1,0,64,0,-64
19523,1,1,1000,1529,529
19524,0,0,0,0,0
19525,0,0,397,0,-397
19526,1,0,32,0,-32
19527,0,0,2,0,-2
19528,0,0,36,0,-36
19529,0,0,55,0,-55
19530,1,0,178,0,-178
19531,0,0,157,0,-157
19532,1,1,202,1221,1019
19533,0,0,38,0,-38
19534,0,0,191,0,-191
19535,0,0,59,0,-59
19536,1,1,556,1367,811
19537,1,0,9,0,-9
19538,1,0,30,0,-30
19539,0,0,48,0,-48
19540,0,0,7,0,-7
19541,1,1,41,2259,2218
19542,0,0,128,0,-128
19543,1,0,59,0,-59
19544,1,1,116,1272,1156
19545,1,0,88,0,-88
19546,0,0,36,0,-36
19547,1,0,143,0,-143
19548,0,0,41,0,-41
19549,1,1,1033,1298,265
19550,1,0,15,0,-15
19551,1,1,265,1267,1002
19552,1,0,15,0,-15
19553,0,0,12,0,-12
19554,1,0,118,0,-118
19555,0,0,75,0,-75
19556,1,0,82,0,-82
19557,1,0,7,0,-7
19558,0,0,111,0,-111
19559,1,1,71,1782,1711
19560,1,1,66,1591,1525
19561,1,0,75,0,-75
19562,1,1,670,1536,866
19563,1,0,32,0,-32
19564,0,0,47,0,-47
19565,1,0,1,0,-1
19566,0,0,31,0,-31
19567,1,1,431,1295,864
19568,1,0,166,0,-166
19569,1,1,156,1655,1499
19570,0,0,131,0,-131
19571,1,0,19,0,-19
19572,0,0,46,0,-46
19573,1,1,1034,1935,901
19574,0,0,26,0,-26
19575,1,0,1,0,-1
19576,1,0,10,0,-10
19577,0,0,100,0,-100
19578,1,0,35,0,-35
19579,0,0,16,0,-16
19580,0,0,9,0,-9
19581,0,0,33,0,-33
19582,1,0,57,0,-57
19583,1,0,29,0,-29
19584,0,0,150,0,-150
19585,0,0,2,0,-2
19586,1,0,44,0,-44
19587,0,0,44,0,-44
19588,0,0,64,0,-64
19589,1,1,1352,1333,-19
19590,1,1,225,1633,1408
19591,1,1,394,1907,1513
19592,1,0,0,0,0
19593,1,1,1267,1373,106
19594,1,0,49,0,-49
19595,0,0,11,0,-11
19596,1,0,45,0,-45
19597,0,0,5,0,-5
19598,0,0,33,0,-33
19599,1,0,119,0,-119
19600,1,1,2637,1452,-1185
19601,1,0,31,0,-31
19602,0,0,113,0,-113
19603,1,1,473,1648,1175
19604,0,0,5,0,-5
19605,1,0,204,0,-204
19606,1,1,760,1388,628
19607,1,1,863,1503,640
19608,1,1,257,1372,1115
19609,0,0,35,0,-35
19610,1,1,717,1341,624
19611,0,0,26,0,-26
19612,1,1,103,3237,3134
19613,1,1,60,1887,1827
19614,0,0,100,0,-100
19615,1,1,123,1234,1111
19616,1,0,66,0,-66
19617,0,0,99,0,-99
19618,0,0,72,0,-72
19619,0,0,36,0,-36
19620,0,0,116,0,-116
19621,0,0,127,0,-127
19622,0,0,130,0,-130
19623,0,0,166,0,-166
19624,1,0,56,0,-56
19625,0,0,26,0,-26
19626,1,0,58,0,-58
19627,1,0,23,0,-23
19628,1,0,3,0,-3
19629,0,0,53,0,-53
19630,1,0,8,0,-8
19631,1,0,7,0,-7
19632,0,0,211,0,-211
19633,1,0,7,0,-7
19634,1,1,356,2806,2450
19635,1,0,182,0,-182
19636,1,0,103,0,-103
19637,1,0,43,0,-43
19638,0,0,101,0,-101
19639,0,0,65,0,-65
19640,1,0,34,0,-34
19641,0,0,155,0,-155
19642,0,0,6,0,-6
19643,1,0,60,0,-60
19644,1,0,23,0,-23
19645,0,0,61,0,-61
19646,0,0,23,0,-23
19647,1,1,77,1310,1233
19648,1,0,20,0,-20
19649,0,0,39,0,-39
19650,1,1,177,3560,3383
19651,0,0,168,0,-168
19652,1,0,12,0,-12
19653,1,0,34,0,-34
19654,0,0,80,0,-80
19655,1,1,433,1228,795
19656,1,1,374,1437,1063
19657,1,0,8,0,-8
19658,1,1,348,1484,1136
19659,1,0,48,0,-48
19660,1,1,480,1362,882
19661,1,1,161,1385,1224
19662,1,0,6,0,-6
19663,1,0,5,0,-5
19664,1,1,602,2366,1764
19665,1,0,3,0,-3
19666,1,1,440,1453,1013
19667,0,0,10,0,-10
19668,1,1,92,1687,1595
19669,0,0,3,0,-3
19670,0,0,17,0,-17
19671,0,0,93,0,-93
19672,1,1,173,1254,1081
19673,0,0,109,0,-109
19674,0,0,287,0,-287
19675,0,0,12,0,-12
19676,0,0,6,0,-6
19677,1,1,1019,1702,683
19678,1,0,21,0,-21
19679,0,0,48,0,-48
19680,0,0,22,0,-22
19681,1,0,119,0,-119
19682,0,0,3,0,-3
19683,0,0,19,0,-19
19684,1,0,33,0,-33
19685,1,0,42,0,-42
19686,1,1,110,1467,1357
19687,1,1,209,1324,1115
19688,1,1,209,1491,1282
19689,0,0,75,0,-75
19690,0,0,50,0,-50
19691,0,0,59,0,-59
19692,0,0,7,0,-7
19693,1,1,211,1430,1219
19694,1,1,499,1321,822
19695,1,0,14,0,-14
19696,1,1,709,3882,3173
19697,1,0,66,0,-66
19698,1,0,72,0,-72
19699,1,1,726,1903,1177
19700,0,0,113,0,-113
19701,0,0,84,0,-84
19702,1,0,30,0,-30
19703,1,1,420,1975,1555
19704,1,0,178,0,-178
19705,1,1,57,1313,1256
19706,1,1,551,1629,1078
19707,1,0,34,0,-34
19708,0,0,42,0,-42
19709,1,1,619,1343,724
19710,0,0,93,0,-93
19711,1,1,85,1474,1389
19712,0,0,189,0,-189
19713,1,1,135,1594,1459
19714,1,0,16,0,-16
19715,1,1,46,1209,1163
19716,1,0,29,0,-29
19717,1,0,31,0,-31
19718,0,0,49,0,-49
19719,0,0,9,0,-9
19720,1,0,190,0,-190
19721,1,1,131,3071,2940
19722,1,0,166,0,-166
19723,1,0,54,0,-54
19724,1,0,9,0,-9
19725,0,0,14,0,-14
19726,1,1,300,1984,1684
19727,0,0,148,0,-148
19728,0,0,115,0,-115
19729,1,0,104,0,-104
19730,0,0,81,0,-81
19731,1,1,829,2396,1567
19732,0,0,161,0,-161
19733,1,1,889,1456,567
19734,1,0,45,0,-45
19735,1,1,58,1298,1240
19736,1,1,588,1345,757
19737,0,0,78,0,-78
19738,1,0,1,0,-1
19739,0,0,125,0,-125
19740,0,0,43,0,-43
19741,0,0,43,0,-43
19742,1,1,41,1451,1410
19743,1,0,125,0,-125
19744,1,0,58,0,-58
19745,1,1,208,2024,1816
19746,0,0,171,0,-171
19747,0,0,46,0,-46
19748,1,1,1520,1418,-102
19749,0,0,29,0,-29
19750,1,1,166,1710,1544
19751,1,0,41,0,-41
19752,1,1,1547,1882,335
19753,0,0,60,0,-60
19754,0,0,38,0,-38
19755,0,0,54,0,-54
19756,0,0,95,0,-95
19757,1,1,758,1508,750
19758,1,1,102,1221,1119
19759,1,0,39,0,-39
19760,0,0,50,0,-50
19761,0,0,50,0,-50
19762,0,0,24,0,-24
19763,0,0,34,0,-34
19764,0,0,88,0,-88
19765,1,0,19,0,-19
19766,0,0,155,0,-155
19767,1,1,1401,1401,0
19768,1,0,98,0,-98
19769,1,1,253,1288,1035
19770,1,0,9,0,-9
19771,1,1,54,1577,1523
19772,1,0,8,0,-8
19773,0,0,14,0,-14
19774,1,1,46,1226,1180
19775,0,0,15,0,-15
19776,1,0,16,0,-16
19777,1,0,0,0,0
19778,0,0,1,0,-1
19779,1,1,182,1336,1154
19780,1,1,1388,1286,-102
19781,1,0,29,0,-29
19782,0,0,45,0,-45
19783,1,0,24,0,-24
19784,1,1,1024,2099,1075
19785,1,1,706,1864,1158
19786,1,0,49,0,-49
19787,1,1,101,1752,1651
19788,0,0,12,0,-12
19789,0,0,243,0,-243
19790,1,1,129,1274,1145
19791,1,0,6,0,-6
19792,1,0,72,0,-72
19793,1,1,218,1595,1377
19794,0,0,61,0,-61
19795,0,0,13,0,-13
19796,0,0,109,0,-109
19797,1,1,199,1267,1068
19798,0,0,188,0,-188
19799,1,1,1229,1300,71
19800,1,0,1,0,-1
19801,0,0,12,0,-12
19802,1,0,12,0,-12
19803,1,0,1,0,-1
19804,1,1,79,1454,1375
19805,1,0,103,0,-103
19806,0,0,17,0,-17
19807,0,0,20,0,-20
19808,0,0,8,0,-8
19809,1,0,13,0,-13
19810,1,1,1016,1293,277
19811,1,0,25,0,-25
19812,0,0,106,0,-106
19813,0,0,46,0,-46
19814,1,1,48,1204,1156
19815,1,1,592,1465,873
19816,1,0,30,0,-30
19817,0,0,10,0,-10
19818,1,0,67,0,-67
19819,1,1,214,1400,1186
19820,0,0,106,0,-106
19821,1,0,35,0,-35
19822,1,0,20,0,-20
19823,0,0,24,0,-24
19824,1,0,47,0,-47
19825,0,0,23,0,-23
19826,1,0,8,0,-8
19827,0,0,7,0,-7
19828,0,0,3,0,-3
19829,1,1,1176,1293,117
19830,1,0,5,0,-5
19831,1,1,1153,1705,552
19832,1,1,611,1286,675
19833,1,1,266,1606,1340
19834,0,0,0,0,0
19835,0,0,10,0,-10
19836,1,1,443,1252,809
19837,0,0,24,0,-24
19838,0,0,8,0,-8
19839,0,0,5,0,-5
19840,1,0,37,0,-37
19841,1,1,89,1397,1308
19842,0,0,21,0,-21
19843,0,0,16,0,-16
19844,0,0,138,0,-138
19845,0,0,59,0,-59
19846,1,0,19,0,-19
19847,1,0,77,0,-77
19848,0,0,124,0,-124
19849,1,1,572,1403,831
19850,1,0,1,0,-1
19851,1,0,41,0,-41
19852,0,0,51,0,-51
19853,0,0,5,0,-5
19854,0,0,16,0,-16
19855,0,0,42,0,-42
19856,1,1,185,1232,1047
19857,1,0,8,0,-8
19858,1,0,15,0,-15
19859,0,0,26,0,-26
19860,1,0,37,0,-37
19861,1,0,23,0,-23
19862,1,1,92,1214,1122
19863,0,0,184,0,-184
19864,1,1,767,1288,521
19865,1,1,550,1246,696
19866,1,0,60,0,-60
19867,1,1,821,1209,388
19868,1,1,204,1317,1113
19869,0,0,51,0,-51
19870,1,0,36,0,-36
19871,1,1,748,1201,453
19872,1,1,359,1242,883
19873,1,0,24,0,-24
19874,1,0,8,0,-8
19875,1,1,353,1423,1070
19876,0,0,35,0,-35
19877,1,0,59,0,-59
19878,1,1,833,1544,711
19879,0,0,60,0,-60
19880,0,0,43,0,-43
19881,1,0,20,0,-20
19882,1,0,84,0,-84
19883,1,1,813,1308,495
19884,1,1,234,1712,1478
19885,1,0,156,0,-156
19886,0,0,98,0,-98
19887,0,0,112,0,-112
19888,0,0,18,0,-18
19889,0,0,15,0,-15
19890,1,0,67,0,-67
19891,1,1,12,1214,1202
19892,0,0,22,0,-22
19893,1,1,367,1217,850
19894,1,1,636,2106,1470
19895,0,0,75,0,-75
19896,1,0,106,0,-106
19897,1,0,44,0,-44
19898,1,0,37,0,-37
19899,0,0,93,0,-93
19900,0,0,87,0,-87
19901,1,1,1393,1233,-160
19902,1,0,3,0,-3
19903,0,0,31,0,-31
19904,1,0,31,0,-31
19905,0,0,7,0,-7
19906,1,0,165,0,-165
19907,1,0,18,0,-18
19908,1,1,57,1443,1386
19909,0,0,35,0,-35
19910,1,1,265,1332,1067
19911,1,1,144,1299,1155
19912,0,0,51,0,-51
19913,1,0,70,0,-70
19914,1,0,19,0,-19
19915,1,1,149,1389,1240
19916,1,1,1483,1870,387
19917,0,0,33,0,-33
19918,0,0,140,0,-140
19919,1,0,12,0,-12
19920,0,0,11,0,-11
19921,1,1,534,2427,1893
19922,0,0,76,0,-76
19923,1,1,148,1372,1224
19924,0,0,67,0,-67
19925,1,0,23,0,-23
19926,1,0,14,0,-14
19927,0,0,13,0,-13
19928,0,0,18,0,-18
19929,0,0,89,0,-89
19930,1,0,22,0,-22
19931,0,0,38,0,-38
19932,1,0,65,0,-65
19933,1,0,86,0,-86
19934,0,0,271,0,-271
19935,1,0,13,0,-13
19936,1,1,217,1959,1742
19937,0,0,57,0,-57
19938,1,1,174,1236,1062
19939,1,1,455,1300,845
19940,0,0,12,0,-12
19941,1,0,125,0,-125
19942,0,0,49,0,-49
19943,0,0,13,0,-13
19944,1,1,254,1275,1021
19945,0,0,11,0,-11
19946,1,1,159,1902,1743
19947,1,0,1,0,-1
19948,0,0,1,0,-1
19949,0,0,11,0,-11
19950,1,0,26,0,-26
19951,0,0,29,0,-29
19952,1,1,421,1328,907
19953,0,0,30,0,-30
19954,0,0,34,0,-34
19955,1,1,337,1613,1276
19956,1,0,21,0,-21
19957,0,0,58,0,-58
19958,1,1,769,1239,470
19959,0,0,58,0,-58
19960,1,1,481,1755,1274
19961,0,0,59,0,-59
19962,1,0,10,0,-10
19963,1,0,0,0,0
19964,0,0,44,0,-44
19965,1,0,1,0,-1
19966,1,1,2069,1223,-846
19967,1,0,29,0,-29
19968,0,0,91,0,-91
19969,1,0,15,0,-15
19970,0,0,84,0,-84
19971,0,0,68,0,-68
19972,1,1,440,1342,902
19973,1,1,1464,1509,45
19974,0,0,37,0,-37
19975,0,0,82,0,-82
19976,1,0,116,0,-116
19977,1,0,11,0,-11
19978,0,0,12,0,-12
19979,1,0,34,0,-34
19980,0,0,191,0,-191
19981,0,0,193,0,-193
19982,1,0,133,0,-133
19983,1,1,67,1793,1726
19984,0,0,130,0,-130
19985,0,0,10,0,-10
19986,1,1,109,1500,1391
19987,1,0,201,0,-201
19988,0,0,1,0,-1
19989,0,0,84,0,-84
19990,1,0,26,0,-26
19991,1,1,7,1906,1899
19992,0,0,47,0,-47
19993,0,0,60,0,-60
19994,1,0,3,0,-3
19995,1,0,5,0,-5
19996,0,0,36,0,-36
19997,1,1,396,2612,2216
19998,1,0,17,0,-17
19999,1,0,139,0,-139
20000,1,0,10,0,-10
20001,0,0,102,0,-102
20002,1,0,8,0,-8
20003,0,0,54,0,-54
20004,1,0,43,0,-43
20005,1,1,582,1341,759
20006,0,0,54,0,-54
20007,1,1,425,1807,1382
20008,1,1,165,1233,1068
20009,0,0,10,0,-10
20010,1,1,398,2759,2361
20011,1,1,730,3666,2936
20012,0,0,15,0,-15
20013,1,1,1362,1372,10
20014,1,0,65,0,-65
20015,1,0,9,0,-9
20016,1,1,1297,1414,117
20017,0,0,58,0,-58
20018,0,0,92,0,-92
20019,0,0,23,0,-23
20020,0,0,43,0,-43
20021,1,1,134,1273,1139
20022,1,0,59,0,-59
20023,1,1,1262,1298,36
20024,0,0,26,0,-26
20025,0,0,26,0,-26
20026,0,0,44,0,-44
20027,0,0,35,0,-35
20028,0,0,27,0,-27
20029,0,0,22,0,-22
20030,1,1,934,1537,603
20031,0,0,136,0,-136
20032,1,0,129,0,-129
20033,1,0,69,0,-69
20034,1,0,1,0,-1
20035,1,0,79,0,-79
20036,0,0,5,0,-5
20037,0,0,8,0,-8
20038,1,1,822,1423,601
20039,1,0,28,0,-28
20040,1,1,208,1323,1115
20041,0,0,156,0,-156
20042,1,0,19,0,-19
20043,1,1,194,1542,1348
20044,1,1,1079,1448,369
20045,0,0,14,0,-14
20046,1,1,863,1543,680
20047,0,0,24,0,-24
20048,1,1,70,1222,1152
20049,1,1,886,1564,678
20050,1,0,11,0,-11
20051,1,0,76,0,-76
20052,1,0,16,0,-16
20053,1,0,29,0,-29
20054,1,1,181,1998,1817
20055,1,0,39,0,-39
20056,1,1,776,1419,643
20057,1,1,346,1232,886
20058,1,1,1233,1458,225
20059,1,0,36,0,-36
20060,1,0,9,0,-9
20061,0,0,128,0,-128
20062,1,0,5,0,-5
20063,1,1,597,1349,752
20064,0,0,41,0,-41
20065,1,1,159,1266,1107
20066,1,1,36,1823,1787
20067,1,1,807,1234,427
20068,0,0,63,0,-63
20069,0,0,13,0,-13
20070,1,1,1671,1396,-275
20071,1,0,4,0,-4
20072,0,0,29,0,-29
20073,1,1,178,1924,1746
20074,1,1,1441,1329,-112
20075,1,0,93,0,-93
20076,1,0,171,0,-171
20077,1,1,151,1264,1113
20078,1,1,319,1809,1490
20079,1,1,85,1425,1340
20080,1,0,16,0,-16
20081,0,0,2,0,-2
20082,1,0,33,0,-33
20083,1,0,28,0,-28
20084,1,1,286,1374,1088
20085,1,1,562,1658,1096
20086,1,1,130,1318,1188
20087,0,0,34,0,-34
20088,0,0,69,0,-69
20089,0,0,21,0,-21
20090,0,0,45,0,-45
20091,0,0,11,0,-11
20092,1,1,439,1575,1136
20093,0,0,6,0,-6
20094,1,1,247,1248,1001
20095,1,1,893,1477,584
20096,1,0,83,0,-83
20097,1,0,44,0,-44
20098,0,0,67,0,-67
20099,0,0,78,0,-78
20100,1,1,1261,1403,142
20101,0,0,6,0,-6
20102,0,0,23,0,-23
20103,1,0,11,0,-11
20104,0,0,137,0,-137
20105,0,0,93,0,-93
20106,1,0,38,0,-38
20107,0,0,111,0,-111
20108,0,0,32,0,-32
20109,1,1,193,1323,1130
20110,0,0,110,0,-110
20111,1,1,663,1722,1059
20112,1,1,500,1454,954
20113,1,0,26,0,-26
20114,1,1,176,2207,2031
20115,0,0,79,0,-79
20116,1,0,161,0,-161
20117,1,1,157,1290,1133
20118,1,0,4,0,-4
20119,0,0,53,0,-53
20120,1,1,399,1418,1019
20121,1,0,4,0,-4
20122,1,1,345,1375,1030
20123,0,0,48,0,-48
20124,1,1,1196,1614,418
20125,0,0,92,0,-92
20126,1,0,173,0,-173
20127,0,0,22,0,-22
20128,0,0,81,0,-81
20129,1,1,2181,1529,-652
20130,1,0,3,0,-3
20131,1,1,819,1584,765
20132,1,0,59,0,-59
20133,1,1,258,1613,1355
20134,0,0,58,0,-58
20135,1,1,852,1379,527
20136,1,0,27,0,-27
20137,1,0,73,0,-73
20138,1,0,9,0,-9
20139,0,0,31,0,-31
20140,1,1,85,1272,1187
20141,1,1,821,1230,409
20142,0,0,54,0,-54
20143,0,0,33,0,-33
20144,1,0,55,0,-55
20145,1,1,1437,1675,238
20146,1,0,42,0,-42
20147,1,0,73,0,-73
20148,1,1,471,1275,804
20149,1,1,331,1228,897
20150,0,0,10,0,-10
20151,1,0,7,0,-7
20152,0,0,93,0,-93
20153,1,0,101,0,-101
20154,1,0,16,0,-16
20155,0,0,16,0,-16
20156,1,0,57,0,-57
20157,1,1,260,1456,1196
20158,0,0,94,0,-94
20159,1,0,7,0,-7
20160,0,0,26,0,-26
20161,1,0,67,0,-67
20162,1,1,61,1524,1463
20163,1,0,19,0,-19
20164,0,0,3,0,-3
20165,0,0,4,0,-4
20166,1,0,110,0,-110
20167,0,0,141,0,-141
20168,0,0,108,0,-108
20169,0,0,79,0,-79
20170,1,0,19,0,-19
20171,0,0,74,0,-74
20172,0,0,11,0,-11
20173,1,0,102,0,-102
20174,0,0,76,0,-76
20175,1,0,31,0,-31
20176,0,0,1,0,-1
20177,0,0,67,0,-67
20178,0,0,2,0,-2
20179,0,0,51,0,-51
20180,0,0,45,0,-45
20181,0,0,1,0,-1
20182,0,0,56,0,-56
20183,1,0,2,0,-2
20184,0,0,145,0,-145
20185,0,0,147,0,-147
20186,1,1,694,1908,1214
20187,1,0,87,0,-87
20188,1,0,58,0,-58
20189,1,1,169,1203,1034
20190,0,0,25,0,-25
20191,1,1,671,1745,1074
20192,1,0,0,0,0
20193,0,0,27,0,-27
20194,1,1,201,1258,1057
20195,1,1,297,1288,991
20196,1,0,24,0,-24
20197,1,0,81,0,-81
20198,1,0,95,0,-95
20199,1,1,100,1288,1188
20200,1,0,52,0,-52
20201,1,1,106,1546,1440
20202,0,0,100,0,-100
20203,1,0,4,0,-4
20204,0,0,58,0,-58
20205,0,0,47,0,-47
20206,0,0,0,0,0
20207,0,0,57,0,-57
20208,1,0,0,0,0
20209,1,0,93,0,-93
20210,1,0,7,0,-7
20211,0,0,76,0,-76
20212,1,1,261,1299,1038
20213,0,0,10,0,-10
20214,0,0,65,0,-65
20215,1,1,241,1366,1125
20216,0,0,51,0,-51
20217,0,0,42,0,-42
20218,0,0,84,0,-84
20219,1,1,117,1482,1365
20220,0,0,4,0,-4
20221,1,0,104,0,-104
20222,1,0,11,0,-11
20223,1,0,19,0,-19
20224,0,0,67,0,-67
20225,0,0,44,0,-44
20226,1,0,57,0,-57
20227,0,0,7,0,-7
20228,1,0,42,0,-42
20229,1,1,316,2321,2005
20230,0,0,16,0,-16
20231,0,0,8,0,-8
20232,1,0,69,0,-69
20233,0,0,1,0,-1
20234,1,1,325,1505,1180
20235,0,0,7,0,-7
20236,1,1,87,1492,1405
20237,1,1,669,1522,853
20238,1,0,29,0,-29
20239,1,0,29,0,-29
20240,0,0,0,0,0
20241,1,0,25,0,-25
20242,1,1,303,1309,1006
20243,1,1,178,1496,1318
20244,1,0,188,0,-188
20245,1,0,0,0,0
20246,1,0,2,0,-2
20247,1,1,370,1522,1152
20248,0,0,57,0,-57
20249,1,1,23,2904,2881
20250,1,0,86,0,-86
20251,1,0,36,0,-36
20252,0,0,41,0,-41
20253,1,1,353,1346,993
20254,1,1,1399,1316,-83
20255,1,1,46,1377,1331
20256,0,0,54,0,-54
20257,0,0,82,0,-82
20258,0,0,0,0,0
20259,1,1,273,1902,1629
20260,1,0,46,0,-46
20261,1,0,21,0,-21
20262,1,0,84,0,-84
20263,0,0,7,0,-7
20264,0,0,11,0,-11
20265,0,0,31,0,-31
20266,1,0,126,0,-126
20267,1,0,39,0,-39
20268,1,0,0,0,0
20269,0,0,154,0,-154
20270,1,0,112,0,-112
20271,1,1,428,1313,885
20272,1,1,715,1249,534
20273,1,0,8,0,-8
20274,1,0,39,0,-39
20275,0,0,9,0,-9
20276,1,1,239,1627,1388
20277,0,0,111,0,-111
20278,0,0,183,0,-183
20279,0,0,96,0,-96
20280,1,1,176,1227,1051
20281,0,0,60,0,-60
20282,0,0,50,0,-50
20283,1,0,66,0,-66
20284,1,1,57,1725,1668
20285,0,0,51,0,-51
20286,0,0,39,0,-39
20287,0,0,9,0,-9
20288,0,0,41,0,-41
20289,0,0,50,0,-50
20290,0,0,22,0,-22
20291,0,0,41,0,-41
20292,1,0,5,0,-5
20293,1,1,613,1242,629
20294,0,0,10,0,-10
20295,1,0,54,0,-54
20296,1,1,79,1916,1837
20297,0,0,61,0,-61
20298,0,0,130,0,-130
20299,0,0,152,0,-152
20300,0,0,2,0,-2
20301,1,1,1259,1329,70
20302,1,0,17,0,-17
20303,1,0,6,0,-6
20304,1,0,33,0,-33
20305,1,0,29,0,-29
20306,1,1,452,1264,812
20307,1,0,8,0,-8
20308,1,1,172,1470,1298
20309,1,0,122,0,-122
20310,1,0,33,0,-33
20311,0,0,53,0,-53
20312,0,0,3,0,-3
20313,0,0,28,0,-28
20314,1,1,183,1379,1196
20315,1,1,155,1388,1233
20316,1,0,49,0,-49
20317,0,0,52,0,-52
20318,1,0,12,0,-12
20319,0,0,76,0,-76
20320,1,0,94,0,-94
20321,0,0,1,0,-1
20322,0,0,2,0,-2
20323,1,0,21,0,-21
20324,1,1,321,2021,1700
20325,1,0,3,0,-3
20326,1,0,5,0,-5
20327,0,0,36,0,-36
20328,0,0,20,0,-20
20329,1,0,24,0,-24
20330,1,0,43,0,-43
20331,1,1,773,1458,685
20332,1,1,999,1252,253
20333,0,0,4,0,-4
20334,1,1,633,1713,1080
20335,1,0,3,0,-3
20336,0,0,53,0,-53
20337,1,0,17,0,-17
20338,0,0,24,0,-24
20339,1,1,402,1388,986
20340,1,0,27,0,-27
20341,0,0,95,0,-95
20342,0,0,19,0,-19
20343,1,1,543,1355,812
20344,1,0,0,0,0
20345,0,0,45,0,-45
20346,1,0,92,0,-92
20347,1,1,612,1447,835
20348,1,0,54,0,-54
20349,1,1,135,1332,1197
20350,0,0,36,0,-36
20351,1,1,226,1941,1715
20352,1,1,445,1215,770
20353,1,0,34,0,-34
20354,1,0,6,0,-6
20355,1,1,1145,1509,364
20356,1,1,256,1327,1071
20357,1,0,58,0,-58
20358,0,0,62,0,-62
20359,1,1,253,3071,2818
20360,1,0,25,0,-25
20361,0,0,9,0,-9
20362,0,0,23,0,-23
20363,0,0,85,0,-85
20364,1,0,36,0,-36
20365,1,1,1247,1481,234
20366,1,0,33,0,-33
20367,1,0,84,0,-84
20368,0,0,13,0,-13
20369,0,0,26,0,-26
20370,1,0,43,0,-43
20371,1,0,56,0,-56
20372,0,0,5,0,-5
20373,0,0,28,0,-28
20374,1,1,923,1345,422
20375,0,0,2,0,-2
20376,0,0,36,0,-36
20377,0,0,61,0,-61
20378,0,0,82,0,-82
20379,1,0,158,0,-158
20380,0,0,263,0,-263
20381,0,0,0,0,0
20382,1,1,185,1312,1127
20383,1,1,806,1439,633
20384,1,1,1094,2192,1098
20385,1,1,1901,1223,-678
20386,1,1,247,1496,1249
20387,1,0,34,0,-34
20388,1,0,11,0,-11
20389,1,0,31,0,-31
20390,1,0,19,0,-19
20391,1,0,80,0,-80
20392,1,0,17,0,-17
20393,1,0,11,0,-11
20394,1,0,176,0,-176
20395,1,1,639,1530,891
20396,0,0,3,0,-3
20397,1,0,0,0,0
20398,1,1,289,1228,939
20399,1,0,18,0,-18
20400,0,0,122,0,-122
20401,1,1,1458,1272,-186
20402,0,0,43,0,-43
20403,0,0,4,0,-4
20404,0,0,4,0,-4
20405,1,0,70,0,-70
20406,0,0,6,0,-6
20407,1,0,24,0,-24
20408,0,0,9,0,-9
20409,1,0,7,0,-7
20410,1,0,93,0,-93
20411,1,0,18,0,-18
20412,0,0,37,0,-37
20413,1,0,68,0,-68
20414,1,1,393,1566,1173
20415,0,0,27,0,-27
20416,0,0,45,0,-45
20417,0,0,28,0,-28
20418,0,0,57,0,-57
20419,0,0,10,0,-10
20420,1,0,8,0,-8
20421,1,0,31,0,-31
20422,1,0,12,0,-12
20423,0,0,78,0,-78
20424,1,1,25,2614,2589
20425,1,1,1120,1438,318
20426,0,0,104,0,-104
20427,1,0,30,0,-30
20428,0,0,52,0,-52
20429,0,0,5,0,-5
20430,1,0,53,0,-53
20431,1,1,116,1621,1505
20432,1,1,1672,2298,626
20433,0,0,52,0,-52
20434,1,0,56,0,-56
20435,1,0,2,0,-2
20436,0,0,60,0,-60
20437,1,1,346,2726,2380
20438,1,0,25,0,-25
20439,0,0,13,0,-13
20440,1,0,29,0,-29
20441,0,0,55,0,-55
20442,1,0,46,0,-46
20443,1,0,15,0,-15
20444,1,1,775,1451,676
20445,0,0,15,0,-15
20446,1,0,93,0,-93
20447,1,0,63,0,-63
20448,1,1,730,1405,675
20449,0,0,3,0,-3
20450,0,0,187,0,-187
20451,1,1,2244,1394,-850
20452,1,0,84,0,-84
20453,0,0,7,0,-7
20454,1,1,2811,2074,-737
20455,1,1,1036,2868,1832
20456,0,0,23,0,-23
20457,1,1,211,1825,1614
20458,1,1,195,1340,1145
20459,1,1,129,1626,1497
20460,1,0,0,0,0
20461,1,0,119,0,-119
20462,0,0,45,0,-45
20463,0,0,34,0,-34
20464,1,0,30,0,-30
20465,1,0,12,0,-12
20466,0,0,5,0,-5
20467,1,1,989,1224,235
20468,1,1,691,1752,1061
20469,0,0,32,0,-32
20470,0,0,14,0,-14
20471,0,0,24,0,-24
20472,1,0,3,0,-3
20473,0,0,12,0,-12
20474,1,1,185,1234,1049
20475,0,0,169,0,-169
20476,1,0,69,0,-69
20477,1,0,56,0,-56
20478,0,0,73,0,-73
20479,1,0,37,0,-37
20480,0,0,38,0,-38
20481,1,1,1998,1661,-337
20482,1,1,493,1503,1010
20483,1,1,34,1618,1584
20484,1,0,32,0,-32
20485,0,0,77,0,-77
20486,0,0,8,0,-8
20487,1,0,52,0,-52
20488,1,1,550,2415,1865
20489,1,1,520,1208,688
20490,1,0,78,0,-78
20491,0,0,11,0,-11
20492,1,0,11,0,-11
20493,1,1,279,1243,964
20494,1,1,1554,1633,79
20495,0,0,34,0,-34
20496,0,0,6,0,-6
20497,0,0,57,0,-57
20498,1,0,57,0,-57
20499,1,0,17,0,-17
20500,1,0,36,0,-36
20501,0,0,103,0,-103
20502,1,0,135,0,-135
20503,0,0,43,0,-43
20504,0,0,16,0,-16
20505,1,1,178,1275,1097
20506,0,0,5,0,-5
20507,1,1,677,1546,869
20508,0,0,69,0,-69
20509,1,1,482,1429,947
20510,0,0,4,0,-4
20511,1,0,7,0,-7
20512,0,0,6,0,-6
20513,1,1,183,1744,1561
20514,0,0,0,0,0
20515,1,0,55,0,-55
20516,1,0,22,0,-22
20517,0,0,179,0,-179
20518,1,0,210,0,-210
20519,1,1,29,1938,1909
20520,0,0,54,0,-54
20521,1,1,391,1371,980
20522,0,0,2,0,-2
20523,0,0,45,0,-45
20524,0,0,176,0,-176
20525,1,1,566,1817,1251
20526,1,1,82,3134,3052
20527,1,1,611,1422,811
20528,1,0,75,0,-75
20529,0,0,21,0,-21
20530,1,0,24,0,-24
20531,0,0,66,0,-66
20532,1,1,847,1288,441
20533,1,0,26,0,-26
20534,1,0,30,0,-30
20535,0,0,146,0,-146
20536,1,1,856,1459,603
20537,1,0,20,0,-20
20538,1,0,5,0,-5
20539,1,0,27,0,-27
20540,1,1,246,1288,1042
20541,1,0,22,0,-22
20542,1,1,348,1338,990
20543,1,0,24,0,-24
20544,1,0,11,0,-11
20545,1,0,27,0,-27
20546,1,1,1027,1218,191
20547,1,0,3,0,-3
20548,0,0,42,0,-42
20549,1,0,132,0,-132
20550,1,1,324,1505,1181
20551,1,1,95,1249,1154
20552,1,1,384,1980,1596
20553,1,0,41,0,-41
20554,0,0,3,0,-3
20555,1,0,24,0,-24
20556,1,0,55,0,-55
20557,1,0,67,0,-67
20558,1,0,27,0,-27
20559,1,1,317,1662,1345
20560,0,0,46,0,-46
20561,1,1,1341,1481,140
20562,0,0,14,0,-14
20563,1,0,33,0,-33
20564,1,0,3,0,-3
20565,1,0,18,0,-18
20566,1,1,264,1384,1120
20567,1,0,17,0,-17
20568,1,1,258,1864,1606
20569,0,0,111,0,-111
20570,1,1,114,1243,1129
20571,0,0,99,0,-99
20572,1,0,18,0,-18
20573,0,0,10,0,-10
20574,0,0,54,0,-54
20575,0,0,21,0,-21
20576,0,0,38,0,-38
20577,1,0,102,0,-102
20578,1,1,468,1391,923
20579,1,1,793,1426,633
20580,1,1,98,1839,1741
20581,0,0,128,0,-128
20582,1,0,59,0,-59
20583,0,0,2,0,-2
20584,0,0,7,0,-7
20585,0,0,38,0,-38
20586,1,1,253,1678,1425
20587,0,0,5,0,-5
20588,1,0,3,0,-3
20589,1,1,213,1221,1008
20590,0,0,33,0,-33
20591,0,0,68,0,-68
20592,1,1,1340,1307,-33
20593,0,0,36,0,-36
20594,0,0,11,0,-11
20595,1,1,335,1542,1207
20596,1,0,132,0,-132
20597,0,0,8,0,-8
20598,1,1,506,1267,761
20599,1,1,41,1650,1609
20600,1,0,28,0,-28
20601,1,0,5,0,-5
20602,0,0,81,0,-81
20603,1,1,30,1231,1201
20604,0,0,14,0,-14
20605,0,0,18,0,-18
20606,0,0,80,0,-80
20607,1,0,82,0,-82
20608,0,0,73,0,-73
20609,1,0,101,0,-101
20610,1,1,423,2033,1610
20611,0,0,9,0,-9
20612,1,0,93,0,-93
20613,0,0,31,0,-31
20614,1,1,62,1388,1326
20615,1,0,7,0,-7
20616,0,0,44,0,-44
20617,1,0,18,0,-18
20618,1,0,98,0,-98
20619,1,0,13,0,-13
20620,1,1,689,1335,646
20621,1,0,18,0,-18
20622,0,0,70,0,-70
20623,1,0,41,0,-41
20624,0,0,46,0,-46
20625,1,0,94,0,-94
20626,1,0,50,0,-50
20627,0,0,14,0,-14
20628,1,1,707,1532,825
20629,0,0,2,0,-2
20630,1,0,1,0,-1
20631,1,0,22,0,-22
20632,0,0,119,0,-119
20633,0,0,1,0,-1
20634,0,0,40,0,-40
20635,0,0,15,0,-15
20636,1,0,40,0,-40
20637,0,0,7,0,-7
20638,1,1,550,1338,788
20639,1,1,105,1317,1212
20640,1,0,15,0,-15
20641,1,0,13,0,-13
20642,1,1,258,1278,1020
20643,0,0,58,0,-58
20644,1,0,37,0,-37
20645,1,1,2162,1384,-778
20646,1,1,394,1461,1067
20647,0,0,16,0,-16
20648,0,0,61,0,-61
20649,1,1,816,1234,418
20650,0,0,11,0,-11
20651,1,1,107,1632,1525
20652,1,1,673,1338,665
20653,0,0,18,0,-18
20654,1,0,45,0,-45
20655,1,0,37,0,-37
20656,1,0,7,0,-7
20657,0,0,186,0,-186
20658,1,0,92,0,-92
20659,0,0,9,0,-9
20660,1,0,7,0,-7
20661,1,0,23,0,-23
20662,1,0,16,0,-16
20663,1,0,165,0,-165
20664,1,1,233,1215,982
20665,0,0,15,0,-15
20666,0,0,8,0,-8
20667,1,0,24,0,-24
20668,0,0,184,0,-184
20669,1,1,2230,2830,600
20670,1,1,783,1805,1022
20671,1,0,148,0,-148
20672,1,0,66,0,-66
20673,1,1,1499,1395,-104
20674,1,1,345,1339,994
20675,1,0,28,0,-28
20676,0,0,35,0,-35
20677,1,0,41,0,-41
20678,1,1,363,1370,1007
20679,1,1,476,1253,777
20680,1,0,69,0,-69
20681,1,0,105,0,-105
20682,1,1,339,1370,1031
20683,1,1,425,1217,792
20684,0,0,32,0,-32
20685,1,0,9,0,-9
20686,1,0,49,0,-49
20687,1,0,34,0,-34
20688,0,0,8,0,-8
20689,1,1,315,1294,979
20690,1,1,273,1424,1151
20691,0,0,29,0,-29
20692,0,0,10,0,-10
20693,0,0,0,0,0
20694,1,1,780,2231,1451
20695,0,0,0,0,0
20696,1,1,586,1662,1076
20697,1,1,498,1262,764
20698,1,0,26,0,-26
20699,1,1,54,1218,1164
20700,0,0,18,0,-18
20701,1,0,44,0,-44
20702,1,1,229,1216,987
20703,1,1,554,2245,1691
20704,0,0,27,0,-27
20705,1,1,718,1218,500
20706,1,1,1006,1209,203
20707,0,0,23,0,-23
20708,1,0,40,0,-40
20709,0,0,9,0,-9
20710,0,0,3,0,-3
20711,1,0,19,0,-19
20712,1,1,265,1230,965
20713,1,0,41,0,-41
20714,1,0,115,0,-115
20715,0,0,30,0,-30
20716,0,0,9,0,-9
20717,0,0,67,0,-67
20718,1,0,36,0,-36
20719,0,0,41,0,-41
20720,0,0,40,0,-40
20721,1,1,969,1399,430
20722,0,0,6,0,-6
20723,1,1,1390,1458,68
20724,1,0,45,0,-45
20725,1,0,34,0,-34
20726,1,1,458,1224,766
20727,0,0,44,0,-44
20728,1,1,310,3027,2717
20729,1,1,25,1737,1712
20730,1,1,387,1903,1516
20731,1,0,18,0,-18
20732,0,0,85,0,-85
20733,1,1,85,1440,1355
20734,0,0,120,0,-120
20735,1,0,0,0,0
20736,1,0,19,0,-19
20737,1,1,575,1267,692
20738,0,0,25,0,-25
20739,1,0,34,0,-34
20740,1,1,1154,1246,92
20741,1,0,12,0,-12
20742,0,0,56,0,-56
20743,1,0,8,0,-8
20744,1,0,7,0,-7
20745,1,0,36,0,-36
20746,0,0,43,0,-43
20747,0,0,48,0,-48
20748,0,0,3,0,-3
20749,0,0,32,0,-32
20750,1,0,19,0,-19
20751,1,1,1183,2866,1683
20752,1,1,221,1788,1567
20753,1,1,987,1565,578
20754,1,0,15,0,-15
20755,1,1,1098,1225,127
20756,0,0,3,0,-3
20757,0,0,2,0,-2
20758,1,0,16,0,-16
20759,1,0,11,0,-11
20760,1,1,127,1513,1386
20761,0,0,47,0,-47
20762,0,0,6,0,-6
20763,0,0,17,0,-17
20764,1,1,1198,2243,1045
20765,1,1,627,1499,872
20766,1,0,32,0,-32
20767,0,0,4,0,-4
20768,1,1,1079,1740,661
20769,1,0,80,0,-80
20770,1,0,13,0,-13
20771,1,1,251,2600,2349
20772,1,0,4,0,-4
20773,1,0,18,0,-18
20774,0,0,0,0,0
20775,1,1,183,1774,1591
20776,1,0,47,0,-47
20777,1,1,865,1542,677
20778,1,0,8,0,-8
20779,1,1,366,1362,996
20780,1,1,707,1209,502
20781,1,1,60,1910,1850
20782,1,0,39,0,-39
20783,1,1,867,1706,839
20784,1,0,58,0,-58
20785,0,0,17,0,-17
20786,1,1,85,1489,1404
20787,1,0,171,0,-171
20788,0,0,110,0,-110
20789,0,0,0,0,0
20790,1,0,6,0,-6
20791,1,1,154,1247,1093
20792,1,0,28,0,-28
20793,1,0,4,0,-4
20794,0,0,12,0,-12
20795,1,1,402,1227,825
20796,1,1,929,1462,533
20797,1,0,16,0,-16
20798,1,0,13,0,-13
20799,1,1,805,1499,694
20800,0,0,3,0,-3
20801,0,0,147,0,-147
20802,0,0,179,0,-179
20803,0,0,5,0,-5
20804,0,0,40,0,-40
20805,0,0,3,0,-3
20806,1,1,866,2381,1515
20807,1,1,791,1561,770
20808,1,0,12,0,-12
20809,0,0,47,0,-47
20810,1,0,42,0,-42
20811,1,0,10,0,-10
20812,0,0,20,0,-20
20813,1,0,13,0,-13
20814,1,1,760,1658,898
20815,1,0,108,0,-108
20816,1,0,10,0,-10
20817,1,1,956,1488,532
20818,0,0,144,0,-144
20819,1,1,55,1247,1192
20820,1,1,435,1317,882
20821,1,0,107,0,-107
20822,0,0,27,0,-27
20823,0,0,21,0,-21
20824,1,1,1092,1676,584
20825,1,1,212,1347,1135
20826,0,0,214,0,-214
20827,1,0,1,0,-1
20828,1,1,441,1240,799
20829,0,0,48,0,-48
20830,0,0,45,0,-45
20831,1,0,6,0,-6
20832,1,1,1204,1806,602
20833,0,0,21,0,-21
20834,0,0,22,0,-22
20835,1,0,49,0,-49
20836,1,0,12,0,-12
20837,1,1,723,1354,631
20838,1,0,53,0,-53
20839,0,0,6,0,-6
20840,1,1,368,1408,1040
20841,1,1,216,1780,1564
20842,0,0,26,0,-26
20843,0,0,5,0,-5
20844,1,0,7,0,-7
20845,1,0,97,0,-97
20846,0,0,6,0,-6
20847,0,0,26,0,-26
20848,1,1,609,2743,2134
20849,1,0,146,0,-146
20850,0,0,16,0,-16
20851,1,0,84,0,-84
20852,0,0,13,0,-13
20853,1,0,30,0,-30
20854,1,1,544,2562,2018
20855,0,0,45,0,-45
20856,1,1,396,1253,857
20857,1,0,50,0,-50
20858,1,1,2190,1423,-767
20859,1,1,276,1200,924
20860,1,1,137,1235,1098
20861,1,1,401,1323,922
20862,1,1,255,1240,985
20863,1,0,41,0,-41
20864,1,0,1,0,-1
20865,0,0,13,0,-13
20866,1,1,1186,1353,167
20867,1,1,435,1332,897
20868,0,0,28,0,-28
20869,0,0,76,0,-76
20870,0,0,13,0,-13
20871,0,0,22,0,-22
20872,1,0,57,0,-57
20873,0,0,98,0,-98
20874,0,0,1,0,-1
20875,1,1,182,1330,1148
20876,1,0,31,0,-31
20877,1,0,8,0,-8
20878,1,0,14,0,-14
20879,1,1,482,1543,1061
20880,1,0,133,0,-133
20881,1,0,17,0,-17
20882,1,1,1160,1324,164
20883,0,0,11,0,-11
20884,0,0,28,0,-28
20885,1,0,24,0,-24
20886,1,1,846,1290,444
20887,0,0,1,0,-1
20888,1,0,36,0,-36
20889,0,0,25,0,-25
20890,1,1,980,2199,1219
20891,1,1,393,1880,1487
20892,0,0,19,0,-19
20893,0,0,94,0,-94
20894,0,0,11,0,-11
20895,1,0,123,0,-123
20896,1,1,690,1530,840
20897,1,1,813,1846,1033
20898,0,0,19,0,-19
20899,1,0,12,0,-12
20900,0,0,61,0,-61
20901,0,0,33,0,-33
20902,0,0,60,0,-60
20903,0,0,167,0,-167
20904,1,0,5,0,-5
20905,1,1,1329,1332,3
20906,0,0,49,0,-49
20907,0,0,87,0,-87
20908,1,0,53,0,-53
20909,0,0,27,0,-27
20910,1,0,15,0,-15
20911,1,1,127,1556,1429
20912,1,0,60,0,-60
20913,1,1,156,1937,1781
20914,1,0,44,0,-44
20915,0,0,87,0,-87
20916,1,1,431,1231,800
20917,1,1,1459,1662,203
20918,0,0,57,0,-57
20919,1,1,608,1492,884
20920,1,1,386,1221,835
20921,1,0,51,0,-51
20922,0,0,8,0,-8
20923,1,1,2339,1416,-923
20924,0,0,92,0,-92
20925,1,0,15,0,-15
20926,1,1,290,1454,1164
20927,1,0,33,0,-33
20928,1,0,64,0,-64
20929,0,0,30,0,-30
20930,0,0,17,0,-17
20931,1,1,861,1270,409
20932,1,1,534,1344,810
20933,1,0,2,0,-2
20934,1,0,25,0,-25
20935,1,1,338,1797,1459
20936,1,0,82,0,-82
20937,0,0,74,0,-74
20938,0,0,5,0,-5
20939,0,0,24,0,-24
20940,1,1,569,1986,1417
20941,1,1,89,1350,1261
20942,0,0,84,0,-84
20943,0,0,29,0,-29
20944,0,0,50,0,-50
20945,1,1,1823,1493,-330
20946,1,1,135,2119,1984
20947,1,0,14,0,-14
20948,0,0,30,0,-30
20949,1,0,141,0,-141
20950,0,0,3,0,-3
20951,1,1,217,1243,1026
20952,0,0,8,0,-8
20953,0,0,15,0,-15
20954,1,1,623,2313,1690
20955,0,0,94,0,-94
20956,0,0,16,0,-16
20957,0,0,2,0,-2
20958,1,1,226,3905,3679
20959,1,0,272,0,-272
20960,1,1,303,1732,1429
20961,1,1,358,1968,1610
20962,1,1,1455,1316,-139
20963,1,1,334,1347,1013
20964,0,0,100,0,-100
20965,0,0,92,0,-92
20966,0,0,88,0,-88
20967,1,1,431,1444,1013
20968,0,0,21,0,-21
20969,1,1,1824,1511,-313
20970,1,0,27,0,-27
20971,0,0,4,0,-4
20972,1,1,396,1297,901
20973,0,0,37,0,-37
20974,0,0,57,0,-57
20975,1,1,540,1326,786
20976,1,1,704,1244,540
20977,1,0,40,0,-40
20978,1,1,732,1862,1130
20979,1,0,47,0,-47
20980,0,0,2,0,-2
20981,1,1,113,1363,1250
20982,1,0,76,0,-76
20983,1,0,203,0,-203
20984,0,0,0,0,0
20985,1,0,25,0,-25
20986,0,0,21,0,-21
20987,1,1,110,1207,1097
20988,1,1,107,1467,1360
20989,0,0,53,0,-53
20990,1,0,13,0,-13
20991,1,1,118,1221,1103
20992,1,0,67,0,-67
20993,1,1,739,1467,728
20994,1,0,28,0,-28
20995,1,0,16,0,-16
20996,0,0,112,0,-112
20997,0,0,9,0,-9
20998,1,1,24,1257,1233
20999,1,0,17,0,-17
21000,1,0,18,0,-18
21001,1,0,119,0,-119
21002,1,1,126,1352,1226
21003,1,0,53,0,-53
21004,1,1,62,1279,1217
21005,1,0,11,0,-11
21006,0,0,185,0,-185
21007,1,1,453,1660,1207
21008,1,1,230,2448,2218
21009,1,0,127,0,-127
21010,1,0,16,0,-16
21011,1,0,12,0,-12
21012,1,1,146,1281,1135
21013,1,1,419,1382,963
21014,1,0,37,0,-37
21015,0,0,42,0,-42
21016,1,1,1332,2169,837
21017,1,0,47,0,-47
21018,0,0,46,0,-46
21019,0,0,101,0,-101
21020,1,1,86,1672,1586
21021,1,0,15,0,-15
21022,0,0,70,0,-70
21023,0,0,26,0,-26
21024,0,0,98,0,-98
21025,1,1,291,1243,952
21026,1,1,147,1352,1205
21027,1,1,607,1221,614
21028,0,0,18,0,-18
21029,0,0,126,0,-126
21030,1,1,611,1383,772
21031,0,0,101,0,-101
21032,0,0,16,0,-16
21033,1,1,191,1769,1578
21034,0,0,46,0,-46
21035,0,0,47,0,-47
21036,0,0,59,0,-59
21037,1,0,3,0,-3
21038,1,0,5,0,-5
21039,1,0,43,0,-43
21040,0,0,79,0,-79
21041,0,0,8,0,-8
21042,1,0,1,0,-1
21043,0,0,17,0,-17
21044,1,0,0,0,0
21045,0,0,5,0,-5
21046,0,0,52,0,-52
21047,1,1,327,1308,981
21048,0,0,39,0,-39
21049,0,0,82,0,-82
21050,1,0,9,0,-9
21051,1,1,1384,1287,-97
21052,0,0,68,0,-68
21053,0,0,96,0,-96
21054,1,1,103,1408,1305
21055,1,1,269,1322,1053
21056,0,0,91,0,-91
21057,1,1,1151,1246,95
21058,0,0,13,0,-13
21059,0,0,92,0,-92
21060,1,0,55,0,-55
21061,1,1,137,1224,1087
21062,1,1,2355,1493,-862
21063,1,0,15,0,-15
21064,1,0,2,0,-2
21065,0,0,128,0,-128
21066,0,0,33,0,-33
21067,1,1,39,2062,2023
21068,0,0,171,0,-171
21069,0,0,81,0,-81
21070,1,1,273,1612,1339
21071,1,0,21,0,-21
21072,1,0,49,0,-49
21073,1,0,153,0,-153
21074,1,0,9,0,-9
21075,1,1,165,1204,1039
21076,0,0,82,0,-82
21077,1,0,19,0,-19
21078,1,1,651,1217,566
21079,1,1,800,1243,443
21080,1,0,31,0,-31
21081,1,0,3,0,-3
21082,0,0,62,0,-62
21083,1,1,680,1285,605
21084,1,0,102,0,-102
21085,0,0,15,0,-15
21086,0,0,26,0,-26
21087,1,1,274,1233,959
21088,0,0,2,0,-2
21089,1,0,39,0,-39
21090,0,0,8,0,-8
21091,1,1,646,1529,883
21092,1,0,99,0,-99
21093,1,0,41,0,-41
21094,1,0,99,0,-99
21095,1,0,49,0,-49
21096,1,0,60,0,-60
21097,1,0,19,0,-19
21098,1,1,88,3311,3223
21099,1,0,102,0,-102
21100,1,1,1124,1359,235
21101,1,0,37,0,-37
21102,1,0,16,0,-16
21103,1,1,680,1658,978
21104,0,0,22,0,-22
21105,1,0,4,0,-4
21106,0,0,45,0,-45
21107,1,0,36,0,-36
21108,0,0,23,0,-23
21109,1,0,24,0,-24
21110,0,0,57,0,-57
21111,1,0,30,0,-30
21112,0,0,2,0,-2
21113,1,1,132,1408,1276
21114,0,0,70,0,-70
21115,0,0,12,0,-12
21116,1,1,106,1634,1528
21117,0,0,8,0,-8
21118,1,1,84,2271,2187
21119,1,1,1765,1331,-434
21120,1,1,448,1459,1011
21121,0,0,36,0,-36
21122,0,0,19,0,-19
21123,0,0,27,0,-27
21124,1,0,191,0,-191
21125,1,0,198,0,-198
21126,1,0,21,0,-21
21127,1,0,16,0,-16
21128,0,0,37,0,-37
21129,0,0,14,0,-14
21130,1,1,1105,2224,1119
21131,0,0,0,0,0
21132,0,0,41,0,-41
21133,1,0,129,0,-129
21134,1,0,177,0,-177
21135,1,0,21,0,-21
21136,1,0,116,0,-116
21137,1,0,80,0,-80
21138,0,0,13,0,-13
21139,1,1,449,1202,753
21140,1,0,86,0,-86
21141,1,0,185,0,-185
21142,1,0,68,0,-68
21143,1,0,181,0,-181
21144,1,0,10,0,-10
21145,0,0,2,0,-2
21146,0,0,0,0,0
21147,1,0,64,0,-64
21148,1,0,142,0,-142
21149,0,0,30,0,-30
21150,1,0,141,0,-141
21151,1,1,473,2314,1841
21152,1,1,1187,1232,45
21153,1,1,992,1303,311
21154,1,0,7,0,-7
21155,1,0,5,0,-5
21156,1,1,560,1400,840
21157,1,1,287,1270,983
21158,0,0,19,0,-19
21159,0,0,14,0,-14
21160,0,0,36,0,-36
21161,1,1,501,3147,2646
21162,1,1,2918,2451,-467
21163,1,1,169,1552,1383
21164,1,0,61,0,-61
21165,1,1,317,1278,961
21166,0,0,16,0,-16
21167,0,0,130,0,-130
21168,0,0,105,0,-105
21169,1,0,9,0,-9
21170,1,0,3,0,-3
21171,1,1,316,1216,900
21172,0,0,136,0,-136
21173,1,0,43,0,-43
21174,1,1,184,1383,1199
21175,1,0,6,0,-6
21176,1,1,690,1894,1204
21177,1,1,390,1284,894
21178,0,0,17,0,-17
21179,1,0,12,0,-12
21180,1,0,64,0,-64
21181,1,0,12,0,-12
21182,1,0,22,0,-22
21183,1,1,129,1604,1475
21184,1,1,441,1517,1076
21185,1,0,12,0,-12
21186,0,0,10,0,-10
21187,0,0,11,0,-11
21188,0,0,33,0,-33
21189,0,0,15,0,-15
21190,1,0,8,0,-8
21191,1,1,894,1808,914
21192,1,0,38,0,-38
21193,1,1,100,1244,1144
21194,1,0,44,0,-44
21195,1,0,37,0,-37
21196,0,0,55,0,-55
21197,0,0,5,0,-5
21198,0,0,47,0,-47
21199,1,1,521,1652,1131
21200,1,1,857,1520,663
21201,0,0,16,0,-16
21202,1,1,124,1273,1149
21203,1,1,150,1747,1597
21204,0,0,11,0,-11
21205,0,0,22,0,-22
21206,0,0,15,0,-15
21207,1,0,63,0,-63
21208,1,1,88,1296,1208
21209,0,0,17,0,-17
21210,1,1,266,1503,1237
21211,1,0,71,0,-71
21212,1,1,264,1230,966
21213,0,0,35,0,-35
21214,1,0,62,0,-62
21215,1,1,621,1671,1050
21216,1,0,7,0,-7
21217,1,0,38,0,-38
21218,0,0,47,0,-47
21219,0,0,97,0,-97
21220,1,1,958,1445,487
21221,1,1,107,1602,1495
21222,1,1,450,1264,814
21223,0,0,0,0,0
21224,0,0,20,0,-20
21225,1,1,658,1455,797
21226,0,0,18,0,-18
21227,1,1,868,1700,832
21228,0,0,307,0,-307
21229,1,1,138,3412,3274
21230,1,1,560,1592,1032
21231,1,0,99,0,-99
21232,0,0,179,0,-179
21233,1,0,22,0,-22
21234,1,1,200,1463,1263
21235,1,1,251,1231,980
21236,1,1,391,2072,1681
21237,0,0,13,0,-13
21238,0,0,54,0,-54
21239,1,0,2,0,-2
21240,0,0,110,0,-110
21241,1,1,226,1439,1213
21242,1,1,240,1591,1351
21243,1,0,14,0,-14
21244,0,0,17,0,-17
21245,1,0,15,0,-15
21246,1,0,12,0,-12
21247,0,0,8,0,-8
21248,0,0,25,0,-25
21249,0,0,10,0,-10
21250,1,0,81,0,-81
21251,0,0,9,0,-9
21252,0,0,121,0,-121
21253,0,0,3,0,-3
21254,0,0,82,0,-82
21255,0,0,5,0,-5
21256,1,0,101,0,-101
21257,1,1,1620,1574,-46
21258,0,0,11,0,-11
21259,1,0,159,0,-159
21260,1,1,165,1359,1194
21261,0,0,5,0,-5
21262,0,0,64,0,-64
21263,0,0,98,0,-98
21264,1,0,279,0,-279
21265,0,0,82,0,-82
21266,1,0,2,0,-2
21267,1,1,101,1785,1684
21268,1,0,21,0,-21
21269,1,1,353,1441,1088
21270,1,1,411,4357,3946
21271,1,1,179,1435,1256
21272,0,0,25,0,-25
21273,0,0,58,0,-58
21274,0,0,235,0,-235
21275,1,1,282,1234,952
21276,1,1,1125,1359,234
21277,0,0,17,0,-17
21278,1,0,102,0,-102
21279,0,0,68,0,-68
21280,1,1,95,1494,1399
21281,1,1,1440,1418,-22
21282,1,1,79,1310,1231
21283,1,0,137,0,-137
21284,1,0,39,0,-39
21285,0,0,48,0,-48
21286,1,1,735,1288,553
21287,1,0,103,0,-103
21288,1,1,19,1742,1723
21289,0,0,19,0,-19
21290,1,0,46,0,-46
21291,1,1,25,1346,1321
21292,1,0,24,0,-24
21293,1,0,3,0,-3
21294,1,1,736,1747,1011
21295,0,0,72,0,-72
21296,1,0,196,0,-196
21297,0,0,9,0,-9
21298,1,0,46,0,-46
21299,0,0,49,0,-49
21300,0,0,6,0,-6
21301,0,0,106,0,-106
21302,1,1,970,1311,341
21303,0,0,55,0,-55
21304,0,0,136,0,-136
21305,0,0,7,0,-7
21306,1,1,841,1416,575
21307,0,0,2,0,-2
21308,1,0,77,0,-77
21309,0,0,68,0,-68
21310,1,0,24,0,-24
21311,0,0,21,0,-21
21312,1,0,3,0,-3
21313,0,0,80,0,-80
21314,1,1,3049,1203,-1846
21315,1,0,35,0,-35
21316,1,1,593,2593,2000
21317,1,0,15,0,-15
21318,1,1,33,1347,1314
21319,0,0,85,0,-85
21320,1,0,146,0,-146
21321,1,0,26,0,-26
21322,1,0,9,0,-9
21323,1,0,74,0,-74
21324,0,0,3,0,-3
21325,1,0,160,0,-160
21326,1,0,10,0,-10
21327,0,0,85,0,-85
21328,1,0,24,0,-24
21329,1,0,86,0,-86
21330,0,0,48,0,-48
21331,0,0,85,0,-85
21332,1,1,216,1263,1047
21333,1,0,15,0,-15
21334,1,1,423,1489,1066
21335,1,1,359,1517,1158
21336,1,0,2,0,-2
21337,0,0,12,0,-12
21338,0,0,14,0,-14
21339,1,0,43,0,-43
21340,0,0,63,0,-63
21341,0,0,3,0,-3
21342,0,0,2,0,-2
21343,1,0,28,0,-28
21344,1,0,56,0,-56
21345,1,0,53,0,-53
21346,1,0,101,0,-101
21347,0,0,11,0,-11
21348,1,0,8,0,-8
21349,0,0,12,0,-12
21350,0,0,38,0,-38
21351,1,1,209,1212,1003
21352,0,0,78,0,-78
21353,0,0,8,0,-8
21354,1,0,34,0,-34
21355,1,1,1411,1265,-146
21356,1,0,26,0,-26
21357,1,0,14,0,-14
21358,0,0,16,0,-16
21359,0,0,32,0,-32
21360,0,0,8,0,-8
21361,0,0,135,0,-135
21362,1,0,60,0,-60
21363,1,0,176,0,-176
21364,1,1,228,1390,1162
21365,1,1,245,1902,1657
21366,1,1,173,1226,1053
21367,0,0,49,0,-49
21368,0,0,22,0,-22
21369,1,1,1464,1292,-172
21370,1,1,758,1227,469
21371,0,0,25,0,-25
21372,0,0,18,0,-18
21373,1,0,9,0,-9
21374,1,1,1740,1570,-170
21375,1,0,63,0,-63
21376,1,1,85,1300,1215
21377,1,1,114,1575,1461
21378,1,0,42,0,-42
21379,1,1,145,1233,1088
21380,1,0,19,0,-19
21381,1,0,64,0,-64
21382,1,0,19,0,-19
21383,0,0,30,0,-30
21384,0,0,33,0,-33
21385,1,0,95,0,-95
21386,1,0,18,0,-18
21387,1,1,240,1525,1285
21388,1,0,28,0,-28
21389,1,1,272,1277,1005
21390,1,0,2,0,-2
21391,0,0,60,0,-60
21392,1,0,104,0,-104
21393,1,0,185,0,-185
21394,1,0,0,0,0
21395,0,0,14,0,-14
21396,1,1,301,2065,1764
21397,0,0,16,0,-16
21398,1,0,103,0,-103
21399,1,1,1682,1253,-429
21400,0,0,226,0,-226
21401,0,0,136,0,-136
21402,0,0,81,0,-81
21403,1,1,258,1339,1081
21404,0,0,11,0,-11
21405,1,0,97,0,-97
21406,1,1,174,1364,1190
21407,1,1,195,1766,1571
21408,1,0,39,0,-39
21409,1,0,28,0,-28
21410,0,0,31,0,-31
21411,1,0,169,0,-169
21412,0,0,145,0,-145
21413,1,1,1575,1366,-209
21414,1,0,4,0,-4
21415,0,0,26,0,-26
21416,1,1,55,1508,1453
21417,0,0,137,0,-137
21418,1,0,111,0,-111
21419,0,0,26,0,-26
21420,0,0,4,0,-4
21421,0,0,78,0,-78
21422,1,0,188,0,-188
21423,1,1,397,1204,807
21424,1,0,32,0,-32
21425,1,0,47,0,-47
21426,1,1,214,1638,1424
21427,0,0,10,0,-10
21428,0,0,153,0,-153
21429,1,1,863,1687,824
21430,1,0,23,0,-23
21431,1,1,645,1296,651
21432,0,0,0,0,0
21433,1,0,10,0,-10
21434,0,0,8,0,-8
21435,0,0,56,0,-56
21436,1,1,273,2620,2347
21437,0,0,0,0,0
21438,1,0,133,0,-133
21439,0,0,49,0,-49
21440,1,0,15,0,-15
21441,0,0,18,0,-18
21442,1,0,51,0,-51
21443,1,0,5,0,-5
21444,1,0,2,0,-2
21445,0,0,62,0,-62
21446,0,0,21,0,-21
21447,1,1,212,4044,3832
21448,1,1,1368,1327,-41
21449,1,1,1639,3051,1412
21450,1,1,239,1668,1429
21451,1,0,147,0,-147
21452,0,0,21,0,-21
21453,0,0,56,0,-56
21454,1,1,196,1334,1138
21455,1,1,132,1250,1118
21456,1,1,1626,1739,113
21457,1,1,1335,1242,-93
21458,1,0,15,0,-15
21459,1,0,193,0,-193
21460,0,0,66,0,-66
21461,0,0,42,0,-42
21462,1,1,1763,1378,-385
21463,1,0,1,0,-1
21464,1,1,657,1346,689
21465,1,1,66,1338,1272
21466,1,0,32,0,-32
21467,1,1,482,1952,1470
21468,0,0,84,0,-84
21469,1,1,908,1282,374
21470,0,0,91,0,-91
21471,1,0,90,0,-90
21472,0,0,13,0,-13
21473,0,0,7,0,-7
21474,1,1,1499,1317,-182
21475,0,0,36,0,-36
21476,0,0,8,0,-8
21477,1,1,706,1506,800
21478,0,0,45,0,-45
21479,0,0,52,0,-52
21480,1,0,37,0,-37
21481,1,0,57,0,-57
21482,0,0,5,0,-5
21483,1,0,194,0,-194
21484,1,1,283,1564,1281
21485,0,0,26,0,-26
21486,1,1,444,1540,1096
21487,0,0,49,0,-49
21488,1,0,32,0,-32
21489,0,0,25,0,-25
21490,1,0,25,0,-25
21491,1,0,129,0,-129
21492,1,0,153,0,-153
21493,0,0,55,0,-55
21494,1,1,259,1228,969
21495,0,0,118,0,-118
21496,1,1,776,1306,530
21497,1,0,45,0,-45
21498,1,0,1,0,-1
21499,1,1,332,1328,996
21500,1,0,58,0,-58
21501,0,0,34,0,-34
21502,1,0,56,0,-56
21503,1,0,212,0,-212
21504,1,0,30,0,-30
21505,1,0,27,0,-27
21506,1,1,516,1233,717
21507,1,1,394,1585,1191
21508,1,0,42,0,-42
21509,0,0,20,0,-20
21510,1,0,6,0,-6
21511,1,1,591,1315,724
21512,1,1,422,1553,1131
21513,0,0,71,0,-71
21514,0,0,24,0,-24
21515,0,0,103,0,-103
21516,0,0,8,0,-8
21517,0,0,52,0,-52
21518,1,0,69,0,-69
21519,0,0,33,0,-33
21520,1,1,1664,1275,-389
21521,1,1,301,1324,1023
21522,1,0,9,0,-9
21523,1,0,35,0,-35
21524,1,1,394,1272,878
21525,0,0,14,0,-14
21526,1,1,465,1295,830
21527,1,1,358,1369,1011
21528,0,0,77,0,-77
21529,1,0,45,0,-45
21530,1,0,16,0,-16
21531,1,1,1326,1399,73
21532,0,0,7,0,-7
21533,1,0,97,0,-97
21534,0,0,111,0,-111
21535,1,0,1,0,-1
21536,1,0,53,0,-53
21537,0,0,12,0,-12
21538,1,1,294,1609,1315
21539,1,1,203,1692,1489
21540,1,0,13,0,-13
21541,0,0,5,0,-5
21542,1,1,133,1462,1329
21543,1,0,20,0,-20
21544,1,0,18,0,-18
21545,0,0,160,0,-160
21546,1,1,611,1255,644
21547,1,1,854,1339,485
21548,0,0,19,0,-19
21549,1,0,45,0,-45
21550,0,0,86,0,-86
21551,1,1,473,3591,3118
21552,1,0,10,0,-10
21553,0,0,20,0,-20
21554,1,0,148,0,-148
21555,1,0,7,0,-7
21556,0,0,31,0,-31
21557,1,1,751,1637,886
21558,1,0,4,0,-4
21559,0,0,16,0,-16
21560,1,1,637,1240,603
21561,1,0,57,0,-57
21562,1,0,74,0,-74
21563,1,1,219,1242,1023
21564,1,1,477,2009,1532
21565,0,0,24,0,-24
21566,1,0,26,0,-26
21567,1,1,124,1744,1620
21568,0,0,21,0,-21
21569,1,1,161,1983,1822
21570,1,1,686,1406,720
21571,0,0,32,0,-32
21572,0,0,82,0,-82
21573,0,0,1,0,-1
21574,1,1,1934,2111,177
21575,1,0,43,0,-43
21576,1,0,28,0,-28
21577,0,0,23,0,-23
21578,1,1,83,1290,1207
21579,0,0,58,0,-58
21580,0,0,130,0,-130
21581,0,0,14,0,-14
21582,1,1,854,1657,803
21583,1,1,790,1444,654
21584,0,0,108,0,-108
21585,1,0,111,0,-111
21586,0,0,17,0,-17
21587,0,0,11,0,-11
21588,0,0,102,0,-102
21589,1,1,100,1318,1218
21590,1,1,2435,1563,-872
21591,1,1,583,1345,762
21592,1,0,98,0,-98
21593,1,1,274,1693,1419
21594,0,0,14,0,-14
21595,1,0,115,0,-115
21596,1,0,7,0,-7
21597,1,1,1419,1413,-6
21598,0,0,9,0,-9
21599,1,1,108,2017,1909
21600,0,0,38,0,-38
21601,1,1,905,1520,615
21602,1,0,52,0,-52
21603,0,0,18,0,-18
21604,1,1,143,1418,1275
21605,0,0,126,0,-126
21606,1,0,21,0,-21
21607,1,1,829,2230,1401
21608,1,0,60,0,-60
21609,0,0,50,0,-50
21610,1,1,1151,1506,355
21611,1,1,770,1262,492
21612,0,0,106,0,-106
21613,0,0,63,0,-63
21614,0,0,86,0,-86
21615,1,0,16,0,-16
21616,0,0,50,0,-50
21617,0,0,4,0,-4
21618,1,0,24,0,-24
21619,1,0,42,0,-42
21620,1,0,76,0,-76
21621,0,0,249,0,-249
21622,0,0,80,0,-80
21623,0,0,156,0,-156
21624,1,0,0,0,0
21625,1,1,1149,1395,246
21626,1,1,505,1283,778
21627,0,0,33,0,-33
21628,1,0,100,0,-100
21629,1,1,432,1236,804
21630,1,1,1055,1214,159
21631,1,0,103,0,-103
21632,1,1,206,1233,1027
21633,1,0,125,0,-125
21634,1,1,637,1358,721
21635,1,1,323,2648,2325
21636,1,0,27,0,-27
21637,0,0,12,0,-12
21638,1,0,5,0,-5
21639,0,0,50,0,-50
21640,1,0,14,0,-14
21641,1,0,11,0,-11
21642,1,1,963,1581,618
21643,0,0,25,0,-25
21644,1,0,56,0,-56
21645,0,0,2,0,-2
21646,0,0,12,0,-12
21647,0,0,5,0,-5
21648,1,1,600,1340,740
21649,1,1,956,1264,308
21650,1,1,877,1210,333
21651,0,0,24,0,-24
21652,1,1,408,1273,865
21653,1,1,80,1565,1485
21654,1,1,1018,3029,2011
21655,0,0,97,0,-97
21656,1,0,33,0,-33
21657,1,0,100,0,-100
21658,1,0,12,0,-12
21659,1,0,32,0,-32
21660,0,0,145,0,-145
21661,0,0,74,0,-74
21662,0,0,32,0,-32
21663,1,1,232,1244,1012
21664,1,0,168,0,-168
21665,0,0,7,0,-7
21666,1,0,0,0,0
21667,1,0,56,0,-56
21668,0,0,28,0,-28
21669,0,0,38,0,-38
21670,0,0,10,0,-10
21671,1,0,69,0,-69
21672,1,1,832,1663,831
21673,0,0,0,0,0
21674,1,1,593,2012,1419
21675,1,1,490,1496,1006
21676,1,1,198,1238,1040
21677,1,0,31,0,-31
21678,1,1,104,1831,1727
21679,1,0,140,0,-140
21680,0,0,33,0,-33
21681,0,0,3,0,-3
21682,0,0,5,0,-5
21683,1,0,5,0,-5
21684,1,0,58,0,-58
21685,0,0,11,0,-11
21686,1,0,55,0,-55
21687,1,1,1473,1226,-247
21688,0,0,5,0,-5
21689,1,0,102,0,-102
21690,1,0,2,0,-2
21691,0,0,34,0,-34
21692,1,1,181,1765,1584
21693,0,0,216,0,-216
21694,0,0,6,0,-6
21695,0,0,208,0,-208
21696,0,0,59,0,-59
21697,1,0,35,0,-35
21698,1,0,27,0,-27
21699,0,0,53,0,-53
21700,1,1,31,1266,1235
21701,1,1,98,1220,1122
21702,0,0,20,0,-20
21703,1,1,556,2371,1815
21704,1,1,327,1448,1121
21705,1,0,27,0,-27
21706,1,0,42,0,-42
21707,0,0,23,0,-23
21708,1,0,107,0,-107
21709,0,0,50,0,-50
21710,1,0,179,0,-179
21711,0,0,15,0,-15
21712,0,0,2,0,-2
21713,0,0,3,0,-3
21714,0,0,71,0,-71
21715,1,0,37,0,-37
21716,0,0,36,0,-36
21717,1,1,76,2013,1937
21718,0,0,122,0,-122
21719,1,1,1153,1224,71
21720,0,0,20,0,-20
21721,0,0,8,0,-8
21722,0,0,144,0,-144
21723,1,0,31,0,-31
21724,0,0,52,0,-52
21725,1,0,3,0,-3
21726,1,0,12,0,-12
21727,1,0,160,0,-160
21728,0,0,168,0,-168
21729,1,1,557,1719,1162
21730,1,1,211,1403,1192
21731,0,0,86,0,-86
21732,1,1,453,2366,1913
21733,0,0,151,0,-151
21734,1,0,53,0,-53
21735,1,1,3012,2516,-496
21736,0,0,1,0,-1
21737,1,0,20,0,-20
21738,1,1,593,1445,852
21739,0,0,15,0,-15
21740,0,0,87,0,-87
21741,0,0,21,0,-21
21742,0,0,40,0,-40
21743,0,0,3,0,-3
21744,0,0,24,0,-24
21745,1,0,61,0,-61
21746,1,1,140,1246,1106
21747,0,0,9,0,-9
21748,0,0,24,0,-24
21749,0,0,72,0,-72
21750,0,0,5,0,-5
21751,0,0,43,0,-43
21752,1,0,3,0,-3
21753,0,0,11,0,-11
21754,1,0,41,0,-41
21755,0,0,194,0,-194
21756,1,1,1798,1208,-590
21757,1,0,56,0,-56
21758,0,0,18,0,-18
21759,0,0,21,0,-21
21760,1,0,3,0,-3
21761,1,1,246,1798,1552
21762,1,1,73,1300,1227
21763,1,0,244,0,-244
21764,1,0,3,0,-3
21765,1,1,91,2361,2270
21766,1,1,105,1210,1105
21767,0,0,39,0,-39
21768,0,0,1,0,-1
21769,0,0,19,0,-19
21770,0,0,24,0,-24
21771,1,1,827,1403,576
21772,1,0,3,0,-3
21773,0,0,16,0,-16
21774,1,0,1,0,-1
21775,0,0,105,0,-105
21776,1,0,52,0,-52
21777,0,0,50,0,-50
21778,0,0,83,0,-83
21779,1,1,823,1211,388
21780,0,0,43,0,-43
21781,1,1,1087,1418,331
21782,1,1,611,6665,6054
21783,0,0,91,0,-91
21784,0,0,29,0,-29
21785,0,0,74,0,-74
21786,0,0,46,0,-46
21787,1,0,16,0,-16
21788,1,0,38,0,-38
21789,0,0,84,0,-84
21790,1,0,17,0,-17
21791,1,1,913,2194,1281
21792,1,0,54,0,-54
21793,0,0,47,0,-47
21794,0,0,2,0,-2
21795,0,0,14,0,-14
21796,1,0,12,0,-12
21797,0,0,242,0,-242
21798,1,0,43,0,-43
21799,0,0,46,0,-46
21800,1,1,516,1455,939
21801,0,0,29,0,-29
21802,0,0,15,0,-15
21803,1,1,180,1533,1353
21804,0,0,88,0,-88
21805,0,0,24,0,-24
21806,1,0,21,0,-21
21807,0,0,83,0,-83
21808,1,0,37,0,-37
21809,0,0,16,0,-16
21810,0,0,13,0,-13
21811,1,1,1008,1504,496
21812,0,0,117,0,-117
21813,0,0,80,0,-80
21814,0,0,2,0,-2
21815,1,0,87,0,-87
21816,1,1,201,1202,1001
21817,1,1,728,1289,561
21818,0,0,28,0,-28
21819,0,0,18,0,-18
21820,0,0,10,0,-10
21821,1,0,0,0,0
21822,1,0,76,0,-76
21823,1,1,659,1323,664
21824,0,0,64,0,-64
21825,1,0,57,0,-57
21826,0,0,72,0,-72
21827,0,0,106,0,-106
21828,1,0,34,0,-34
21829,1,1,438,1342,904
21830,1,0,23,0,-23
21831,0,0,7,0,-7
21832,1,0,127,0,-127
21833,1,0,47,0,-47
21834,1,1,1191,2541,1350
21835,1,1,1846,1651,-195
21836,1,0,69,0,-69
21837,1,0,13,0,-13
21838,1,1,92,1289,1197
21839,1,1,550,2174,1624
21840,1,1,208,1344,1136
21841,0,0,81,0,-81
21842,1,0,18,0,-18
21843,1,1,288,1271,983
21844,1,1,566,1467,901
21845,0,0,207,0,-207
21846,1,1,133,1356,1223
21847,1,0,8,0,-8
21848,1,0,5,0,-5
21849,1,1,460,1327,867
21850,0,0,2,0,-2
21851,1,1,102,1337,1235
21852,0,0,0,0,0
21853,1,0,4,0,-4
21854,1,1,177,1273,1096
21855,1,1,348,1456,1108
21856,1,0,68,0,-68
21857,0,0,7,0,-7
21858,0,0,1,0,-1
21859,1,0,25,0,-25
21860,0,0,1,0,-1
21861,1,1,409,1405,996
21862,1,0,16,0,-16
21863,1,1,504,1304,800
21864,0,0,4,0,-4
21865,1,1,1898,1206,-692
21866,0,0,66,0,-66
21867,0,0,8,0,-8
21868,0,0,71,0,-71
21869,0,0,64,0,-64
21870,1,1,1158,1381,223
21871,1,0,91,0,-91
21872,1,1,558,1217,659
21873,1,1,154,1476,1322
21874,1,1,611,1218,607
21875,0,0,34,0,-34
21876,1,1,1136,1485,349
21877,0,0,14,0,-14
21878,1,0,3,0,-3
21879,1,1,501,1289,788
21880,1,1,477,1629,1152
21881,0,0,40,0,-40
21882,0,0,120,0,-120
21883,1,1,24,1750,1726
21884,1,1,147,1211,1064
21885,0,0,1,0,-1
21886,0,0,59,0,-59
21887,0,0,39,0,-39
21888,1,1,339,2181,1842
21889,1,0,52,0,-52
21890,0,0,33,0,-33
21891,1,1,40,1581,1541
21892,1,0,167,0,-167
21893,1,0,103,0,-103
21894,1,1,933,1659,726
21895,1,0,49,0,-49
21896,1,0,48,0,-48
21897,1,1,212,2038,1826
21898,0,0,172,0,-172
21899,1,0,1,0,-1
21900,1,0,33,0,-33
21901,0,0,0,0,0
21902,1,0,219,0,-219
21903,1,0,65,0,-65
21904,1,0,96,0,-96
21905,0,0,31,0,-31
21906,1,1,174,1305,1131
21907,1,0,173,0,-173
21908,1,1,269,1296,1027
21909,0,0,17,0,-17
21910,0,0,1,0,-1
21911,1,0,227,0,-227
21912,0,0,12,0,-12
21913,0,0,4,0,-4
21914,1,0,16,0,-16
21915,0,0,17,0,-17
21916,1,0,31,0,-31
21917,1,1,249,1247,998
21918,0,0,176,0,-176
21919,0,0,66,0,-66
21920,0,0,32,0,-32
21921,1,1,32,1206,1174
21922,1,1,207,1225,1018
21923,1,1,1275,1380,105
21924,1,1,781,1580,799
21925,1,1,369,1388,1019
21926,0,0,22,0,-22
21927,1,0,4,0,-4
21928,0,0,28,0,-28
21929,1,0,72,0,-72
21930,1,1,1355,1348,-7
21931,1,0,18,0,-18
21932,0,0,13,0,-13
21933,0,0,10,0,-10
21934,0,0,6,0,-6
21935,1,0,21,0,-21
21936,0,0,17,0,-17
21937,0,0,13,0,-13
21938,1,1,296,1301,1005
21939,1,1,1342,1523,181
21940,0,0,52,0,-52
21941,1,1,994,1830,836
21942,1,1,411,1676,1265
21943,1,0,55,0,-55
21944,0,0,26,0,-26
21945,1,0,45,0,-45
21946,1,0,169,0,-169
21947,1,1,159,1280,1121
21948,0,0,1,0,-1
21949,0,0,3,0,-3
21950,1,0,6,0,-6
21951,0,0,60,0,-60
21952,0,0,29,0,-29
21953,1,1,168,1230,1062
21954,0,0,13,0,-13
21955,1,0,151,0,-151
21956,1,1,129,2547,2418
21957,1,1,469,1335,866
21958,1,0,131,0,-131
21959,0,0,18,0,-18
21960,0,0,136,0,-136
21961,1,1,527,1237,710
21962,1,0,8,0,-8
21963,0,0,42,0,-42
21964,1,1,1275,1485,210
21965,1,1,399,1229,830
21966,1,1,648,1951,1303
21967,1,0,56,0,-56
21968,0,0,1,0,-1
21969,0,0,16,0,-16
21970,0,0,16,0,-16
21971,1,0,9,0,-9
21972,0,0,28,0,-28
21973,0,0,61,0,-61
21974,1,0,40,0,-40
21975,0,0,42,0,-42
21976,1,1,162,1340,1178
21977,0,0,32,0,-32
21978,0,0,14,0,-14
21979,0,0,134,0,-134
21980,1,0,227,0,-227
21981,1,0,36,0,-36
21982,1,1,99,1399,1300
21983,0,0,100,0,-100
21984,0,0,55,0,-55
21985,1,1,81,1274,1193
21986,0,0,34,0,-34
21987,0,0,66,0,-66
21988,1,1,765,2000,1235
21989,1,1,482,1225,743
21990,0,0,58,0,-58
21991,0,0,61,0,-61
21992,0,0,47,0,-47
21993,1,1,1876,2447,571
21994,0,0,0,0,0
21995,1,0,78,0,-78
21996,1,0,46,0,-46
21997,1,1,178,1250,1072
21998,0,0,13,0,-13
21999,1,0,78,0,-78
22000,0,0,72,0,-72
22001,1,0,42,0,-42
22002,1,1,193,1400,1207
22003,1,1,461,1512,1051
22004,0,0,36,0,-36
22005,1,0,0,0,0
22006,1,1,386,1212,826
22007,1,0,4,0,-4
22008,1,0,81,0,-81
22009,1,1,176,1662,1486
22010,1,0,26,0,-26
22011,0,0,78,0,-78
22012,1,1,315,1355,1040
22013,1,1,227,1931,1704
22014,1,0,91,0,-91
22015,1,0,49,0,-49
22016,1,0,24,0,-24
22017,1,0,3,0,-3
22018,0,0,45,0,-45
22019,0,0,51,0,-51
22020,0,0,43,0,-43
22021,1,1,190,1413,1223
22022,0,0,33,0,-33
22023,0,0,13,0,-13
22024,1,0,72,0,-72
22025,1,0,20,0,-20
22026,1,1,255,2325,2070
22027,1,0,157,0,-157
22028,0,0,22,0,-22
22029,1,0,3,0,-3
22030,0,0,3,0,-3
22031,0,0,22,0,-22
22032,1,1,663,1233,570
22033,0,0,45,0,-45
22034,1,1,650,3342,2692
22035,1,1,28,1363,1335
22036,1,0,107,0,-107
22037,1,0,22,0,-22
22038,1,0,7,0,-7
22039,1,1,246,1288,1042
22040,0,0,87,0,-87
22041,1,1,1179,1976,797
22042,0,0,76,0,-76
22043,0,0,30,0,-30
22044,0,0,32,0,-32
22045,0,0,9,0,-9
22046,0,0,78,0,-78
22047,1,1,182,1272,1090
22048,1,0,197,0,-197
22049,1,0,43,0,-43
22050,1,1,1211,1699,488
22051,1,1,28,1208,1180
22052,0,0,2,0,-2
22053,0,0,4,0,-4
22054,1,1,161,1603,1442
22055,0,0,41,0,-41
22056,1,0,53,0,-53
22057,1,1,442,1232,790
22058,0,0,67,0,-67
22059,1,1,365,1384,1019
22060,1,1,1824,2117,293
22061,0,0,158,0,-158
22062,0,0,50,0,-50
22063,0,0,12,0,-12
22064,1,0,5,0,-5
22065,0,0,32,0,-32
22066,1,0,68,0,-68
22067,1,1,815,1214,399
22068,1,1,126,1248,1122
22069,0,0,81,0,-81
22070,1,0,90,0,-90
22071,0,0,101,0,-101
22072,0,0,13,0,-13
22073,1,0,2,0,-2
22074,0,0,31,0,-31
22075,1,0,38,0,-38
22076,1,0,2,0,-2
22077,0,0,1,0,-1
22078,1,1,150,1406,1256
22079,1,1,1667,1677,10
22080,0,0,147,0,-147
22081,1,1,153,1206,1053
22082,1,1,730,1433,703
22083,0,0,12,0,-12
22084,1,1,557,2471,1914
22085,1,1,99,1525,1426
22086,0,0,128,0,-128
22087,1,0,0,0,0
22088,0,0,11,0,-11
22089,1,0,31,0,-31
22090,1,0,144,0,-144
22091,1,0,3,0,-3
22092,0,0,3,0,-3
22093,1,1,37,1244,1207
22094,1,1,1128,1201,73
22095,1,0,18,0,-18
22096,1,0,41,0,-41
22097,0,0,50,0,-50
22098,0,0,35,0,-35
22099,0,0,6,0,-6
22100,1,0,17,0,-17
22101,1,1,65,1590,1525
22102,1,1,247,1548,1301
22103,0,0,43,0,-43
22104,1,0,34,0,-34
22105,1,1,712,1321,609
22106,1,1,170,1554,1384
22107,0,0,73,0,-73
22108,1,0,115,0,-115
22109,1,0,117,0,-117
22110,0,0,54,0,-54
22111,0,0,123,0,-123
22112,1,0,46,0,-46
22113,0,0,11,0,-11
22114,1,0,59,0,-59
22115,1,0,100,0,-100
22116,0,0,183,0,-183
22117,1,1,1122,1637,515
22118,1,0,56,0,-56
22119,0,0,32,0,-32
22120,0,0,114,0,-114
22121,0,0,124,0,-124
22122,1,1,89,2343,2254
22123,1,0,9,0,-9
22124,1,1,51,1685,1634
22125,0,0,57,0,-57
22126,1,0,86,0,-86
22127,0,0,8,0,-8
22128,1,1,220,2263,2043
22129,1,1,89,3797,3708
22130,1,0,37,0,-37
22131,1,1,166,1281,1115
22132,0,0,56,0,-56
22133,1,0,15,0,-15
22134,1,1,291,1225,934
22135,1,1,415,1415,1000
22136,0,0,33,0,-33
22137,1,1,1080,1300,220
22138,1,1,1164,1789,625
22139,0,0,41,0,-41
22140,1,1,713,1326,613
22141,0,0,28,0,-28
22142,1,0,3,0,-3
22143,0,0,43,0,-43
22144,1,1,346,1696,1350
22145,1,1,751,1306,555
22146,0,0,58,0,-58
22147,1,0,35,0,-35
22148,0,0,1,0,-1
22149,0,0,16,0,-16
22150,1,1,214,1365,1151
22151,1,0,33,0,-33
22152,0,0,21,0,-21
22153,0,0,12,0,-12
22154,1,1,229,1342,1113
22155,1,0,16,0,-16
22156,1,0,2,0,-2
22157,0,0,9,0,-9
22158,1,0,3,0,-3
22159,0,0,25,0,-25
22160,1,1,528,1518,990
22161,1,0,69,0,-69
22162,1,1,1212,1752,540
22163,1,1,157,1229,1072
22164,1,0,21,0,-21
22165,1,1,1328,1207,-121
22166,1,1,592,2646,2054
22167,1,0,44,0,-44
22168,1,1,833,1217,384
22169,1,1,132,1405,1273
22170,1,0,14,0,-14
22171,1,0,23,0,-23
22172,1,0,107,0,-107
22173,1,0,98,0,-98
22174,1,0,45,0,-45
22175,1,1,733,1330,597
22176,1,1,2016,2082,66
22177,1,1,557,2353,1796
22178,1,1,295,1258,963
22179,1,0,132,0,-132
22180,0,0,57,0,-57
22181,0,0,23,0,-23
22182,1,0,195,0,-195
22183,0,0,50,0,-50
22184,1,0,12,0,-12
22185,1,1,603,1494,891
22186,1,0,16,0,-16
22187,0,0,43,0,-43
22188,1,0,49,0,-49
22189,0,0,64,0,-64
22190,0,0,64,0,-64
22191,1,0,77,0,-77
22192,1,1,160,1643,1483
22193,0,0,35,0,-35
22194,0,0,48,0,-48
22195,0,0,58,0,-58
22196,1,1,874,2461,1587
22197,0,0,93,0,-93
22198,1,1,33,1562,1529
22199,0,0,145,0,-145
22200,1,1,208,1336,1128
22201,1,1,605,2065,1460
22202,1,1,90,1567,1477
22203,1,1,21,1550,1529
22204,1,1,1100,1574,474
22205,1,1,1443,1290,-153
22206,0,0,13,0,-13
22207,1,0,20,0,-20
22208,1,1,1030,1364,334
22209,0,0,9,0,-9
22210,1,1,619,1326,707
22211,1,0,80,0,-80
22212,0,0,31,0,-31
22213,1,0,143,0,-143
22214,1,0,23,0,-23
22215,0,0,90,0,-90
22216,0,0,12,0,-12
22217,0,0,20,0,-20
22218,0,0,7,0,-7
22219,1,0,3,0,-3
22220,1,1,685,1950,1265
22221,1,1,84,1446,1362
22222,1,1,958,1246,288
22223,1,0,86,0,-86
22224,0,0,5,0,-5
22225,0,0,37,0,-37
22226,1,1,115,1485,1370
22227,0,0,13,0,-13
22228,0,0,25,0,-25
22229,0,0,34,0,-34
22230,1,1,464,1324,860
22231,0,0,55,0,-55
22232,0,0,47,0,-47
22233,0,0,34,0,-34
22234,0,0,48,0,-48
22235,1,1,291,1320,1029
22236,1,0,66,0,-66
22237,0,0,60,0,-60
22238,0,0,3,0,-3
22239,1,1,342,1565,1223
22240,0,0,36,0,-36
22241,0,0,142,0,-142
22242,0,0,13,0,-13
22243,1,0,42,0,-42
22244,1,0,20,0,-20
22245,1,0,7,0,-7
22246,1,0,55,0,-55
22247,1,0,79,0,-79
22248,0,0,7,0,-7
22249,1,0,131,0,-131
22250,1,1,291,1532,1241
22251,1,1,488,1478,990
22252,0,0,30,0,-30
22253,1,0,31,0,-31
22254,0,0,26,0,-26
22255,0,0,13,0,-13
22256,1,0,0,0,0
22257,1,1,173,1200,1027
22258,0,0,28,0,-28
22259,1,0,22,0,-22
22260,0,0,24,0,-24
22261,1,0,33,0,-33
22262,1,1,211,1206,995
22263,1,1,219,2048,1829
22264,0,0,10,0,-10
22265,1,0,77,0,-77
22266,1,1,284,1269,985
22267,1,0,24,0,-24
22268,0,0,73,0,-73
22269,1,1,942,1294,352
22270,1,1,961,1611,650
22271,1,1,73,1436,1363
22272,0,0,132,0,-132
22273,1,1,776,1461,685
22274,1,1,2252,1239,-1013
22275,0,0,7,0,-7
22276,0,0,49,0,-49
22277,1,0,31,0,-31
22278,1,1,629,1264,635
22279,1,1,85,1374,1289
22280,0,0,90,0,-90
22281,0,0,71,0,-71
22282,1,1,231,1230,999
22283,1,1,162,1218,1056
22284,1,0,3,0,-3
22285,1,1,215,3062,2847
22286,0,0,31,0,-31
22287,1,1,541,1676,1135
22288,1,0,108,0,-108
22289,1,1,602,1338,736
22290,1,1,235,1339,1104
22291,1,0,22,0,-22
22292,0,0,21,0,-21
22293,1,1,250,1307,1057
22294,1,0,53,0,-53
22295,0,0,54,0,-54
22296,1,1,425,1249,824
22297,0,0,47,0,-47
22298,0,0,19,0,-19
22299,0,0,71,0,-71
22300,0,0,146,0,-146
22301,1,0,23,0,-23
22302,1,0,78,0,-78
22303,1,0,38,0,-38
22304,0,0,288,0,-288
22305,1,0,80,0,-80
22306,0,0,12,0,-12
22307,1,0,0,0,0
22308,1,1,195,1200,1005
22309,1,1,81,1312,1231
22310,0,0,30,0,-30
22311,0,0,66,0,-66
22312,0,0,110,0,-110
22313,1,1,248,1237,989
22314,0,0,15,0,-15
22315,1,1,400,1409,1009
22316,1,0,105,0,-105
22317,1,1,158,1510,1352
22318,0,0,19,0,-19
22319,1,0,1,0,-1
22320,1,0,130,0,-130
22321,1,1,312,1210,898
22322,0,0,35,0,-35
22323,1,0,2,0,-2
22324,1,1,58,1347,1289
22325,0,0,151,0,-151
22326,1,1,2861,1571,-1290
22327,1,0,74,0,-74
22328,0,0,59,0,-59
22329,1,0,72,0,-72
22330,0,0,159,0,-159
22331,0,0,33,0,-33
22332,1,0,69,0,-69
22333,0,0,27,0,-27
22334,1,1,287,1753,1466
22335,0,0,37,0,-37
22336,1,1,79,1240,1161
22337,1,0,109,0,-109
22338,0,0,19,0,-19
22339,0,0,7,0,-7
22340,1,1,539,1674,1135
22341,1,1,1040,1920,880
22342,1,1,549,1886,1337
22343,1,1,137,1308,1171
22344,0,0,22,0,-22
22345,1,1,89,1887,1798
22346,1,0,39,0,-39
22347,0,0,4,0,-4
22348,0,0,57,0,-57
22349,0,0,0,0,0
22350,1,0,4,0,-4
22351,0,0,4,0,-4
22352,0,0,32,0,-32
22353,1,0,3,0,-3
22354,1,1,655,1785,1130
22355,1,0,74,0,-74
22356,0,0,48,0,-48
22357,1,1,328,1771,1443
22358,1,1,942,1554,612
22359,0,0,38,0,-38
22360,0,0,30,0,-30
22361,1,0,17,0,-17
22362,1,1,424,1844,1420
22363,0,0,11,0,-11
22364,0,0,1,0,-1
22365,0,0,5,0,-5
22366,1,1,302,3320,3018
22367,0,0,14,0,-14
22368,1,1,140,1317,1177
22369,1,0,70,0,-70
22370,1,1,718,1285,567
22371,1,1,263,1289,1026
22372,1,0,6,0,-6
22373,1,1,80,1293,1213
22374,0,0,32,0,-32
22375,1,0,0,0,0
22376,1,0,56,0,-56
22377,0,0,20,0,-20
22378,1,1,2057,1311,-746
22379,1,1,1498,1848,350
22380,0,0,122,0,-122
22381,1,0,26,0,-26
22382,0,0,18,0,-18
22383,0,0,20,0,-20
22384,1,1,121,4219,4098
22385,1,1,108,2106,1998
22386,0,0,33,0,-33
22387,1,0,30,0,-30
22388,1,1,49,1509,1460
22389,0,0,37,0,-37
22390,1,0,52,0,-52
22391,0,0,44,0,-44
22392,1,0,2,0,-2
22393,1,1,858,1926,1068
22394,0,0,15,0,-15
22395,1,0,39,0,-39
22396,1,1,239,1286,1047
22397,1,0,30,0,-30
22398,1,0,38,0,-38
22399,0,0,92,0,-92
22400,1,1,126,1984,1858
22401,1,1,50,3564,3514
22402,0,0,13,0,-13
22403,1,1,166,1414,1248
22404,1,0,33,0,-33
22405,1,1,564,1206,642
22406,1,0,111,0,-111
22407,0,0,10,0,-10
22408,0,0,62,0,-62
22409,1,0,52,0,-52
22410,1,0,7,0,-7
22411,1,1,75,1742,1667
22412,1,1,1133,1205,72
22413,0,0,25,0,-25
22414,1,1,113,1210,1097
22415,1,1,1992,1203,-789
22416,1,1,975,1243,268
22417,0,0,61,0,-61
22418,0,0,124,0,-124
22419,1,0,35,0,-35
22420,1,0,135,0,-135
22421,0,0,16,0,-16
22422,1,1,561,1375,814
22423,1,0,83,0,-83
22424,0,0,48,0,-48
22425,1,0,41,0,-41
22426,1,1,3525,1520,-2005
22427,1,0,26,0,-26
22428,1,0,124,0,-124
22429,1,0,108,0,-108
22430,0,0,0,0,0
22431,0,0,97,0,-97
22432,1,0,55,0,-55
22433,0,0,52,0,-52
22434,0,0,183,0,-183
22435,1,1,423,1223,800
22436,1,1,212,1706,1494
22437,1,0,47,0,-47
22438,1,0,52,0,-52
22439,1,1,363,1308,945
22440,1,0,27,0,-27
22441,1,1,72,1246,1174
22442,1,1,82,1231,1149
22443,1,1,710,1955,1245
22444,0,0,19,0,-19
22445,1,0,9,0,-9
22446,1,1,714,1309,595
22447,1,1,460,1310,850
22448,1,0,44,0,-44
22449,0,0,19,0,-19
22450,1,0,20,0,-20
22451,1,0,6,0,-6
22452,1,0,93,0,-93
22453,1,1,701,1227,526
22454,0,0,260,0,-260
22455,0,0,117,0,-117
22456,1,1,464,1311,847
22457,1,1,154,1644,1490
22458,0,0,0,0,0
22459,0,0,7,0,-7
22460,1,1,621,1345,724
22461,1,0,132,0,-132
22462,1,1,149,1912,1763
22463,0,0,86,0,-86
22464,1,0,69,0,-69
22465,1,0,8,0,-8
22466,0,0,11,0,-11
22467,0,0,157,0,-157
22468,0,0,101,0,-101
22469,1,0,61,0,-61
22470,0,0,64,0,-64
22471,0,0,59,0,-59
22472,0,0,11,0,-11
22473,0,0,25,0,-25
22474,1,0,116,0,-116
22475,0,0,138,0,-138
22476,1,1,884,3295,2411
22477,0,0,38,0,-38
22478,1,1,394,1202,808
22479,0,0,23,0,-23
22480,1,0,82,0,-82
22481,1,0,1,0,-1
22482,0,0,7,0,-7
22483,1,0,35,0,-35
22484,1,1,439,1209,770
22485,0,0,51,0,-51
22486,1,1,78,1930,1852
22487,1,1,148,1200,1052
22488,1,1,20,1278,1258
22489,1,1,221,1574,1353
22490,1,0,63,0,-63
22491,0,0,11,0,-11
22492,1,1,1061,1590,529
22493,0,0,9,0,-9
22494,1,1,577,1417,840
22495,1,0,48,0,-48
22496,1,1,353,1924,1571
22497,0,0,61,0,-61
22498,0,0,62,0,-62
22499,1,1,506,1349,843
22500,0,0,11,0,-11
22501,0,0,7,0,-7
22502,1,0,13,0,-13
22503,0,0,209,0,-209
22504,1,1,51,1235,1184
22505,1,1,479,1462,983
22506,0,0,90,0,-90
22507,0,0,21,0,-21
22508,1,0,5,0,-5
22509,1,1,403,1207,804
22510,0,0,37,0,-37
22511,0,0,170,0,-170
22512,1,0,22,0,-22
22513,0,0,3,0,-3
22514,0,0,118,0,-118
22515,1,0,96,0,-96
22516,1,1,327,1303,976
22517,0,0,20,0,-20
22518,1,1,69,1955,1886
22519,0,0,1,0,-1
22520,0,0,6,0,-6
22521,0,0,49,0,-49
22522,0,0,97,0,-97
22523,0,0,76,0,-76
22524,1,0,2,0,-2
22525,1,0,101,0,-101
22526,0,0,224,0,-224
22527,0,0,24,0,-24
22528,0,0,38,0,-38
22529,1,0,53,0,-53
22530,1,1,327,2006,1679
