ID,Флаг дозвона,Флаг продажи,Расходы,PV,NPV
0,1,0,113,0,-113
1,1,1,269,1707,1438
2,1,0,15,0,-15
3,1,1,273,2143,1870
4,1,1,607,1246,639
5,0,0,8,0,-8
6,1,1,102,1452,1350
7,1,0,14,0,-14
8,0,0,99,0,-99
9,1,0,13,0,-13
10,1,1,533,1899,1366
11,1,1,475,1666,1191
12,0,0,58,0,-58
13,1,1,88,1300,1212
14,0,0,9,0,-9
15,1,1,648,1228,580
16,0,0,20,0,-20
17,1,1,87,1257,1170
18,1,1,43,1808,1765
19,1,1,605,1679,1074
20,0,0,97,0,-97
21,1,1,207,1924,1717
22,1,0,89,0,-89
23,1,1,1216,1509,293
24,1,1,959,1713,754
25,1,0,3,0,-3
26,1,1,501,2077,1576
27,0,0,43,0,-43
28,0,0,43,0,-43
29,1,0,40,0,-40
30,0,0,36,0,-36
31,0,0,73,0,-73
32,1,1,518,1217,699
33,1,0,5,0,-5
34,1,1,503,1535,1032
35,1,0,12,0,-12
36,1,1,783,1695,912
37,1,1,260,1217,957
38,0,0,33,0,-33
39,1,1,1107,1264,157
40,1,0,29,0,-29
41,1,1,1997,2729,732
42,0,0,14,0,-14
43,0,0,7,0,-7
44,1,1,361,1490,1129
45,0,0,110,0,-110
46,0,0,2,0,-2
47,1,1,617,1675,1058
48,1,1,61,1320,1259
49,1,1,530,1494,964
50,1,1,228,1456,1228
51,1,0,80,0,-80
52,1,0,81,0,-81
53,0,0,70,0,-70
54,1,1,45,1233,1188
55,1,1,566,3190,2624
56,1,0,65,0,-65
57,0,0,5,0,-5
58,0,0,96,0,-96
59,0,0,24,0,-24
60,0,0,51,0,-51
61,1,0,8,0,-8
62,0,0,6,0,-6
63,1,0,61,0,-61
64,1,1,719,1318,599
65,0,0,5,0,-5
66,1,1,80,1481,1401
67,1,1,195,1693,1498
68,0,0,25,0,-25
69,0,0,113,0,-113
70,0,0,127,0,-127
71,1,1,676,1402,726
72,1,0,68,0,-68
73,0,0,6,0,-6
74,0,0,90,0,-90
75,0,0,15,0,-15
76,1,0,18,0,-18
77,0,0,33,0,-33
78,1,1,683,1411,728
79,1,1,722,1269,547
80,1,1,355,1935,1580
81,1,0,46,0,-46
82,1,1,760,1441,681
83,0,0,0,0,0
84,1,0,3,0,-3
85,0,0,20,0,-20
86,1,1,250,1892,1642
87,0,0,146,0,-146
88,1,0,98,0,-98
89,1,1,238,1288,1050
90,0,0,8,0,-8
91,1,0,33,0,-33
92,1,1,278,1263,985
93,1,0,20,0,-20
94,1,1,83,1480,1397
95,1,0,9,0,-9
96,1,0,23,0,-23
97,0,0,62,0,-62
98,1,0,45,0,-45
99,1,1,664,1507,843
100,0,0,9,0,-9
101,0,0,40,0,-40
102,0,0,5,0,-5
103,0,0,1,0,-1
104,0,0,40,0,-40
105,1,1,759,1214,455
106,1,0,12,0,-12
107,1,0,8,0,-8
108,1,1,1128,1241,113
109,0,0,35,0,-35
110,1,0,19,0,-19
111,1,0,51,0,-51
112,0,0,10,0,-10
113,1,1,236,1270,1034
114,1,1,936,2499,1563
115,0,0,4,0,-4
116,1,0,5,0,-5
117,1,0,40,0,-40
118,0,0,135,0,-135
119,0,0,210,0,-210
120,0,0,28,0,-28
121,0,0,5,0,-5
122,1,1,15,1522,1507
123,0,0,9,0,-9
124,0,0,79,0,-79
125,1,1,601,1200,599
126,1,1,618,1665,1047
127,1,1,1241,1305,64
128,1,0,59,0,-59
129,1,0,25,0,-25
130,1,0,11,0,-11
131,1,1,714,1376,662
132,0,0,94,0,-94
133,0,0,61,0,-61
134,0,0,1,0,-1
135,0,0,90,0,-90
136,1,0,34,0,-34
137,1,1,114,1852,1738
138,1,0,4,0,-4
139,1,1,450,1795,1345
140,0,0,5,0,-5
141,1,0,24,0,-24
142,1,0,155,0,-155
143,1,0,39,0,-39
144,1,0,96,0,-96
145,1,0,19,0,-19
146,1,0,7,0,-7
147,1,0,66,0,-66
148,1,0,87,0,-87
149,1,1,1808,1284,-524
150,0,0,61,0,-61
151,1,1,1208,1203,-5
152,1,1,48,2396,2348
153,1,1,652,1522,870
154,1,0,4,0,-4
155,0,0,71,0,-71
156,1,0,12,0,-12
157,1,0,0,0,0
158,1,1,85,1859,1774
159,1,0,22,0,-22
160,1,1,2137,1304,-833
161,1,0,103,0,-103
162,1,1,327,3052,2725
163,1,1,187,1841,1654
164,0,0,1,0,-1
165,1,1,1284,2334,1050
166,0,0,65,0,-65
167,0,0,3,0,-3
168,1,0,14,0,-14
169,0,0,41,0,-41
170,1,0,25,0,-25
171,1,1,118,1450,1332
172,0,0,78,0,-78
173,0,0,1,0,-1
174,0,0,19,0,-19
175,0,0,17,0,-17
176,1,0,30,0,-30
177,1,1,74,1743,1669
178,0,0,0,0,0
179,1,1,166,1245,1079
180,1,1,1043,1203,160
181,1,0,31,0,-31
182,0,0,73,0,-73
183,0,0,44,0,-44
184,0,0,27,0,-27
185,0,0,29,0,-29
186,0,0,54,0,-54
187,0,0,29,0,-29
188,1,0,71,0,-71
189,0,0,84,0,-84
190,1,0,32,0,-32
191,0,0,33,0,-33
192,1,1,281,1793,1512
193,1,0,0,0,0
194,1,1,1595,1211,-384
195,0,0,23,0,-23
196,1,1,449,3101,2652
197,1,1,117,1542,1425
198,1,1,1600,1234,-366
199,1,1,913,1523,610
200,0,0,20,0,-20
201,0,0,14,0,-14
202,1,0,117,0,-117
203,1,0,35,0,-35
204,1,1,481,1447,966
205,0,0,43,0,-43
206,1,1,138,1508,1370
207,1,1,1234,1550,316
208,1,0,58,0,-58
209,1,1,489,1384,895
210,1,0,17,0,-17
211,0,0,79,0,-79
212,1,1,995,1449,454
213,1,0,59,0,-59
214,1,1,534,1395,861
215,1,1,395,1523,1128
216,1,1,986,1228,242
217,1,1,235,1965,1730
218,1,1,452,1572,1120
219,0,0,69,0,-69
220,0,0,23,0,-23
221,0,0,19,0,-19
222,0,0,43,0,-43
223,1,0,12,0,-12
224,1,0,29,0,-29
225,1,1,1019,2027,1008
226,1,0,16,0,-16
227,0,0,18,0,-18
228,1,0,2,0,-2
229,1,1,321,1255,934
230,0,0,6,0,-6
231,1,0,75,0,-75
232,1,0,85,0,-85
233,0,0,21,0,-21
234,0,0,34,0,-34
235,0,0,26,0,-26
236,0,0,3,0,-3
237,1,0,2,0,-2
238,0,0,6,0,-6
239,1,0,83,0,-83
240,0,0,19,0,-19
241,1,0,93,0,-93
242,1,0,21,0,-21
243,0,0,6,0,-6
244,1,1,60,1597,1537
245,1,0,44,0,-44
246,1,0,17,0,-17
247,1,0,17,0,-17
248,1,0,0,0,0
249,0,0,62,0,-62
250,0,0,3,0,-3
251,1,1,139,1459,1320
252,1,1,205,1285,1080
253,1,1,9,1502,1493
254,0,0,211,0,-211
255,0,0,59,0,-59
256,1,0,118,0,-118
257,1,0,15,0,-15
258,0,0,49,0,-49
259,0,0,5,0,-5
260,0,0,39,0,-39
261,0,0,10,0,-10
262,1,0,39,0,-39
263,1,1,455,1396,941
264,1,1,564,1528,964
265,0,0,23,0,-23
266,1,0,5,0,-5
267,1,1,410,1539,1129
268,0,0,47,0,-47
269,0,0,175,0,-175
270,1,1,334,1301,967
271,0,0,23,0,-23
272,0,0,44,0,-44
273,0,0,46,0,-46
274,1,0,96,0,-96
275,0,0,0,0,0
276,1,0,25,0,-25
277,0,0,119,0,-119
278,1,0,29,0,-29
279,0,0,21,0,-21
280,0,0,33,0,-33
281,1,0,65,0,-65
282,1,1,47,1670,1623
283,0,0,35,0,-35
284,1,1,972,1853,881
285,0,0,54,0,-54
286,1,0,21,0,-21
287,1,0,45,0,-45
288,1,0,93,0,-93
289,1,0,119,0,-119
290,0,0,29,0,-29
291,0,0,92,0,-92
292,1,0,69,0,-69
293,1,1,460,1302,842
294,1,1,318,1448,1130
295,1,0,71,0,-71
296,0,0,68,0,-68
297,1,0,4,0,-4
298,0,0,101,0,-101
299,1,1,82,1283,1201
300,1,0,21,0,-21
301,0,0,1,0,-1
302,1,1,229,1262,1033
303,0,0,8,0,-8
304,1,1,2181,1522,-659
305,1,0,55,0,-55
306,1,1,2712,1578,-1134
307,1,0,120,0,-120
308,0,0,16,0,-16
309,1,0,126,0,-126
310,0,0,8,0,-8
311,1,0,7,0,-7
312,0,0,32,0,-32
313,1,1,2253,1781,-472
314,0,0,23,0,-23
315,0,0,9,0,-9
316,1,0,190,0,-190
317,0,0,14,0,-14
318,0,0,79,0,-79
319,1,0,41,0,-41
320,1,0,8,0,-8
321,1,1,379,1249,870
322,1,0,24,0,-24
323,0,0,126,0,-126
324,1,1,373,2857,2484
325,0,0,75,0,-75
326,1,1,112,1272,1160
327,1,0,118,0,-118
328,1,1,209,1920,1711
329,1,0,8,0,-8
330,0,0,15,0,-15
331,0,0,39,0,-39
332,1,0,69,0,-69
333,0,0,2,0,-2
334,1,1,200,2931,2731
335,0,0,2,0,-2
336,1,0,1,0,-1
337,1,1,452,1317,865
338,1,0,122,0,-122
339,1,1,115,1408,1293
340,0,0,25,0,-25
341,1,1,354,1426,1072
342,1,0,21,0,-21
343,1,1,848,1318,470
344,1,0,142,0,-142
345,0,0,21,0,-21
346,1,1,587,1286,699
347,1,0,69,0,-69
348,0,0,31,0,-31
349,1,1,334,1383,1049
350,0,0,17,0,-17
351,0,0,71,0,-71
352,0,0,67,0,-67
353,0,0,184,0,-184
354,1,1,399,1315,916
355,1,1,91,1411,1320
356,1,1,809,1576,767
357,1,1,204,1364,1160
358,0,0,110,0,-110
359,1,1,347,1284,937
360,0,0,34,0,-34
361,0,0,19,0,-19
362,0,0,42,0,-42
363,1,1,125,1485,1360
364,1,0,34,0,-34
365,1,1,619,1770,1151
366,1,0,43,0,-43
367,1,0,71,0,-71
368,0,0,28,0,-28
369,1,1,273,1529,1256
370,0,0,5,0,-5
371,0,0,3,0,-3
372,1,1,471,1242,771
373,0,0,167,0,-167
374,0,0,7,0,-7
375,1,0,33,0,-33
376,1,1,49,1473,1424
377,0,0,63,0,-63
378,1,1,149,1848,1699
379,1,1,376,1230,854
380,1,0,0,0,0
381,1,1,625,1352,727
382,0,0,15,0,-15
383,1,1,525,1495,970
384,1,1,43,1264,1221
385,1,0,14,0,-14
386,1,0,74,0,-74
387,1,0,1,0,-1
388,1,1,131,1355,1224
389,1,0,141,0,-141
390,0,0,17,0,-17
391,0,0,33,0,-33
392,1,0,14,0,-14
393,0,0,5,0,-5
394,0,0,35,0,-35
395,1,0,65,0,-65
396,0,0,46,0,-46
397,1,0,26,0,-26
398,1,1,284,1666,1382
399,0,0,59,0,-59
400,1,0,13,0,-13
401,1,1,274,1213,939
402,0,0,5,0,-5
403,1,0,62,0,-62
404,0,0,55,0,-55
405,1,0,39,0,-39
406,0,0,183,0,-183
407,1,0,114,0,-114
408,1,1,1675,1645,-30
409,1,0,23,0,-23
410,0,0,27,0,-27
411,1,1,1091,1326,235
412,1,0,1,0,-1
413,1,1,302,1408,1106
414,1,1,354,1548,1194
415,0,0,142,0,-142
416,0,0,23,0,-23
417,0,0,78,0,-78
418,0,0,19,0,-19
419,0,0,47,0,-47
420,1,0,79,0,-79
421,0,0,103,0,-103
422,1,0,9,0,-9
423,1,1,589,1202,613
424,0,0,50,0,-50
425,0,0,26,0,-26
426,1,0,4,0,-4
427,1,1,491,1216,725
428,1,0,94,0,-94
429,1,0,3,0,-3
430,1,0,59,0,-59
431,1,1,271,1320,1049
432,1,0,131,0,-131
433,1,1,338,1568,1230
434,0,0,107,0,-107
435,1,1,177,2321,2144
436,1,1,834,1316,482
437,1,0,13,0,-13
438,1,1,121,1562,1441
439,1,0,2,0,-2
440,1,0,15,0,-15
441,0,0,17,0,-17
442,1,1,491,1538,1047
443,1,1,289,4555,4266
444,0,0,29,0,-29
445,1,0,32,0,-32
446,1,0,8,0,-8
447,1,1,890,1302,412
448,0,0,1,0,-1
449,1,0,103,0,-103
450,1,0,58,0,-58
451,1,0,10,0,-10
452,1,1,189,1789,1600
453,0,0,89,0,-89
454,1,0,4,0,-4
455,0,0,21,0,-21
456,1,1,1569,2579,1010
457,0,0,146,0,-146
458,0,0,100,0,-100
459,1,0,13,0,-13
460,0,0,31,0,-31
461,1,0,138,0,-138
462,1,1,300,1388,1088
463,0,0,25,0,-25
464,0,0,103,0,-103
465,1,0,87,0,-87
466,1,1,33,1422,1389
467,0,0,21,0,-21
468,0,0,42,0,-42
469,1,0,13,0,-13
470,0,0,52,0,-52
471,1,0,43,0,-43
472,0,0,63,0,-63
473,0,0,123,0,-123
474,1,1,377,1234,857
475,1,0,47,0,-47
476,1,0,38,0,-38
477,1,1,557,1219,662
478,0,0,20,0,-20
479,0,0,19,0,-19
480,1,0,77,0,-77
481,0,0,36,0,-36
482,1,0,11,0,-11
483,1,0,43,0,-43
484,1,1,196,3474,3278
485,0,0,78,0,-78
486,1,0,29,0,-29
487,1,0,18,0,-18
488,1,1,283,2214,1931
489,1,0,14,0,-14
490,1,0,88,0,-88
491,0,0,0,0,0
492,0,0,49,0,-49
493,1,1,309,1591,1282
494,0,0,102,0,-102
495,1,0,121,0,-121
496,1,0,20,0,-20
497,0,0,21,0,-21
498,0,0,187,0,-187
499,0,0,10,0,-10
500,0,0,11,0,-11
501,1,1,33,3054,3021
502,0,0,7,0,-7
503,1,1,265,1253,988
504,0,0,11,0,-11
505,1,1,991,1207,216
506,1,1,356,1250,894
507,0,0,118,0,-118
508,1,1,597,1540,943
509,0,0,79,0,-79
510,1,0,89,0,-89
511,1,1,812,1442,630
512,1,1,134,1756,1622
513,0,0,56,0,-56
514,1,1,95,1212,1117
515,1,1,95,2093,1998
516,1,0,55,0,-55
517,1,0,9,0,-9
518,0,0,82,0,-82
519,0,0,22,0,-22
520,1,0,70,0,-70
521,1,0,47,0,-47
522,0,0,10,0,-10
523,0,0,7,0,-7
524,1,1,365,1271,906
525,0,0,12,0,-12
526,1,1,79,1311,1232
527,1,0,76,0,-76
528,1,1,133,2277,2144
529,1,0,22,0,-22
530,0,0,19,0,-19
531,1,1,368,2304,1936
532,1,1,522,1394,872
533,1,0,28,0,-28
534,0,0,96,0,-96
535,0,0,28,0,-28
536,1,0,52,0,-52
537,0,0,38,0,-38
538,1,1,59,1367,1308
539,0,0,74,0,-74
540,0,0,11,0,-11
541,1,0,16,0,-16
542,1,1,2428,1667,-761
543,1,0,105,0,-105
544,0,0,2,0,-2
545,1,1,658,1614,956
546,1,1,72,1217,1145
547,0,0,4,0,-4
548,0,0,55,0,-55
549,1,1,65,1483,1418
550,0,0,92,0,-92
551,1,0,16,0,-16
552,1,1,773,1326,553
553,0,0,0,0,0
554,0,0,54,0,-54
555,0,0,28,0,-28
556,0,0,49,0,-49
557,1,0,19,0,-19
558,0,0,21,0,-21
559,1,0,9,0,-9
560,1,1,310,1253,943
561,1,0,28,0,-28
562,0,0,42,0,-42
563,1,0,17,0,-17
564,0,0,66,0,-66
565,1,0,24,0,-24
566,0,0,150,0,-150
567,1,1,423,1305,882
568,1,1,117,1519,1402
569,1,1,1129,1231,102
570,1,0,2,0,-2
571,0,0,53,0,-53
572,1,1,1022,1620,598
573,1,1,937,1594,657
574,0,0,37,0,-37
575,1,0,62,0,-62
576,1,1,1154,1706,552
577,0,0,13,0,-13
578,1,1,107,1206,1099
579,0,0,158,0,-158
580,1,0,25,0,-25
581,1,1,988,1474,486
582,1,0,5,0,-5
583,0,0,31,0,-31
584,1,1,59,1324,1265
585,1,0,34,0,-34
586,1,0,18,0,-18
587,1,1,2347,1518,-829
588,0,0,0,0,0
589,1,0,52,0,-52
590,1,0,51,0,-51
591,1,0,11,0,-11
592,1,1,111,2573,2462
593,0,0,73,0,-73
594,0,0,48,0,-48
595,1,1,300,1494,1194
596,1,0,34,0,-34
597,0,0,0,0,0
598,0,0,9,0,-9
599,0,0,18,0,-18
600,1,1,366,1823,1457
601,1,0,96,0,-96
602,0,0,13,0,-13
603,0,0,5,0,-5
604,1,1,127,1578,1451
605,0,0,255,0,-255
606,1,0,187,0,-187
607,0,0,53,0,-53
608,0,0,141,0,-141
609,1,1,31,2094,2063
610,0,0,18,0,-18
611,1,1,54,6467,6413
612,0,0,7,0,-7
613,0,0,11,0,-11
614,1,1,1059,1852,793
615,0,0,18,0,-18
616,0,0,244,0,-244
617,0,0,28,0,-28
618,1,0,0,0,0
619,1,0,24,0,-24
620,1,0,34,0,-34
621,0,0,147,0,-147
622,1,0,62,0,-62
623,1,0,42,0,-42
624,1,1,414,1483,1069
625,0,0,8,0,-8
626,1,0,87,0,-87
627,0,0,6,0,-6
628,1,1,88,1386,1298
629,1,0,76,0,-76
630,1,1,80,2519,2439
631,1,1,930,1640,710
632,1,1,1228,1361,133
633,0,0,56,0,-56
634,1,0,17,0,-17
635,0,0,71,0,-71
636,1,1,529,1721,1192
637,1,1,142,1334,1192
638,1,0,9,0,-9
639,0,0,21,0,-21
640,1,1,1317,1693,376
641,0,0,72,0,-72
642,1,0,11,0,-11
643,1,1,326,1501,1175
644,1,0,9,0,-9
645,1,0,22,0,-22
646,1,1,668,2548,1880
647,1,0,66,0,-66
648,1,1,131,1738,1607
649,0,0,81,0,-81
650,1,0,10,0,-10
651,1,0,59,0,-59
652,1,0,32,0,-32
653,1,1,1500,1332,-168
654,1,0,109,0,-109
655,1,0,44,0,-44
656,1,1,340,1558,1218
657,0,0,100,0,-100
658,1,1,576,1292,716
659,0,0,0,0,0
660,1,0,62,0,-62
661,1,1,140,1228,1088
662,1,0,48,0,-48
663,0,0,15,0,-15
664,0,0,0,0,0
665,0,0,139,0,-139
666,1,1,484,1208,724
667,1,1,153,3630,3477
668,1,1,827,1751,924
669,1,0,47,0,-47
670,1,0,68,0,-68
671,0,0,276,0,-276
672,1,0,21,0,-21
673,0,0,6,0,-6
674,0,0,3,0,-3
675,1,1,289,1483,1194
676,0,0,14,0,-14
677,0,0,17,0,-17
678,1,0,14,0,-14
679,0,0,106,0,-106
680,1,0,7,0,-7
681,1,1,353,1499,1146
682,1,0,6,0,-6
683,0,0,102,0,-102
684,0,0,48,0,-48
685,0,0,64,0,-64
686,0,0,31,0,-31
687,0,0,69,0,-69
688,0,0,20,0,-20
689,1,1,365,1509,1144
690,1,0,28,0,-28
691,0,0,15,0,-15
692,1,1,132,1592,1460
693,1,0,67,0,-67
694,1,1,453,1489,1036
695,1,1,565,1275,710
696,0,0,44,0,-44
697,1,0,23,0,-23
698,0,0,58,0,-58
699,1,0,23,0,-23
700,0,0,52,0,-52
701,0,0,155,0,-155
702,0,0,31,0,-31
703,0,0,5,0,-5
704,0,0,63,0,-63
705,0,0,6,0,-6
706,0,0,7,0,-7
707,0,0,21,0,-21
708,1,0,22,0,-22
709,0,0,35,0,-35
710,0,0,64,0,-64
711,0,0,14,0,-14
712,0,0,87,0,-87
713,1,1,436,1442,1006
714,0,0,30,0,-30
715,0,0,71,0,-71
716,0,0,22,0,-22
717,1,1,432,2293,1861
718,0,0,49,0,-49
719,1,0,68,0,-68
720,1,0,38,0,-38
721,1,0,40,0,-40
722,0,0,60,0,-60
723,0,0,36,0,-36
724,0,0,60,0,-60
725,1,1,350,1208,858
726,1,0,8,0,-8
727,1,0,102,0,-102
728,0,0,26,0,-26
729,1,0,61,0,-61
730,0,0,46,0,-46
731,0,0,21,0,-21
732,1,0,61,0,-61
733,0,0,1,0,-1
734,1,0,11,0,-11
735,0,0,33,0,-33
736,1,1,590,1773,1183
737,0,0,5,0,-5
738,0,0,95,0,-95
739,1,1,833,3164,2331
740,1,0,149,0,-149
741,1,0,21,0,-21
742,0,0,64,0,-64
743,1,1,237,1671,1434
744,1,1,2064,1509,-555
745,1,1,490,1210,720
746,1,0,28,0,-28
747,1,0,54,0,-54
748,0,0,43,0,-43
749,1,1,600,1415,815
750,0,0,9,0,-9
751,1,1,446,1320,874
752,0,0,26,0,-26
753,1,0,14,0,-14
754,1,0,14,0,-14
755,0,0,23,0,-23
756,0,0,40,0,-40
757,1,0,13,0,-13
758,0,0,15,0,-15
759,1,1,194,2024,1830
760,1,1,17,1217,1200
761,1,1,142,1212,1070
762,0,0,189,0,-189
763,1,0,7,0,-7
764,1,1,112,1228,1116
765,1,0,1,0,-1
766,1,0,56,0,-56
767,0,0,15,0,-15
768,1,1,1006,2013,1007
769,1,0,98,0,-98
770,0,0,17,0,-17
771,0,0,2,0,-2
772,1,1,733,1294,561
773,0,0,1,0,-1
774,1,0,32,0,-32
775,1,1,910,1436,526
776,1,0,65,0,-65
777,0,0,8,0,-8
778,1,0,20,0,-20
779,0,0,31,0,-31
780,1,1,475,1652,1177
781,1,1,698,1870,1172
782,1,1,291,1544,1253
783,1,1,801,1449,648
784,1,0,15,0,-15
785,1,1,43,1517,1474
786,1,1,642,1294,652
787,1,1,1487,1903,416
788,1,1,272,1518,1246
789,1,1,22,1582,1560
790,1,1,75,1442,1367
791,0,0,42,0,-42
792,1,1,565,1346,781
793,0,0,179,0,-179
794,1,1,452,1359,907
795,0,0,30,0,-30
796,1,1,5556,1676,-3880
797,1,0,5,0,-5
798,1,1,14,2221,2207
799,1,1,401,2023,1622
800,0,0,62,0,-62
801,0,0,62,0,-62
802,1,1,678,1200,522
803,0,0,42,0,-42
804,1,0,89,0,-89
805,0,0,16,0,-16
806,0,0,13,0,-13
807,1,1,213,1262,1049
808,1,1,264,1595,1331
809,1,0,34,0,-34
810,1,0,57,0,-57
811,1,0,51,0,-51
812,1,0,2,0,-2
813,0,0,21,0,-21
814,0,0,34,0,-34
815,1,0,64,0,-64
816,0,0,91,0,-91
817,1,0,232,0,-232
818,1,0,91,0,-91
819,1,1,349,1322,973
820,1,1,1286,1206,-80
821,0,0,30,0,-30
822,0,0,74,0,-74
823,1,1,890,1401,511
824,1,1,221,1289,1068
825,0,0,118,0,-118
826,1,0,31,0,-31
827,1,0,207,0,-207
828,0,0,37,0,-37
829,0,0,320,0,-320
830,0,0,77,0,-77
831,0,0,2,0,-2
832,1,1,2657,1262,-1395
833,0,0,3,0,-3
834,0,0,11,0,-11
835,1,1,83,1270,1187
836,1,1,270,1328,1058
837,0,0,61,0,-61
838,0,0,91,0,-91
839,1,0,16,0,-16
840,0,0,9,0,-9
841,1,0,13,0,-13
842,1,1,1026,1535,509
843,1,0,11,0,-11
844,0,0,75,0,-75
845,1,0,35,0,-35
846,1,1,473,1660,1187
847,1,1,1969,1241,-728
848,0,0,63,0,-63
849,1,0,143,0,-143
850,1,1,560,1340,780
851,0,0,112,0,-112
852,1,0,25,0,-25
853,1,1,1053,1667,614
854,1,1,641,1306,665
855,0,0,295,0,-295
856,1,0,74,0,-74
857,1,0,168,0,-168
858,1,1,366,1212,846
859,1,0,58,0,-58
860,0,0,35,0,-35
861,1,1,119,1494,1375
862,0,0,20,0,-20
863,1,1,445,1313,868
864,1,0,39,0,-39
865,1,1,1924,1320,-604
866,0,0,4,0,-4
867,1,0,78,0,-78
868,0,0,1,0,-1
869,0,0,53,0,-53
870,1,0,0,0,0
871,1,1,319,1220,901
872,0,0,5,0,-5
873,1,1,1918,1262,-656
874,1,1,1125,1317,192
875,1,1,355,1267,912
876,1,0,16,0,-16
877,1,1,846,1423,577
878,1,0,9,0,-9
879,0,0,109,0,-109
880,1,1,806,1333,527
881,1,1,241,2422,2181
882,0,0,15,0,-15
883,1,1,97,1219,1122
884,0,0,19,0,-19
885,1,1,2186,1309,-877
886,0,0,26,0,-26
887,1,0,6,0,-6
888,1,0,10,0,-10
889,1,0,4,0,-4
890,1,0,8,0,-8
891,0,0,87,0,-87
892,1,0,2,0,-2
893,0,0,4,0,-4
894,0,0,151,0,-151
895,1,1,381,3217,2836
896,0,0,48,0,-48
897,1,1,1449,1441,-8
898,0,0,118,0,-118
899,0,0,34,0,-34
900,1,1,368,1256,888
901,0,0,12,0,-12
902,1,1,933,3869,2936
903,0,0,14,0,-14
904,1,0,8,0,-8
905,1,1,637,1558,921
906,0,0,90,0,-90
907,1,1,365,1262,897
908,1,0,38,0,-38
909,0,0,159,0,-159
910,1,1,610,1253,643
911,1,1,131,1644,1513
912,1,1,915,1209,294
913,0,0,20,0,-20
914,0,0,2,0,-2
915,1,0,53,0,-53
916,1,1,686,1642,956
917,0,0,44,0,-44
918,1,1,411,2676,2265
919,1,1,260,1255,995
920,1,1,1044,1278,234
921,1,1,293,1409,1116
922,1,0,5,0,-5
923,1,0,93,0,-93
924,1,1,617,1282,665
925,1,1,1071,1644,573
926,1,0,26,0,-26
927,1,0,7,0,-7
928,1,1,175,1507,1332
929,1,1,168,1346,1178
930,0,0,61,0,-61
931,0,0,4,0,-4
932,0,0,78,0,-78
933,1,1,349,1621,1272
934,1,0,70,0,-70
935,0,0,35,0,-35
936,1,0,3,0,-3
937,0,0,139,0,-139
938,0,0,45,0,-45
939,1,0,132,0,-132
940,1,0,11,0,-11
941,0,0,80,0,-80
942,1,1,1007,1685,678
943,1,1,1000,1591,591
944,1,0,34,0,-34
945,0,0,2,0,-2
946,0,0,108,0,-108
947,0,0,28,0,-28
948,0,0,11,0,-11
949,1,1,1308,4260,2952
950,0,0,82,0,-82
951,1,1,716,2567,1851
952,1,0,35,0,-35
953,1,1,136,1249,1113
954,1,1,379,2298,1919
955,1,1,284,1415,1131
956,1,0,1,0,-1
957,0,0,73,0,-73
958,0,0,18,0,-18
959,0,0,106,0,-106
960,1,0,3,0,-3
961,1,0,1,0,-1
962,1,1,62,1585,1523
963,1,0,52,0,-52
964,1,1,1405,1211,-194
965,0,0,50,0,-50
966,0,0,24,0,-24
967,1,0,49,0,-49
968,1,0,14,0,-14
969,1,0,26,0,-26
970,1,1,871,1995,1124
971,0,0,18,0,-18
972,0,0,16,0,-16
973,0,0,22,0,-22
974,1,0,1,0,-1
975,0,0,32,0,-32
976,1,0,210,0,-210
977,1,1,91,2437,2346
978,0,0,47,0,-47
979,1,0,78,0,-78
980,0,0,10,0,-10
981,1,0,55,0,-55
982,1,0,28,0,-28
983,0,0,124,0,-124
984,0,0,2,0,-2
985,1,1,983,1486,503
986,1,0,91,0,-91
987,1,1,250,1248,998
988,1,1,214,1719,1505
989,1,0,17,0,-17
990,0,0,2,0,-2
991,1,1,355,1355,1000
992,1,0,10,0,-10
993,1,1,46,1751,1705
994,0,0,20,0,-20
995,0,0,2,0,-2
996,0,0,112,0,-112
997,0,0,13,0,-13
998,1,0,161,0,-161
999,1,1,280,4000,3720
1000,1,0,42,0,-42
1001,0,0,67,0,-67
1002,1,1,247,1712,1465
1003,1,0,9,0,-9
1004,0,0,158,0,-158
1005,0,0,27,0,-27
1006,0,0,48,0,-48
1007,0,0,7,0,-7
1008,0,0,91,0,-91
1009,1,1,151,1869,1718
1010,1,1,1001,1354,353
1011,1,0,7,0,-7
1012,0,0,2,0,-2
1013,0,0,14,0,-14
1014,1,0,104,0,-104
1015,0,0,271,0,-271
1016,1,0,31,0,-31
1017,0,0,125,0,-125
1018,1,0,14,0,-14
1019,1,0,7,0,-7
1020,1,1,277,1349,1072
1021,0,0,8,0,-8
1022,1,0,6,0,-6
1023,1,1,698,2688,1990
1024,1,1,433,1408,975
1025,0,0,13,0,-13
1026,0,0,27,0,-27
1027,0,0,44,0,-44
1028,0,0,83,0,-83
1029,1,0,103,0,-103
1030,1,1,164,1255,1091
1031,1,1,604,1313,709
1032,0,0,19,0,-19
1033,1,1,835,1482,647
1034,1,1,505,1228,723
1035,1,1,1518,1207,-311
1036,0,0,14,0,-14
1037,1,0,3,0,-3
1038,1,0,3,0,-3
1039,1,1,648,1603,955
1040,1,0,31,0,-31
1041,0,0,26,0,-26
1042,1,0,23,0,-23
1043,1,1,226,1490,1264
1044,0,0,25,0,-25
1045,0,0,21,0,-21
1046,1,1,529,1511,982
1047,1,1,299,2238,1939
1048,1,0,43,0,-43
1049,0,0,46,0,-46
1050,0,0,24,0,-24
1051,1,1,533,1861,1328
1052,1,1,1216,1682,466
1053,0,0,47,0,-47
1054,0,0,30,0,-30
1055,0,0,4,0,-4
1056,1,1,1072,1306,234
1057,1,0,36,0,-36
1058,0,0,4,0,-4
1059,0,0,63,0,-63
1060,0,0,92,0,-92
1061,1,0,25,0,-25
1062,1,1,104,1319,1215
1063,1,0,72,0,-72
1064,1,0,37,0,-37
1065,1,0,15,0,-15
1066,1,0,42,0,-42
1067,1,0,21,0,-21
1068,1,1,83,3428,3345
1069,0,0,25,0,-25
1070,0,0,28,0,-28
1071,0,0,5,0,-5
1072,0,0,24,0,-24
1073,1,0,12,0,-12
1074,1,0,69,0,-69
1075,0,0,98,0,-98
1076,1,1,650,1867,1217
1077,1,1,442,1251,809
1078,0,0,17,0,-17
1079,1,1,120,1515,1395
1080,0,0,94,0,-94
1081,1,1,860,1214,354
1082,1,0,2,0,-2
1083,1,1,381,1634,1253
1084,0,0,118,0,-118
1085,1,0,26,0,-26
1086,0,0,26,0,-26
1087,1,0,81,0,-81
1088,1,1,228,1278,1050
1089,1,1,670,1204,534
1090,1,1,393,1503,1110
1091,1,0,19,0,-19
1092,1,0,26,0,-26
1093,1,1,576,1537,961
1094,0,0,19,0,-19
1095,0,0,19,0,-19
1096,1,1,205,1751,1546
1097,1,1,138,1204,1066
1098,1,1,401,1619,1218
1099,0,0,6,0,-6
1100,1,1,163,1499,1336
1101,0,0,55,0,-55
1102,0,0,28,0,-28
1103,0,0,5,0,-5
1104,0,0,51,0,-51
1105,1,0,40,0,-40
1106,1,0,0,0,0
1107,0,0,20,0,-20
1108,1,1,117,1227,1110
1109,1,1,249,1312,1063
1110,1,1,601,1213,612
1111,1,1,741,1558,817
1112,1,1,205,1312,1107
1113,0,0,7,0,-7
1114,1,0,50,0,-50
1115,1,0,18,0,-18
1116,1,0,22,0,-22
1117,1,1,1182,1259,77
1118,1,0,8,0,-8
1119,0,0,27,0,-27
1120,1,1,683,1661,978
1121,1,1,515,1285,770
1122,0,0,9,0,-9
1123,0,0,46,0,-46
1124,1,1,202,1685,1483
1125,1,1,298,1311,1013
1126,0,0,0,0,0
1127,1,1,330,1269,939
1128,0,0,58,0,-58
1129,0,0,27,0,-27
1130,1,1,576,1229,653
1131,1,0,24,0,-24
1132,0,0,89,0,-89
1133,1,1,68,1342,1274
1134,0,0,146,0,-146
1135,1,0,4,0,-4
1136,1,0,150,0,-150
1137,1,0,24,0,-24
1138,0,0,6,0,-6
1139,0,0,2,0,-2
1140,1,0,75,0,-75
1141,1,1,187,1233,1046
1142,0,0,17,0,-17
1143,0,0,107,0,-107
1144,1,1,945,1268,323
1145,0,0,20,0,-20
1146,0,0,29,0,-29
1147,1,1,702,1314,612
1148,0,0,33,0,-33
1149,0,0,39,0,-39
1150,1,1,769,1202,433
1151,0,0,39,0,-39
1152,1,1,695,2323,1628
1153,1,1,678,1724,1046
1154,1,1,152,1366,1214
1155,1,1,1946,2648,702
1156,0,0,7,0,-7
1157,1,1,407,1260,853
1158,0,0,34,0,-34
1159,1,1,420,1868,1448
1160,1,1,1049,1435,386
1161,1,1,113,1425,1312
1162,0,0,98,0,-98
1163,0,0,9,0,-9
1164,1,1,808,2499,1691
1165,1,0,23,0,-23
1166,1,0,110,0,-110
1167,1,1,139,1382,1243
1168,1,1,754,1414,660
1169,1,1,270,1502,1232
1170,1,0,6,0,-6
1171,1,1,656,1480,824
1172,0,0,0,0,0
1173,0,0,31,0,-31
1174,1,1,787,1254,467
1175,1,1,331,2672,2341
1176,1,1,313,3772,3459
1177,0,0,51,0,-51
1178,1,0,27,0,-27
1179,1,1,357,1872,1515
1180,0,0,21,0,-21
1181,1,0,63,0,-63
1182,0,0,9,0,-9
1183,0,0,2,0,-2
1184,0,0,37,0,-37
1185,1,1,390,1932,1542
1186,0,0,94,0,-94
1187,1,1,291,1201,910
1188,1,1,507,1950,1443
1189,1,1,452,2468,2016
1190,0,0,51,0,-51
1191,1,1,217,1395,1178
1192,0,0,43,0,-43
1193,1,1,1294,1244,-50
1194,1,0,0,0,0
1195,1,0,55,0,-55
1196,0,0,87,0,-87
1197,1,1,1435,1417,-18
1198,0,0,55,0,-55
1199,0,0,88,0,-88
1200,1,0,18,0,-18
1201,1,0,37,0,-37
1202,1,0,26,0,-26
1203,0,0,33,0,-33
1204,0,0,51,0,-51
1205,0,0,161,0,-161
1206,1,0,38,0,-38
1207,0,0,5,0,-5
1208,0,0,44,0,-44
1209,0,0,56,0,-56
1210,1,1,976,1549,573
1211,0,0,12,0,-12
1212,0,0,84,0,-84
1213,0,0,16,0,-16
1214,1,1,212,1763,1551
1215,0,0,40,0,-40
1216,0,0,15,0,-15
1217,1,1,232,1249,1017
1218,1,1,560,1249,689
1219,1,0,24,0,-24
1220,0,0,23,0,-23
1221,1,0,29,0,-29
1222,1,1,465,1386,921
1223,1,0,12,0,-12
1224,1,0,27,0,-27
1225,0,0,30,0,-30
1226,0,0,307,0,-307
1227,0,0,106,0,-106
1228,0,0,56,0,-56
1229,1,1,116,1823,1707
1230,1,0,4,0,-4
1231,0,0,0,0,0
1232,1,1,1212,1438,226
1233,0,0,2,0,-2
1234,0,0,67,0,-67
1235,0,0,11,0,-11
1236,1,1,579,1212,633
1237,1,1,1073,1303,230
1238,0,0,119,0,-119
1239,0,0,138,0,-138
1240,1,0,58,0,-58
1241,1,0,244,0,-244
1242,1,0,61,0,-61
1243,1,1,217,4652,4435
1244,0,0,13,0,-13
1245,1,1,916,1344,428
1246,0,0,21,0,-21
1247,1,1,1331,1269,-62
1248,0,0,86,0,-86
1249,1,0,9,0,-9
1250,0,0,46,0,-46
1251,0,0,45,0,-45
1252,1,1,1785,1433,-352
1253,0,0,19,0,-19
1254,0,0,24,0,-24
1255,1,0,106,0,-106
1256,1,1,449,1810,1361
1257,1,0,146,0,-146
1258,1,0,10,0,-10
1259,0,0,177,0,-177
1260,1,0,8,0,-8
1261,0,0,102,0,-102
1262,0,0,8,0,-8
1263,1,1,552,2646,2094
1264,0,0,31,0,-31
1265,1,1,396,1334,938
1266,1,0,162,0,-162
1267,1,1,75,1472,1397
1268,0,0,24,0,-24
1269,0,0,22,0,-22
1270,0,0,53,0,-53
1271,0,0,3,0,-3
1272,1,0,5,0,-5
1273,1,1,433,2000,1567
1274,0,0,169,0,-169
1275,1,1,66,1245,1179
1276,1,1,160,1439,1279
1277,0,0,4,0,-4
1278,1,0,93,0,-93
1279,1,1,170,1526,1356
1280,1,1,169,1571,1402
1281,1,0,55,0,-55
1282,1,0,68,0,-68
1283,0,0,2,0,-2
1284,0,0,21,0,-21
1285,1,0,15,0,-15
1286,0,0,57,0,-57
1287,1,0,53,0,-53
1288,1,1,1294,1621,327
1289,0,0,32,0,-32
1290,1,0,2,0,-2
1291,1,1,874,1569,695
1292,0,0,30,0,-30
1293,0,0,60,0,-60
1294,0,0,0,0,0
1295,0,0,140,0,-140
1296,1,1,129,1899,1770
1297,0,0,42,0,-42
1298,1,0,40,0,-40
1299,1,1,296,1278,982
1300,1,0,44,0,-44
1301,1,0,93,0,-93
1302,1,1,214,1345,1131
1303,0,0,64,0,-64
1304,1,1,346,1560,1214
1305,0,0,26,0,-26
1306,1,0,1,0,-1
1307,1,1,1520,1321,-199
1308,0,0,166,0,-166
1309,1,1,901,1427,526
1310,0,0,156,0,-156
1311,0,0,8,0,-8
1312,1,0,20,0,-20
1313,0,0,122,0,-122
1314,1,0,71,0,-71
1315,1,0,8,0,-8
1316,1,1,34,1622,1588
1317,1,1,551,1376,825
1318,1,0,13,0,-13
1319,1,0,24,0,-24
1320,0,0,97,0,-97
1321,0,0,95,0,-95
1322,0,0,41,0,-41
1323,1,0,64,0,-64
1324,0,0,68,0,-68
1325,1,1,1136,1432,296
1326,1,1,140,1318,1178
1327,1,0,1,0,-1
1328,0,0,136,0,-136
1329,1,1,389,1382,993
1330,1,1,681,2629,1948
1331,1,0,49,0,-49
1332,1,0,13,0,-13
1333,1,0,9,0,-9
1334,1,1,640,1465,825
1335,0,0,14,0,-14
1336,1,0,32,0,-32
1337,0,0,44,0,-44
1338,1,1,406,1475,1069
1339,1,1,308,1710,1402
1340,0,0,132,0,-132
1341,1,0,155,0,-155
1342,1,0,42,0,-42
1343,0,0,8,0,-8
1344,1,0,112,0,-112
1345,1,1,333,1581,1248
1346,1,1,246,1946,1700
1347,1,0,3,0,-3
1348,1,0,8,0,-8
1349,0,0,28,0,-28
1350,1,0,83,0,-83
1351,1,0,45,0,-45
1352,1,0,47,0,-47
1353,0,0,2,0,-2
1354,1,0,12,0,-12
1355,1,1,1320,1272,-48
1356,1,1,183,1606,1423
1357,1,0,89,0,-89
1358,1,1,426,2356,1930
1359,1,1,1046,1356,310
1360,0,0,103,0,-103
1361,1,1,757,1205,448
1362,0,0,79,0,-79
1363,1,0,100,0,-100
1364,1,1,894,1545,651
1365,0,0,32,0,-32
1366,0,0,22,0,-22
1367,0,0,22,0,-22
1368,0,0,52,0,-52
1369,0,0,57,0,-57
1370,0,0,188,0,-188
1371,1,1,640,1238,598
1372,0,0,2,0,-2
1373,1,0,41,0,-41
1374,1,0,33,0,-33
1375,1,1,293,1286,993
1376,1,1,81,1269,1188
1377,1,1,324,1509,1185
1378,0,0,13,0,-13
1379,0,0,102,0,-102
1380,0,0,64,0,-64
1381,1,1,331,1649,1318
1382,1,1,17,1254,1237
1383,0,0,50,0,-50
1384,0,0,15,0,-15
1385,1,0,25,0,-25
1386,0,0,20,0,-20
1387,1,0,42,0,-42
1388,1,0,22,0,-22
1389,0,0,11,0,-11
1390,1,1,55,1312,1257
1391,1,0,23,0,-23
1392,1,1,65,1380,1315
1393,1,1,926,1260,334
1394,0,0,53,0,-53
1395,1,0,36,0,-36
1396,1,0,51,0,-51
1397,1,1,99,1543,1444
1398,0,0,5,0,-5
1399,1,1,411,1240,829
1400,1,1,1063,1414,351
1401,0,0,32,0,-32
1402,0,0,71,0,-71
1403,0,0,94,0,-94
1404,0,0,59,0,-59
1405,0,0,8,0,-8
1406,1,1,362,1244,882
1407,1,1,915,1372,457
1408,1,0,45,0,-45
1409,1,1,835,1291,456
1410,0,0,3,0,-3
1411,1,1,298,2068,1770
1412,0,0,68,0,-68
1413,1,1,327,1337,1010
1414,1,1,66,1441,1375
1415,0,0,24,0,-24
1416,0,0,0,0,0
1417,0,0,15,0,-15
1418,0,0,1,0,-1
1419,1,1,662,1211,549
1420,1,0,38,0,-38
1421,0,0,141,0,-141
1422,0,0,40,0,-40
1423,1,1,265,1261,996
1424,1,0,118,0,-118
1425,0,0,36,0,-36
1426,1,0,21,0,-21
1427,0,0,51,0,-51
1428,1,0,17,0,-17
1429,1,0,56,0,-56
1430,1,0,123,0,-123
1431,1,1,1114,1284,170
1432,0,0,89,0,-89
1433,0,0,3,0,-3
1434,1,1,734,1346,612
1435,0,0,9,0,-9
1436,0,0,43,0,-43
1437,1,1,256,2258,2002
1438,0,0,31,0,-31
1439,1,1,313,1747,1434
1440,1,0,24,0,-24
1441,1,0,13,0,-13
1442,0,0,29,0,-29
1443,0,0,100,0,-100
1444,1,1,119,1324,1205
1445,1,0,6,0,-6
1446,0,0,105,0,-105
1447,0,0,5,0,-5
1448,0,0,80,0,-80
1449,1,1,71,1264,1193
1450,0,0,212,0,-212
1451,1,1,373,1287,914
1452,0,0,34,0,-34
1453,1,1,842,1326,484
1454,1,1,100,2149,2049
1455,1,1,752,1678,926
1456,0,0,81,0,-81
1457,1,1,403,2045,1642
1458,1,0,25,0,-25
1459,1,0,27,0,-27
1460,0,0,30,0,-30
1461,1,1,231,1459,1228
1462,1,1,20,1207,1187
1463,1,1,136,1775,1639
1464,0,0,2,0,-2
1465,1,0,82,0,-82
1466,1,1,716,1671,955
1467,1,1,694,1334,640
1468,1,1,197,1301,1104
1469,0,0,175,0,-175
1470,0,0,138,0,-138
1471,0,0,73,0,-73
1472,1,0,7,0,-7
1473,0,0,56,0,-56
1474,0,0,34,0,-34
1475,0,0,34,0,-34
1476,1,1,86,1895,1809
1477,1,1,310,1259,949
1478,0,0,25,0,-25
1479,1,1,423,1393,970
1480,1,1,247,1285,1038
1481,1,1,34,3971,3937
1482,0,0,7,0,-7
1483,1,0,48,0,-48
1484,1,1,419,1343,924
1485,1,0,36,0,-36
1486,0,0,94,0,-94
1487,1,0,83,0,-83
1488,0,0,18,0,-18
1489,0,0,126,0,-126
1490,0,0,28,0,-28
1491,1,1,591,5224,4633
1492,1,0,12,0,-12
1493,1,1,934,1417,483
1494,1,0,178,0,-178
1495,0,0,2,0,-2
1496,0,0,70,0,-70
1497,0,0,65,0,-65
1498,1,0,103,0,-103
1499,1,0,0,0,0
1500,0,0,14,0,-14
1501,0,0,77,0,-77
1502,0,0,2,0,-2
1503,0,0,70,0,-70
1504,1,1,77,1479,1402
1505,1,0,27,0,-27
1506,1,1,95,2501,2406
1507,1,0,2,0,-2
1508,1,0,21,0,-21
1509,1,1,434,2020,1586
1510,1,1,223,1907,1684
1511,0,0,147,0,-147
1512,1,0,37,0,-37
1513,1,1,1391,1249,-142
1514,0,0,45,0,-45
1515,0,0,62,0,-62
1516,1,1,156,1224,1068
1517,1,0,48,0,-48
1518,1,1,769,2446,1677
1519,1,0,90,0,-90
1520,1,0,81,0,-81
1521,1,0,93,0,-93
1522,1,1,550,1943,1393
1523,1,0,9,0,-9
1524,0,0,345,0,-345
1525,1,1,1911,2259,348
1526,1,1,443,1777,1334
1527,1,0,22,0,-22
1528,1,0,33,0,-33
1529,1,0,7,0,-7
1530,0,0,99,0,-99
1531,1,1,808,1420,612
1532,0,0,8,0,-8
1533,0,0,127,0,-127
1534,1,1,1178,2173,995
1535,1,1,201,1362,1161
1536,1,0,144,0,-144
1537,1,1,165,1365,1200
1538,0,0,73,0,-73
1539,1,1,421,1237,816
1540,0,0,123,0,-123
1541,1,0,62,0,-62
1542,1,1,381,2143,1762
1543,1,1,1024,1305,281
1544,0,0,10,0,-10
1545,1,1,2068,1603,-465
1546,1,1,117,1460,1343
1547,0,0,5,0,-5
1548,1,1,31,1228,1197
1549,1,0,15,0,-15
1550,1,1,1156,1366,210
1551,1,0,117,0,-117
1552,1,0,19,0,-19
1553,1,1,340,1534,1194
1554,0,0,34,0,-34
1555,1,0,47,0,-47
1556,0,0,35,0,-35
1557,1,0,14,0,-14
1558,1,0,37,0,-37
1559,1,0,45,0,-45
1560,0,0,30,0,-30
1561,0,0,162,0,-162
1562,1,0,51,0,-51
1563,0,0,28,0,-28
1564,1,0,48,0,-48
1565,1,0,27,0,-27
1566,0,0,26,0,-26
1567,1,0,1,0,-1
1568,1,0,16,0,-16
1569,0,0,64,0,-64
1570,1,1,813,1317,504
1571,0,0,33,0,-33
1572,1,0,44,0,-44
1573,0,0,23,0,-23
1574,1,1,738,1472,734
1575,1,0,14,0,-14
1576,0,0,35,0,-35
1577,1,0,22,0,-22
1578,1,1,187,1380,1193
1579,0,0,56,0,-56
1580,1,0,52,0,-52
1581,1,0,59,0,-59
1582,0,0,47,0,-47
1583,0,0,38,0,-38
1584,0,0,1,0,-1
1585,0,0,110,0,-110
1586,0,0,124,0,-124
1587,1,0,78,0,-78
1588,1,0,37,0,-37
1589,1,0,33,0,-33
1590,1,1,1833,1613,-220
1591,1,0,1,0,-1
1592,1,1,1315,1692,377
1593,1,1,485,1543,1058
1594,0,0,58,0,-58
1595,1,1,446,1285,839
1596,0,0,31,0,-31
1597,1,1,388,1244,856
1598,0,0,87,0,-87
1599,1,0,8,0,-8
1600,0,0,65,0,-65
1601,1,1,190,1357,1167
1602,1,1,344,1707,1363
1603,1,0,13,0,-13
1604,0,0,96,0,-96
1605,0,0,148,0,-148
1606,1,0,44,0,-44
1607,0,0,79,0,-79
1608,1,1,109,1434,1325
1609,1,0,1,0,-1
1610,1,0,25,0,-25
1611,0,0,66,0,-66
1612,0,0,107,0,-107
1613,1,1,801,1414,613
1614,0,0,6,0,-6
1615,1,1,875,1330,455
1616,1,1,1045,2195,1150
1617,1,1,1083,1322,239
1618,1,0,31,0,-31
1619,1,0,31,0,-31
1620,1,0,10,0,-10
1621,1,1,284,1296,1012
1622,1,1,477,1249,772
1623,0,0,76,0,-76
1624,1,0,14,0,-14
1625,1,0,170,0,-170
1626,1,0,5,0,-5
1627,0,0,119,0,-119
1628,1,0,45,0,-45
1629,1,0,4,0,-4
1630,1,1,120,1609,1489
1631,1,1,187,1691,1504
1632,1,0,20,0,-20
1633,0,0,0,0,0
1634,1,1,965,1478,513
1635,1,1,545,1836,1291
1636,0,0,48,0,-48
1637,0,0,31,0,-31
1638,1,1,469,1631,1162
1639,1,1,343,1580,1237
1640,0,0,82,0,-82
1641,1,0,31,0,-31
1642,0,0,33,0,-33
1643,0,0,6,0,-6
1644,0,0,12,0,-12
1645,0,0,74,0,-74
1646,0,0,1,0,-1
1647,1,1,104,1949,1845
1648,1,0,85,0,-85
1649,1,1,184,1485,1301
1650,1,0,7,0,-7
1651,0,0,82,0,-82
1652,1,1,262,1548,1286
1653,1,1,105,1539,1434
1654,0,0,50,0,-50
1655,0,0,22,0,-22
1656,1,1,694,1879,1185
1657,1,0,3,0,-3
1658,1,1,806,1200,394
1659,1,0,26,0,-26
1660,0,0,81,0,-81
1661,0,0,49,0,-49
1662,1,1,1528,1453,-75
1663,1,1,151,1523,1372
1664,1,1,270,1281,1011
1665,1,1,1035,1763,728
1666,1,0,48,0,-48
1667,1,1,774,1218,444
1668,1,1,187,2146,1959
1669,0,0,40,0,-40
1670,1,0,35,0,-35
1671,1,0,1,0,-1
1672,1,0,43,0,-43
1673,1,1,1172,1247,75
1674,1,1,193,1608,1415
1675,0,0,45,0,-45
1676,0,0,83,0,-83
1677,1,0,17,0,-17
1678,1,0,24,0,-24
1679,1,0,73,0,-73
1680,1,0,171,0,-171
1681,0,0,124,0,-124
1682,0,0,12,0,-12
1683,0,0,11,0,-11
1684,0,0,12,0,-12
1685,1,0,2,0,-2
1686,1,1,1221,1207,-14
1687,1,0,59,0,-59
1688,1,1,239,1244,1005
1689,0,0,34,0,-34
1690,1,0,41,0,-41
1691,1,1,498,2105,1607
1692,1,1,263,2279,2016
1693,1,1,306,1406,1100
1694,0,0,3,0,-3
1695,1,1,374,1200,826
1696,0,0,0,0,0
1697,1,1,82,1620,1538
1698,0,0,167,0,-167
1699,1,1,29,1335,1306
1700,0,0,20,0,-20
1701,0,0,27,0,-27
1702,1,1,623,1649,1026
1703,1,1,730,3271,2541
1704,0,0,9,0,-9
1705,1,0,122,0,-122
1706,0,0,2,0,-2
1707,1,1,271,1202,931
1708,1,1,721,1376,655
1709,1,1,138,1224,1086
1710,0,0,68,0,-68
1711,1,1,836,1447,611
1712,1,1,76,1578,1502
1713,1,0,70,0,-70
1714,1,0,15,0,-15
1715,1,1,149,6132,5983
1716,1,0,31,0,-31
1717,1,0,95,0,-95
1718,1,1,282,1628,1346
1719,1,1,162,1487,1325
1720,0,0,52,0,-52
1721,1,1,209,1237,1028
1722,0,0,44,0,-44
1723,1,1,1285,1834,549
1724,0,0,4,0,-4
1725,0,0,39,0,-39
1726,1,1,553,1854,1301
1727,0,0,72,0,-72
1728,0,0,63,0,-63
1729,0,0,45,0,-45
1730,0,0,12,0,-12
1731,0,0,53,0,-53
1732,0,0,6,0,-6
1733,0,0,13,0,-13
1734,0,0,73,0,-73
1735,1,1,979,1212,233
1736,1,0,86,0,-86
1737,1,1,120,1702,1582
1738,1,0,47,0,-47
1739,1,1,498,1636,1138
1740,0,0,320,0,-320
1741,0,0,3,0,-3
1742,0,0,56,0,-56
1743,1,0,54,0,-54
1744,1,1,60,2052,1992
1745,1,0,29,0,-29
1746,1,1,147,1383,1236
1747,1,0,5,0,-5
1748,1,0,33,0,-33
1749,0,0,23,0,-23
1750,1,1,1533,1245,-288
1751,0,0,24,0,-24
1752,1,1,272,1625,1353
1753,0,0,46,0,-46
1754,1,1,868,1687,819
1755,1,1,103,2038,1935
1756,0,0,5,0,-5
1757,1,0,36,0,-36
1758,1,0,151,0,-151
1759,0,0,80,0,-80
1760,1,1,877,1225,348
1761,1,0,9,0,-9
1762,0,0,80,0,-80
1763,1,0,43,0,-43
1764,1,0,155,0,-155
1765,1,1,764,1694,930
1766,1,1,137,1601,1464
1767,1,1,63,1475,1412
1768,1,1,638,1216,578
1769,0,0,60,0,-60
1770,0,0,25,0,-25
1771,0,0,144,0,-144
1772,1,0,192,0,-192
1773,1,0,54,0,-54
1774,1,0,3,0,-3
1775,1,1,831,1697,866
1776,1,1,15,2111,2096
1777,0,0,7,0,-7
1778,1,0,5,0,-5
1779,0,0,79,0,-79
1780,0,0,0,0,0
1781,1,1,769,1429,660
1782,1,0,57,0,-57
1783,1,0,13,0,-13
1784,0,0,0,0,0
1785,1,1,215,1539,1324
1786,1,0,11,0,-11
1787,0,0,46,0,-46
1788,1,1,381,1810,1429
1789,0,0,38,0,-38
1790,0,0,16,0,-16
1791,1,0,77,0,-77
1792,1,0,92,0,-92
1793,0,0,214,0,-214
1794,1,0,2,0,-2
1795,1,0,26,0,-26
1796,1,1,322,1857,1535
1797,1,0,110,0,-110
1798,0,0,5,0,-5
1799,1,1,209,1761,1552
1800,1,1,1201,1239,38
1801,1,1,969,1227,258
1802,0,0,115,0,-115
1803,1,1,364,1558,1194
1804,0,0,140,0,-140
1805,0,0,31,0,-31
1806,1,0,1,0,-1
1807,1,0,135,0,-135
1808,1,0,28,0,-28
1809,0,0,173,0,-173
1810,1,1,84,1696,1612
1811,0,0,46,0,-46
1812,1,0,46,0,-46
1813,1,0,50,0,-50
1814,1,0,20,0,-20
1815,0,0,48,0,-48
1816,1,1,301,1293,992
1817,1,0,42,0,-42
1818,0,0,65,0,-65
1819,0,0,148,0,-148
1820,1,1,78,1465,1387
1821,1,0,17,0,-17
1822,1,1,183,1246,1063
1823,1,1,1118,3690,2572
1824,0,0,64,0,-64
1825,0,0,162,0,-162
1826,1,0,11,0,-11
1827,1,1,185,1319,1134
1828,1,0,6,0,-6
1829,0,0,25,0,-25
1830,0,0,15,0,-15
1831,0,0,4,0,-4
1832,0,0,74,0,-74
1833,1,0,23,0,-23
1834,0,0,19,0,-19
1835,0,0,34,0,-34
1836,0,0,10,0,-10
1837,1,1,521,1252,731
1838,1,0,14,0,-14
1839,0,0,185,0,-185
1840,1,1,281,1249,968
1841,1,0,56,0,-56
1842,1,0,59,0,-59
1843,1,1,92,1297,1205
1844,0,0,26,0,-26
1845,0,0,113,0,-113
1846,1,1,457,1617,1160
1847,0,0,0,0,0
1848,0,0,0,0,0
1849,1,1,901,1240,339
1850,1,1,361,1263,902
1851,0,0,2,0,-2
1852,1,0,18,0,-18
1853,1,1,256,1631,1375
1854,1,1,418,1347,929
1855,1,1,205,1573,1368
1856,1,1,773,1617,844
1857,0,0,14,0,-14
1858,1,0,140,0,-140
1859,0,0,48,0,-48
1860,1,0,96,0,-96
1861,1,0,9,0,-9
1862,0,0,131,0,-131
1863,1,1,136,1325,1189
1864,1,1,1262,1868,606
1865,1,0,4,0,-4
1866,0,0,2,0,-2
1867,0,0,66,0,-66
1868,0,0,56,0,-56
1869,0,0,25,0,-25
1870,0,0,4,0,-4
1871,1,1,496,1821,1325
1872,1,0,52,0,-52
1873,1,0,19,0,-19
1874,1,1,1233,2309,1076
1875,1,1,167,2265,2098
1876,0,0,2,0,-2
1877,1,1,1008,1550,542
1878,1,1,1208,1368,160
1879,0,0,112,0,-112
1880,0,0,141,0,-141
1881,1,0,63,0,-63
1882,1,0,49,0,-49
1883,1,1,429,1667,1238
1884,0,0,0,0,0
1885,1,0,55,0,-55
1886,0,0,56,0,-56
1887,0,0,24,0,-24
1888,1,1,210,1635,1425
1889,1,1,459,1410,951
1890,1,0,28,0,-28
1891,1,1,74,1267,1193
1892,1,1,419,1319,900
1893,1,1,370,1278,908
1894,1,1,918,2555,1637
1895,1,0,1,0,-1
1896,0,0,12,0,-12
1897,0,0,17,0,-17
1898,0,0,28,0,-28
1899,1,1,290,1389,1099
1900,1,1,950,1428,478
1901,1,0,183,0,-183
1902,1,1,264,1423,1159
1903,0,0,11,0,-11
1904,1,1,1585,2734,1149
1905,0,0,157,0,-157
1906,0,0,3,0,-3
1907,0,0,28,0,-28
1908,0,0,14,0,-14
1909,1,1,647,1496,849
1910,1,1,437,1364,927
1911,0,0,63,0,-63
1912,1,1,46,1442,1396
1913,0,0,71,0,-71
1914,1,0,43,0,-43
1915,0,0,211,0,-211
1916,1,0,181,0,-181
1917,0,0,14,0,-14
1918,1,0,46,0,-46
1919,0,0,10,0,-10
1920,0,0,42,0,-42
1921,1,1,524,1397,873
1922,1,1,193,1473,1280
1923,1,1,533,1369,836
1924,0,0,59,0,-59
1925,0,0,48,0,-48
1926,1,0,19,0,-19
1927,0,0,60,0,-60
1928,0,0,82,0,-82
1929,0,0,17,0,-17
1930,1,0,6,0,-6
1931,1,1,998,1737,739
1932,0,0,56,0,-56
1933,0,0,1,0,-1
1934,1,0,6,0,-6
1935,0,0,19,0,-19
1936,0,0,22,0,-22
1937,1,0,6,0,-6
1938,0,0,15,0,-15
1939,1,1,70,1317,1247
1940,1,0,38,0,-38
1941,0,0,2,0,-2
1942,1,1,943,1301,358
1943,0,0,68,0,-68
1944,0,0,17,0,-17
1945,1,1,443,1394,951
1946,1,1,981,1253,272
1947,0,0,85,0,-85
1948,0,0,28,0,-28
1949,1,1,118,1258,1140
1950,1,0,93,0,-93
1951,0,0,75,0,-75
1952,1,0,40,0,-40
1953,0,0,84,0,-84
1954,1,1,1169,1221,52
1955,1,1,433,1215,782
1956,0,0,93,0,-93
1957,0,0,66,0,-66
1958,1,0,7,0,-7
1959,0,0,48,0,-48
1960,0,0,54,0,-54
1961,1,0,149,0,-149
1962,0,0,5,0,-5
1963,1,0,47,0,-47
1964,1,0,13,0,-13
1965,0,0,34,0,-34
1966,1,0,87,0,-87
1967,1,0,116,0,-116
1968,1,0,171,0,-171
1969,1,0,2,0,-2
1970,1,1,347,1502,1155
1971,1,1,31,1878,1847
1972,1,1,49,1819,1770
1973,0,0,2,0,-2
1974,1,0,126,0,-126
1975,1,1,1064,1497,433
1976,1,0,20,0,-20
1977,1,1,105,2227,2122
1978,1,0,75,0,-75
1979,0,0,15,0,-15
1980,1,0,2,0,-2
1981,1,1,338,2031,1693
1982,1,1,1051,1763,712
1983,1,1,817,1273,456
1984,0,0,22,0,-22
1985,1,1,418,2348,1930
1986,0,0,30,0,-30
1987,1,0,3,0,-3
1988,1,0,56,0,-56
1989,0,0,23,0,-23
1990,0,0,69,0,-69
1991,0,0,73,0,-73
1992,1,1,733,1572,839
1993,1,0,4,0,-4
1994,0,0,17,0,-17
1995,1,1,557,1590,1033
1996,1,0,68,0,-68
1997,0,0,58,0,-58
1998,0,0,56,0,-56
1999,0,0,31,0,-31
2000,0,0,1,0,-1
2001,0,0,0,0,0
2002,0,0,12,0,-12
2003,1,1,519,1989,1470
2004,0,0,18,0,-18
2005,1,0,52,0,-52
2006,0,0,87,0,-87
2007,0,0,130,0,-130
2008,1,0,78,0,-78
2009,1,1,315,1600,1285
2010,1,0,8,0,-8
2011,1,1,55,1215,1160
2012,0,0,94,0,-94
2013,1,1,357,1551,1194
2014,1,0,44,0,-44
2015,1,0,4,0,-4
2016,1,1,810,1468,658
2017,1,0,19,0,-19
2018,1,0,4,0,-4
2019,0,0,4,0,-4
2020,1,1,57,1395,1338
2021,1,0,113,0,-113
2022,1,0,38,0,-38
2023,0,0,24,0,-24
2024,0,0,3,0,-3
2025,0,0,27,0,-27
2026,1,1,1280,1338,58
2027,0,0,26,0,-26
2028,1,1,379,1337,958
2029,1,1,103,1942,1839
2030,0,0,35,0,-35
2031,0,0,110,0,-110
2032,1,1,926,1292,366
2033,1,0,138,0,-138
2034,0,0,36,0,-36
2035,0,0,131,0,-131
2036,1,1,29,1621,1592
2037,1,0,27,0,-27
2038,0,0,6,0,-6
2039,1,0,212,0,-212
2040,1,0,22,0,-22
2041,0,0,53,0,-53
2042,1,1,429,1463,1034
2043,0,0,75,0,-75
2044,0,0,30,0,-30
2045,1,0,37,0,-37
2046,0,0,58,0,-58
2047,0,0,127,0,-127
2048,1,0,60,0,-60
2049,1,1,999,1467,468
2050,1,1,302,1567,1265
2051,0,0,70,0,-70
2052,1,0,21,0,-21
2053,1,0,0,0,0
2054,1,0,38,0,-38
2055,0,0,11,0,-11
2056,1,0,11,0,-11
2057,1,0,73,0,-73
2058,1,0,1,0,-1
2059,1,1,304,2601,2297
2060,1,0,3,0,-3
2061,0,0,36,0,-36
2062,1,0,21,0,-21
2063,1,0,93,0,-93
2064,1,1,262,1229,967
2065,1,1,691,1568,877
2066,1,1,193,1874,1681
2067,1,1,68,1541,1473
2068,1,0,51,0,-51
2069,0,0,15,0,-15
2070,0,0,14,0,-14
2071,0,0,80,0,-80
2072,1,0,11,0,-11
2073,0,0,51,0,-51
2074,0,0,14,0,-14
2075,0,0,103,0,-103
2076,1,0,55,0,-55
2077,1,0,22,0,-22
2078,1,0,10,0,-10
2079,0,0,56,0,-56
2080,1,1,149,1314,1165
2081,1,1,754,1426,672
2082,1,1,440,2706,2266
2083,1,1,576,1251,675
2084,0,0,8,0,-8
2085,1,1,172,1480,1308
2086,1,1,343,1627,1284
2087,1,1,177,1247,1070
2088,0,0,45,0,-45
2089,0,0,147,0,-147
2090,1,0,49,0,-49
2091,0,0,20,0,-20
2092,1,0,11,0,-11
2093,0,0,54,0,-54
2094,1,0,10,0,-10
2095,0,0,149,0,-149
2096,0,0,37,0,-37
2097,1,0,1,0,-1
2098,1,1,43,1706,1663
2099,1,0,41,0,-41
2100,0,0,12,0,-12
2101,1,1,79,2021,1942
2102,0,0,5,0,-5
2103,1,1,857,1314,457
2104,0,0,67,0,-67
2105,1,0,83,0,-83
2106,1,1,1122,1437,315
2107,1,0,16,0,-16
2108,0,0,82,0,-82
2109,0,0,68,0,-68
2110,1,0,3,0,-3
2111,0,0,43,0,-43
2112,1,1,1688,3078,1390
2113,1,1,639,1803,1164
2114,1,1,273,2874,2601
2115,1,0,111,0,-111
2116,1,0,60,0,-60
2117,1,0,51,0,-51
2118,1,1,153,1484,1331
2119,1,0,16,0,-16
2120,0,0,53,0,-53
2121,1,1,750,2260,1510
2122,1,1,447,1699,1252
2123,0,0,25,0,-25
2124,0,0,5,0,-5
2125,1,1,897,1369,472
2126,1,0,12,0,-12
2127,1,1,471,1616,1145
2128,0,0,52,0,-52
2129,0,0,158,0,-158
2130,1,0,19,0,-19
2131,0,0,13,0,-13
2132,1,1,135,1313,1178
2133,1,0,98,0,-98
2134,1,1,152,3602,3450
2135,0,0,11,0,-11
2136,1,1,980,1332,352
2137,0,0,48,0,-48
2138,0,0,106,0,-106
2139,0,0,36,0,-36
2140,1,1,400,1204,804
2141,1,0,131,0,-131
2142,1,1,380,1303,923
2143,1,1,789,1270,481
2144,0,0,15,0,-15
2145,1,0,98,0,-98
2146,0,0,39,0,-39
2147,1,1,125,1287,1162
2148,0,0,19,0,-19
2149,1,1,540,1208,668
2150,1,1,833,2776,1943
2151,0,0,113,0,-113
2152,0,0,88,0,-88
2153,0,0,37,0,-37
2154,1,0,68,0,-68
2155,1,0,52,0,-52
2156,1,1,1292,1337,45
2157,1,1,975,1256,281
2158,1,0,2,0,-2
2159,1,1,144,1341,1197
2160,1,0,27,0,-27
2161,0,0,17,0,-17
2162,0,0,109,0,-109
2163,0,0,39,0,-39
2164,1,0,42,0,-42
2165,1,1,674,1214,540
2166,1,0,33,0,-33
2167,1,1,720,2230,1510
2168,0,0,47,0,-47
2169,1,1,451,1337,886
2170,1,0,15,0,-15
2171,0,0,4,0,-4
2172,0,0,119,0,-119
2173,0,0,37,0,-37
2174,0,0,70,0,-70
2175,0,0,106,0,-106
2176,1,1,868,1437,569
2177,1,0,48,0,-48
2178,1,0,51,0,-51
2179,1,1,47,1608,1561
2180,0,0,44,0,-44
2181,1,1,190,3060,2870
2182,1,1,614,1370,756
2183,1,1,368,1312,944
2184,1,0,7,0,-7
2185,1,0,22,0,-22
2186,0,0,2,0,-2
2187,0,0,44,0,-44
2188,0,0,72,0,-72
2189,1,0,61,0,-61
2190,0,0,105,0,-105
2191,1,1,92,1234,1142
2192,0,0,160,0,-160
2193,1,1,323,1223,900
2194,0,0,20,0,-20
2195,1,1,794,1500,706
2196,1,0,66,0,-66
2197,1,1,473,1798,1325
2198,0,0,22,0,-22
2199,0,0,108,0,-108
2200,1,0,30,0,-30
2201,0,0,22,0,-22
2202,0,0,6,0,-6
2203,1,0,37,0,-37
2204,1,0,59,0,-59
2205,1,1,295,1549,1254
2206,1,0,16,0,-16
2207,0,0,16,0,-16
2208,1,1,62,1217,1155
2209,1,1,183,1297,1114
2210,0,0,30,0,-30
2211,1,0,24,0,-24
2212,0,0,29,0,-29
2213,0,0,38,0,-38
2214,0,0,9,0,-9
2215,1,1,703,1648,945
2216,0,0,65,0,-65
2217,0,0,4,0,-4
2218,1,0,28,0,-28
2219,0,0,5,0,-5
2220,1,0,14,0,-14
2221,1,0,75,0,-75
2222,1,0,137,0,-137
2223,0,0,11,0,-11
2224,0,0,139,0,-139
2225,0,0,0,0,0
2226,1,1,1147,1468,321
2227,1,1,75,1266,1191
2228,1,0,79,0,-79
2229,0,0,0,0,0
2230,1,1,1003,1906,903
2231,0,0,142,0,-142
2232,1,1,1685,1339,-346
2233,1,1,709,1508,799
2234,1,0,79,0,-79
2235,0,0,106,0,-106
2236,0,0,76,0,-76
2237,0,0,34,0,-34
2238,1,1,99,1386,1287
2239,0,0,0,0,0
2240,1,0,31,0,-31
2241,1,0,4,0,-4
2242,0,0,27,0,-27
2243,0,0,11,0,-11
2244,0,0,63,0,-63
2245,0,0,88,0,-88
2246,1,1,429,1226,797
2247,0,0,73,0,-73
2248,1,0,73,0,-73
2249,0,0,7,0,-7
2250,1,1,501,1387,886
2251,1,1,398,1758,1360
2252,0,0,35,0,-35
2253,1,1,722,1232,510
2254,1,1,1204,2867,1663
2255,1,1,70,1309,1239
2256,1,1,2585,1551,-1034
2257,1,1,1292,1504,212
2258,0,0,44,0,-44
2259,1,0,76,0,-76
2260,0,0,0,0,0
2261,1,0,91,0,-91
2262,1,0,13,0,-13
2263,1,0,4,0,-4
2264,1,1,1630,1211,-419
2265,1,0,108,0,-108
2266,1,0,47,0,-47
2267,1,1,820,1249,429
2268,1,1,223,1337,1114
2269,1,1,969,1689,720
2270,1,0,5,0,-5
2271,1,1,1772,1216,-556
2272,0,0,68,0,-68
2273,1,0,24,0,-24
2274,1,1,204,1200,996
2275,0,0,44,0,-44
2276,0,0,14,0,-14
2277,0,0,22,0,-22
2278,0,0,78,0,-78
2279,1,1,924,1821,897
2280,1,0,80,0,-80
2281,1,0,154,0,-154
2282,1,0,54,0,-54
2283,0,0,56,0,-56
2284,1,1,203,1446,1243
2285,0,0,46,0,-46
2286,0,0,127,0,-127
2287,1,1,980,1557,577
2288,0,0,87,0,-87
2289,0,0,35,0,-35
2290,1,1,658,1229,571
2291,0,0,36,0,-36
2292,1,0,16,0,-16
2293,1,0,74,0,-74
2294,1,1,639,1828,1189
2295,0,0,132,0,-132
2296,1,0,71,0,-71
2297,0,0,13,0,-13
2298,0,0,64,0,-64
2299,1,0,308,0,-308
2300,1,1,185,1911,1726
2301,1,1,459,1379,920
2302,1,0,34,0,-34
2303,1,1,1603,1856,253
2304,0,0,82,0,-82
2305,0,0,19,0,-19
2306,1,1,1237,1214,-23
2307,1,0,12,0,-12
2308,1,0,51,0,-51
2309,1,0,57,0,-57
2310,0,0,177,0,-177
2311,1,1,1146,1522,376
2312,1,0,18,0,-18
2313,1,1,775,1562,787
2314,1,0,24,0,-24
2315,0,0,5,0,-5
2316,1,1,78,1317,1239
2317,0,0,79,0,-79
2318,1,1,227,1651,1424
2319,1,1,69,1425,1356
2320,1,0,243,0,-243
2321,0,0,12,0,-12
2322,1,0,37,0,-37
2323,1,0,32,0,-32
2324,1,1,89,1696,1607
2325,0,0,4,0,-4
2326,1,1,987,1352,365
2327,0,0,36,0,-36
2328,1,0,86,0,-86
2329,0,0,120,0,-120
2330,1,1,396,2455,2059
2331,0,0,34,0,-34
2332,0,0,71,0,-71
2333,0,0,68,0,-68
2334,0,0,29,0,-29
2335,0,0,68,0,-68
2336,0,0,26,0,-26
2337,0,0,19,0,-19
2338,1,1,1168,1578,410
2339,0,0,38,0,-38
2340,0,0,29,0,-29
2341,0,0,14,0,-14
2342,1,1,2449,2251,-198
2343,0,0,108,0,-108
2344,1,0,60,0,-60
2345,0,0,88,0,-88
2346,0,0,61,0,-61
2347,1,1,469,1225,756
2348,1,0,140,0,-140
2349,0,0,19,0,-19
2350,1,0,57,0,-57
2351,1,1,443,1257,814
2352,0,0,4,0,-4
2353,0,0,39,0,-39
2354,1,1,2121,1972,-149
2355,1,1,1134,1205,71
2356,0,0,59,0,-59
2357,1,1,199,1322,1123
2358,1,1,241,1528,1287
2359,1,0,3,0,-3
2360,1,0,168,0,-168
2361,1,1,180,2231,2051
2362,0,0,30,0,-30
2363,1,0,93,0,-93
2364,0,0,32,0,-32
2365,1,1,60,1248,1188
2366,1,0,18,0,-18
2367,1,1,386,1336,950
2368,1,0,33,0,-33
2369,0,0,67,0,-67
2370,0,0,41,0,-41
2371,1,1,1011,1209,198
2372,1,0,24,0,-24
2373,0,0,105,0,-105
2374,0,0,49,0,-49
2375,0,0,41,0,-41
2376,1,0,22,0,-22
2377,1,1,307,1237,930
2378,1,0,159,0,-159
2379,0,0,33,0,-33
2380,0,0,22,0,-22
2381,0,0,42,0,-42
2382,0,0,46,0,-46
2383,1,1,1261,1831,570
2384,0,0,44,0,-44
2385,0,0,33,0,-33
2386,1,0,62,0,-62
2387,0,0,75,0,-75
2388,1,0,18,0,-18
2389,1,0,89,0,-89
2390,0,0,56,0,-56
2391,0,0,67,0,-67
2392,0,0,6,0,-6
2393,1,1,534,1203,669
2394,1,1,624,1716,1092
2395,1,1,1287,1346,59
2396,1,0,30,0,-30
2397,1,1,747,1362,615
2398,0,0,14,0,-14
2399,1,1,265,1470,1205
2400,0,0,11,0,-11
2401,1,1,536,1369,833
2402,1,1,633,1959,1326
2403,1,0,22,0,-22
2404,1,1,97,1711,1614
2405,0,0,30,0,-30
2406,0,0,54,0,-54
2407,0,0,1,0,-1
2408,1,1,331,1974,1643
2409,0,0,27,0,-27
2410,1,0,33,0,-33
2411,1,0,13,0,-13
2412,0,0,54,0,-54
2413,1,1,299,4515,4216
2414,0,0,14,0,-14
2415,0,0,42,0,-42
2416,1,1,307,1609,1302
2417,0,0,31,0,-31
2418,0,0,8,0,-8
2419,1,0,11,0,-11
2420,1,0,59,0,-59
2421,0,0,35,0,-35
2422,1,0,5,0,-5
2423,1,0,1,0,-1
2424,1,1,153,1596,1443
2425,1,0,2,0,-2
2426,1,1,431,1997,1566
2427,1,0,123,0,-123
2428,0,0,34,0,-34
2429,1,1,113,1950,1837
2430,1,0,82,0,-82
2431,0,0,83,0,-83
2432,1,0,20,0,-20
2433,1,1,807,1447,640
2434,1,1,131,2387,2256
2435,0,0,25,0,-25
2436,0,0,57,0,-57
2437,1,0,7,0,-7
2438,0,0,98,0,-98
2439,1,1,149,1522,1373
2440,1,1,148,1228,1080
2441,1,1,67,2627,2560
2442,1,1,1351,1559,208
2443,1,1,642,1537,895
2444,1,1,580,1280,700
2445,1,0,0,0,0
2446,0,0,40,0,-40
2447,1,0,25,0,-25
2448,1,0,34,0,-34
2449,0,0,3,0,-3
2450,1,1,200,1570,1370
2451,1,1,230,1441,1211
2452,0,0,10,0,-10
2453,1,0,82,0,-82
2454,1,1,675,1291,616
2455,1,1,51,3480,3429
2456,1,1,201,1696,1495
2457,1,1,178,1274,1096
2458,1,1,1329,1207,-122
2459,0,0,11,0,-11
2460,0,0,25,0,-25
2461,0,0,5,0,-5
2462,0,0,59,0,-59
2463,0,0,86,0,-86
2464,0,0,42,0,-42
2465,1,0,12,0,-12
2466,1,1,2040,1365,-675
2467,0,0,4,0,-4
2468,1,1,96,1831,1735
2469,0,0,39,0,-39
2470,0,0,15,0,-15
2471,0,0,2,0,-2
2472,1,1,460,1313,853
2473,1,1,733,1687,954
2474,0,0,53,0,-53
2475,1,0,0,0,0
2476,1,0,5,0,-5
2477,1,0,57,0,-57
2478,1,1,1888,2875,987
2479,1,1,453,1294,841
2480,1,0,41,0,-41
2481,1,0,39,0,-39
2482,1,1,1258,1928,670
2483,1,0,117,0,-117
2484,1,0,15,0,-15
2485,1,1,824,1200,376
2486,0,0,123,0,-123
2487,1,1,733,1299,566
2488,0,0,6,0,-6
2489,0,0,3,0,-3
2490,1,0,67,0,-67
2491,1,0,4,0,-4
2492,1,1,429,1386,957
2493,0,0,14,0,-14
2494,1,1,521,1243,722
2495,1,1,790,1260,470
2496,0,0,5,0,-5
2497,0,0,30,0,-30
2498,0,0,21,0,-21
2499,0,0,32,0,-32
2500,1,0,6,0,-6
2501,1,0,41,0,-41
2502,0,0,28,0,-28
2503,1,0,3,0,-3
2504,0,0,30,0,-30
2505,1,0,63,0,-63
2506,0,0,252,0,-252
2507,1,1,800,1375,575
2508,1,0,38,0,-38
2509,0,0,30,0,-30
2510,0,0,29,0,-29
2511,0,0,64,0,-64
2512,1,1,367,1436,1069
2513,0,0,22,0,-22
2514,0,0,121,0,-121
2515,0,0,7,0,-7
2516,1,0,60,0,-60
2517,0,0,55,0,-55
2518,1,0,6,0,-6
2519,1,0,62,0,-62
2520,1,0,28,0,-28
2521,1,0,16,0,-16
2522,0,0,166,0,-166
2523,1,1,69,1236,1167
2524,1,1,284,2336,2052
2525,0,0,54,0,-54
2526,1,1,167,1878,1711
2527,0,0,16,0,-16
2528,1,0,64,0,-64
2529,1,0,32,0,-32
2530,1,1,406,1558,1152
2531,0,0,8,0,-8
2532,1,1,956,1565,609
2533,1,0,150,0,-150
2534,1,1,578,2104,1526
2535,1,0,104,0,-104
2536,0,0,100,0,-100
2537,1,1,731,1693,962
2538,0,0,14,0,-14
2539,1,0,8,0,-8
2540,0,0,22,0,-22
2541,1,0,5,0,-5
2542,0,0,3,0,-3
2543,0,0,63,0,-63
2544,1,0,1,0,-1
2545,0,0,104,0,-104
2546,1,1,838,1345,507
2547,1,0,28,0,-28
2548,1,1,503,1268,765
2549,1,0,19,0,-19
2550,1,1,269,1426,1157
2551,1,0,5,0,-5
2552,0,0,58,0,-58
2553,1,1,974,1561,587
2554,1,0,50,0,-50
2555,0,0,129,0,-129
2556,1,1,718,1309,591
2557,1,0,89,0,-89
2558,1,0,5,0,-5
2559,1,1,376,1999,1623
2560,0,0,20,0,-20
2561,0,0,65,0,-65
2562,1,0,62,0,-62
2563,0,0,10,0,-10
2564,0,0,122,0,-122
2565,0,0,15,0,-15
2566,0,0,82,0,-82
2567,1,1,481,1280,799
2568,1,0,1,0,-1
2569,0,0,35,0,-35
2570,1,0,67,0,-67
2571,0,0,22,0,-22
2572,1,1,1187,1603,416
2573,1,0,34,0,-34
2574,1,1,301,1300,999
2575,1,0,112,0,-112
2576,1,0,44,0,-44
2577,1,1,46,1372,1326
2578,1,0,23,0,-23
2579,0,0,21,0,-21
2580,1,0,0,0,0
2581,1,1,372,1508,1136
2582,0,0,20,0,-20
2583,1,1,1745,1305,-440
2584,1,1,159,1319,1160
2585,1,0,7,0,-7
2586,1,0,20,0,-20
2587,1,0,53,0,-53
2588,1,1,241,1592,1351
2589,0,0,10,0,-10
2590,1,1,714,2759,2045
2591,0,0,42,0,-42
2592,1,0,3,0,-3
2593,0,0,21,0,-21
2594,0,0,7,0,-7
2595,1,0,51,0,-51
2596,0,0,48,0,-48
2597,1,0,49,0,-49
2598,1,0,50,0,-50
2599,1,1,40,1523,1483
2600,0,0,67,0,-67
2601,0,0,42,0,-42
2602,0,0,69,0,-69
2603,0,0,10,0,-10
2604,1,1,988,1576,588
2605,1,0,152,0,-152
2606,1,1,264,1250,986
2607,1,0,51,0,-51
2608,0,0,57,0,-57
2609,1,0,8,0,-8
2610,1,1,422,1674,1252
2611,0,0,49,0,-49
2612,0,0,50,0,-50
2613,1,1,116,1236,1120
2614,1,1,3259,1234,-2025
2615,1,0,94,0,-94
2616,1,1,394,1242,848
2617,0,0,9,0,-9
2618,1,1,165,2124,1959
2619,0,0,97,0,-97
2620,0,0,223,0,-223
2621,1,1,458,1241,783
2622,0,0,0,0,0
2623,0,0,32,0,-32
2624,1,1,1156,1824,668
2625,1,1,527,1840,1313
2626,0,0,7,0,-7
2627,0,0,45,0,-45
2628,1,1,126,1393,1267
2629,1,0,80,0,-80
2630,1,0,56,0,-56
2631,1,1,166,2061,1895
2632,0,0,107,0,-107
2633,1,0,20,0,-20
2634,1,1,163,1310,1147
2635,1,1,200,1262,1062
2636,1,1,78,1298,1220
2637,0,0,39,0,-39
2638,1,1,238,1340,1102
2639,0,0,50,0,-50
2640,0,0,10,0,-10
2641,0,0,52,0,-52
2642,1,0,12,0,-12
2643,0,0,30,0,-30
2644,0,0,46,0,-46
2645,0,0,121,0,-121
2646,0,0,4,0,-4
2647,0,0,6,0,-6
2648,1,0,39,0,-39
2649,0,0,230,0,-230
2650,0,0,64,0,-64
2651,0,0,75,0,-75
2652,1,1,28,1275,1247
2653,1,1,807,1398,591
2654,1,1,148,1447,1299
2655,1,1,157,1496,1339
2656,0,0,179,0,-179
2657,1,0,22,0,-22
2658,1,0,16,0,-16
2659,1,0,10,0,-10
2660,1,1,280,1308,1028
2661,1,0,80,0,-80
2662,0,0,47,0,-47
2663,0,0,60,0,-60
2664,0,0,23,0,-23
2665,0,0,106,0,-106
2666,0,0,1,0,-1
2667,1,1,231,1536,1305
2668,1,0,7,0,-7
2669,1,1,83,1823,1740
2670,1,1,88,2352,2264
2671,0,0,108,0,-108
2672,1,0,15,0,-15
2673,1,0,169,0,-169
2674,0,0,1,0,-1
2675,1,0,7,0,-7
2676,0,0,20,0,-20
2677,1,0,10,0,-10
2678,1,1,460,1882,1422
2679,0,0,71,0,-71
2680,0,0,8,0,-8
2681,1,1,53,1631,1578
2682,0,0,2,0,-2
2683,0,0,131,0,-131
2684,1,0,23,0,-23
2685,0,0,97,0,-97
2686,1,0,20,0,-20
2687,1,1,440,1322,882
2688,0,0,77,0,-77
2689,1,1,378,1396,1018
2690,1,0,39,0,-39
2691,1,0,24,0,-24
2692,0,0,28,0,-28
2693,0,0,55,0,-55
2694,1,1,308,2041,1733
2695,1,1,497,1517,1020
2696,1,1,44,1385,1341
2697,0,0,10,0,-10
2698,1,0,7,0,-7
2699,0,0,0,0,0
2700,0,0,16,0,-16
2701,1,1,1152,1216,64
2702,1,1,374,1571,1197
2703,1,1,1686,1637,-49
2704,0,0,1,0,-1
2705,0,0,30,0,-30
2706,0,0,2,0,-2
2707,0,0,49,0,-49
2708,0,0,25,0,-25
2709,1,1,1471,1209,-262
2710,0,0,14,0,-14
2711,1,1,754,1258,504
2712,1,0,44,0,-44
2713,0,0,124,0,-124
2714,0,0,10,0,-10
2715,1,1,577,1457,880
2716,1,1,937,1412,475
2717,1,0,49,0,-49
2718,0,0,13,0,-13
2719,0,0,32,0,-32
2720,1,1,410,1954,1544
2721,1,0,0,0,0
2722,0,0,33,0,-33
2723,1,0,158,0,-158
2724,0,0,57,0,-57
2725,1,0,18,0,-18
2726,1,0,112,0,-112
2727,1,0,25,0,-25
2728,1,1,1138,1201,63
2729,0,0,62,0,-62
2730,1,0,37,0,-37
2731,0,0,52,0,-52
2732,1,1,100,1572,1472
2733,1,0,24,0,-24
2734,1,1,1217,1600,383
2735,1,1,229,2057,1828
2736,0,0,420,0,-420
2737,1,1,620,1742,1122
2738,1,1,463,1338,875
2739,1,1,1395,1814,419
2740,1,0,1,0,-1
2741,1,1,57,1510,1453
2742,1,0,27,0,-27
2743,0,0,185,0,-185
2744,0,0,18,0,-18
2745,0,0,30,0,-30
2746,1,0,1,0,-1
2747,0,0,35,0,-35
2748,0,0,143,0,-143
2749,0,0,36,0,-36
2750,0,0,33,0,-33
2751,1,0,27,0,-27
2752,0,0,82,0,-82
2753,0,0,37,0,-37
2754,1,0,5,0,-5
2755,0,0,74,0,-74
2756,0,0,52,0,-52
2757,1,0,6,0,-6
2758,1,0,31,0,-31
2759,0,0,103,0,-103
2760,1,0,75,0,-75
2761,1,0,21,0,-21
2762,0,0,20,0,-20
2763,0,0,27,0,-27
2764,1,0,74,0,-74
2765,1,0,24,0,-24
2766,1,0,106,0,-106
2767,1,0,82,0,-82
2768,1,1,713,1876,1163
2769,1,0,20,0,-20
2770,1,1,1792,3182,1390
2771,0,0,9,0,-9
2772,1,0,24,0,-24
2773,1,1,1206,1410,204
2774,0,0,133,0,-133
2775,0,0,26,0,-26
2776,1,1,1029,1259,230
2777,1,0,9,0,-9
2778,0,0,26,0,-26
2779,1,1,173,1447,1274
2780,0,0,0,0,0
2781,1,1,913,2051,1138
2782,1,1,142,1329,1187
2783,1,1,656,1224,568
2784,1,1,354,1436,1082
2785,1,1,202,1395,1193
2786,0,0,20,0,-20
2787,1,0,44,0,-44
2788,0,0,65,0,-65
2789,1,0,52,0,-52
2790,1,0,40,0,-40
2791,0,0,41,0,-41
2792,0,0,16,0,-16
2793,1,1,269,4927,4658
2794,1,0,7,0,-7
2795,1,1,644,1534,890
2796,1,1,163,1865,1702
2797,1,0,36,0,-36
2798,1,0,9,0,-9
2799,1,0,76,0,-76
2800,0,0,3,0,-3
2801,1,0,43,0,-43
2802,1,0,57,0,-57
2803,0,0,21,0,-21
2804,0,0,46,0,-46
2805,0,0,62,0,-62
2806,1,1,287,1672,1385
2807,0,0,13,0,-13
2808,0,0,15,0,-15
2809,1,0,6,0,-6
2810,1,1,680,1426,746
2811,1,0,33,0,-33
2812,1,1,1291,2980,1689
2813,0,0,5,0,-5
2814,0,0,17,0,-17
2815,1,1,301,1227,926
2816,1,0,75,0,-75
2817,0,0,23,0,-23
2818,1,1,1238,1446,208
2819,1,1,1733,1294,-439
2820,1,1,151,1909,1758
2821,1,0,67,0,-67
2822,0,0,2,0,-2
2823,0,0,5,0,-5
2824,1,1,25,1715,1690
2825,1,1,59,1225,1166
2826,1,0,19,0,-19
2827,0,0,12,0,-12
2828,1,1,656,1451,795
2829,1,1,71,1222,1151
2830,0,0,103,0,-103
2831,1,1,288,1357,1069
2832,0,0,40,0,-40
2833,1,0,76,0,-76
2834,0,0,34,0,-34
2835,0,0,17,0,-17
2836,1,1,50,1520,1470
2837,0,0,6,0,-6
2838,1,0,2,0,-2
2839,1,0,22,0,-22
2840,1,0,46,0,-46
2841,0,0,32,0,-32
2842,1,1,431,1325,894
2843,1,1,1092,2021,929
2844,1,1,178,1232,1054
2845,0,0,196,0,-196
2846,1,1,984,1543,559
2847,1,1,718,1214,496
2848,0,0,52,0,-52
2849,0,0,223,0,-223
2850,1,1,616,2710,2094
2851,1,1,1397,1434,37
2852,1,1,266,1691,1425
2853,1,0,5,0,-5
2854,1,1,51,1422,1371
2855,1,1,377,1433,1056
2856,0,0,91,0,-91
2857,1,1,644,2035,1391
2858,0,0,97,0,-97
2859,1,1,248,1769,1521
2860,1,0,67,0,-67
2861,1,0,5,0,-5
2862,1,0,268,0,-268
2863,1,0,21,0,-21
2864,0,0,53,0,-53
2865,1,1,287,2145,1858
2866,0,0,26,0,-26
2867,1,0,11,0,-11
2868,1,1,1243,1453,210
2869,0,0,2,0,-2
2870,1,0,18,0,-18
2871,0,0,41,0,-41
2872,1,1,1712,1904,192
2873,1,0,47,0,-47
2874,1,0,10,0,-10
2875,1,1,974,1205,231
2876,1,0,25,0,-25
2877,1,1,2385,1667,-718
2878,1,1,332,1590,1258
2879,1,1,895,2104,1209
2880,1,1,108,1267,1159
2881,1,0,0,0,0
2882,0,0,22,0,-22
2883,0,0,35,0,-35
2884,1,0,13,0,-13
2885,0,0,73,0,-73
2886,0,0,1,0,-1
2887,0,0,37,0,-37
2888,1,0,2,0,-2
2889,1,1,217,2189,1972
2890,0,0,55,0,-55
2891,1,1,999,1516,517
2892,0,0,76,0,-76
2893,0,0,55,0,-55
2894,0,0,77,0,-77
2895,1,0,105,0,-105
2896,1,1,355,1321,966
2897,0,0,51,0,-51
2898,1,0,47,0,-47
2899,0,0,33,0,-33
2900,0,0,12,0,-12
2901,0,0,96,0,-96
2902,1,1,1021,1622,601
2903,1,1,760,1495,735
2904,1,1,179,1551,1372
2905,1,1,470,1576,1106
2906,1,1,1938,1280,-658
2907,0,0,22,0,-22
2908,1,0,53,0,-53
2909,0,0,26,0,-26
2910,0,0,22,0,-22
2911,1,0,30,0,-30
2912,1,0,14,0,-14
2913,1,0,94,0,-94
2914,0,0,72,0,-72
2915,1,1,890,2056,1166
2916,0,0,11,0,-11
2917,1,0,14,0,-14
2918,1,1,525,1273,748
2919,0,0,56,0,-56
2920,1,1,243,1488,1245
2921,0,0,70,0,-70
2922,1,1,252,1342,1090
2923,1,0,27,0,-27
2924,0,0,5,0,-5
2925,1,0,16,0,-16
2926,0,0,56,0,-56
2927,0,0,52,0,-52
2928,1,0,56,0,-56
2929,1,1,35,1331,1296
2930,1,1,218,1485,1267
2931,0,0,181,0,-181
2932,0,0,207,0,-207
2933,0,0,56,0,-56
2934,0,0,13,0,-13
2935,1,1,140,1492,1352
2936,0,0,7,0,-7
2937,0,0,59,0,-59
2938,1,1,116,1630,1514
2939,1,0,44,0,-44
2940,0,0,111,0,-111
2941,1,0,1,0,-1
2942,1,0,99,0,-99
2943,0,0,5,0,-5
2944,0,0,11,0,-11
2945,0,0,142,0,-142
2946,0,0,4,0,-4
2947,0,0,0,0,0
2948,1,1,286,1311,1025
2949,0,0,80,0,-80
2950,0,0,1,0,-1
2951,1,0,66,0,-66
2952,0,0,27,0,-27
2953,1,1,222,1412,1190
2954,0,0,46,0,-46
2955,0,0,1,0,-1
2956,0,0,73,0,-73
2957,1,0,30,0,-30
2958,1,1,102,1290,1188
2959,1,0,77,0,-77
2960,1,1,323,1853,1530
2961,1,0,18,0,-18
2962,0,0,11,0,-11
2963,0,0,136,0,-136
2964,1,0,92,0,-92
2965,1,0,25,0,-25
2966,1,1,490,1252,762
2967,0,0,69,0,-69
2968,0,0,135,0,-135
2969,1,1,650,1241,591
2970,1,0,159,0,-159
2971,0,0,18,0,-18
2972,0,0,58,0,-58
2973,1,0,26,0,-26
2974,1,0,71,0,-71
2975,1,1,235,1453,1218
2976,1,0,44,0,-44
2977,1,1,296,1330,1034
2978,1,0,75,0,-75
2979,0,0,24,0,-24
2980,1,0,138,0,-138
2981,0,0,0,0,0
2982,0,0,52,0,-52
2983,0,0,3,0,-3
2984,1,0,19,0,-19
2985,1,0,25,0,-25
2986,0,0,153,0,-153
2987,1,0,29,0,-29
2988,0,0,10,0,-10
2989,1,0,26,0,-26
2990,0,0,21,0,-21
2991,0,0,1,0,-1
2992,0,0,9,0,-9
2993,0,0,80,0,-80
2994,0,0,41,0,-41
2995,1,1,229,3081,2852
2996,1,0,27,0,-27
2997,1,1,590,1653,1063
2998,1,0,83,0,-83
2999,1,1,194,2549,2355
3000,0,0,8,0,-8
3001,1,1,520,1680,1160
3002,0,0,53,0,-53
3003,1,1,300,2806,2506
3004,0,0,49,0,-49
3005,0,0,162,0,-162
3006,0,0,26,0,-26
3007,0,0,93,0,-93
3008,0,0,10,0,-10
3009,0,0,21,0,-21
3010,0,0,147,0,-147
3011,1,1,68,1242,1174
3012,0,0,20,0,-20
3013,0,0,138,0,-138
3014,1,1,156,1322,1166
3015,1,0,76,0,-76
3016,0,0,20,0,-20
3017,0,0,7,0,-7
3018,1,0,24,0,-24
3019,1,1,449,1514,1065
3020,1,0,92,0,-92
3021,1,0,34,0,-34
3022,1,1,773,1231,458
3023,0,0,48,0,-48
3024,1,1,587,1241,654
3025,0,0,156,0,-156
3026,0,0,67,0,-67
3027,0,0,21,0,-21
3028,0,0,136,0,-136
3029,0,0,30,0,-30
3030,1,1,1318,1292,-26
3031,1,1,257,1242,985
3032,1,1,516,1243,727
3033,0,0,85,0,-85
3034,1,1,133,1975,1842
3035,0,0,9,0,-9
3036,1,0,5,0,-5
3037,1,0,127,0,-127
3038,1,0,167,0,-167
3039,0,0,0,0,0
3040,0,0,5,0,-5
3041,1,1,295,1496,1201
3042,1,0,60,0,-60
3043,0,0,14,0,-14
3044,1,0,114,0,-114
3045,0,0,85,0,-85
3046,1,0,12,0,-12
3047,1,0,20,0,-20
3048,1,0,70,0,-70
3049,0,0,249,0,-249
3050,1,1,260,1246,986
3051,0,0,165,0,-165
3052,0,0,50,0,-50
3053,0,0,66,0,-66
3054,1,0,15,0,-15
3055,0,0,12,0,-12
3056,1,1,20,3779,3759
3057,0,0,35,0,-35
3058,1,1,323,2036,1713
3059,0,0,28,0,-28
3060,1,0,6,0,-6
3061,0,0,84,0,-84
3062,0,0,130,0,-130
3063,1,0,45,0,-45
3064,0,0,31,0,-31
3065,0,0,8,0,-8
3066,1,1,349,1413,1064
3067,1,1,167,1228,1061
3068,1,1,1046,1431,385
3069,1,1,201,1325,1124
3070,0,0,85,0,-85
3071,0,0,1,0,-1
3072,1,1,421,1251,830
3073,1,1,195,1327,1132
3074,1,0,45,0,-45
3075,1,1,1023,1550,527
3076,1,1,142,1370,1228
3077,0,0,4,0,-4
3078,1,0,2,0,-2
3079,1,1,571,1383,812
3080,0,0,27,0,-27
3081,0,0,126,0,-126
3082,1,0,75,0,-75
3083,1,1,578,1505,927
3084,0,0,24,0,-24
3085,0,0,12,0,-12
3086,1,1,499,1223,724
3087,0,0,9,0,-9
3088,1,0,0,0,0
3089,1,0,65,0,-65
3090,0,0,74,0,-74
3091,0,0,14,0,-14
3092,0,0,0,0,0
3093,1,1,810,2873,2063
3094,0,0,19,0,-19
3095,0,0,62,0,-62
3096,0,0,57,0,-57
3097,0,0,33,0,-33
3098,0,0,31,0,-31
3099,1,1,476,3067,2591
3100,1,1,106,1243,1137
3101,1,1,480,1227,747
3102,0,0,8,0,-8
3103,0,0,10,0,-10
3104,1,0,1,0,-1
3105,0,0,9,0,-9
3106,1,1,79,1311,1232
3107,0,0,36,0,-36
3108,1,1,164,1334,1170
3109,1,1,53,1270,1217
3110,1,1,143,1353,1210
3111,0,0,30,0,-30
3112,1,1,446,1229,783
3113,0,0,7,0,-7
3114,1,0,40,0,-40
3115,1,1,102,1324,1222
3116,1,0,31,0,-31
3117,1,1,1506,1509,3
3118,1,0,54,0,-54
3119,0,0,175,0,-175
3120,1,0,78,0,-78
3121,1,1,951,3613,2662
3122,0,0,13,0,-13
3123,0,0,93,0,-93
3124,0,0,37,0,-37
3125,1,1,1059,1297,238
3126,0,0,29,0,-29
3127,1,0,179,0,-179
3128,1,0,6,0,-6
3129,1,0,81,0,-81
3130,1,0,6,0,-6
3131,1,1,354,1443,1089
3132,0,0,1,0,-1
3133,0,0,40,0,-40
3134,1,1,257,1273,1016
3135,0,0,15,0,-15
3136,0,0,67,0,-67
3137,0,0,13,0,-13
3138,0,0,222,0,-222
3139,1,0,80,0,-80
3140,1,0,108,0,-108
3141,1,0,46,0,-46
3142,0,0,93,0,-93
3143,1,1,1381,1433,52
3144,1,1,1110,1789,679
3145,1,1,2614,1211,-1403
3146,1,0,88,0,-88
3147,0,0,12,0,-12
3148,0,0,28,0,-28
3149,0,0,10,0,-10
3150,0,0,79,0,-79
3151,0,0,23,0,-23
3152,0,0,2,0,-2
3153,1,1,483,1334,851
3154,1,0,3,0,-3
3155,0,0,12,0,-12
3156,1,0,36,0,-36
3157,1,0,11,0,-11
3158,0,0,10,0,-10
3159,0,0,40,0,-40
3160,1,1,422,1939,1517
3161,0,0,27,0,-27
3162,0,0,50,0,-50
3163,1,1,360,1467,1107
3164,1,1,203,1293,1090
3165,0,0,15,0,-15
3166,0,0,70,0,-70
3167,1,1,639,1468,829
3168,1,1,883,5562,4679
3169,1,1,180,1393,1213
3170,1,1,771,1314,543
3171,1,0,72,0,-72
3172,1,1,205,1309,1104
3173,1,1,535,2126,1591
3174,1,0,14,0,-14
3175,1,1,39,1338,1299
3176,1,1,1265,1279,14
3177,1,1,89,1619,1530
3178,1,0,67,0,-67
3179,0,0,6,0,-6
3180,1,0,5,0,-5
3181,0,0,33,0,-33
3182,1,1,702,2375,1673
3183,1,1,267,1230,963
3184,1,1,1833,1396,-437
3185,0,0,2,0,-2
3186,1,1,177,1869,1692
3187,1,0,4,0,-4
3188,1,1,411,1417,1006
3189,1,0,162,0,-162
3190,1,1,598,1877,1279
3191,1,0,27,0,-27
3192,1,0,105,0,-105
3193,1,0,50,0,-50
3194,0,0,19,0,-19
3195,1,1,410,1484,1074
3196,0,0,37,0,-37
3197,0,0,112,0,-112
3198,0,0,9,0,-9
3199,0,0,58,0,-58
3200,1,0,164,0,-164
3201,0,0,120,0,-120
3202,0,0,325,0,-325
3203,0,0,5,0,-5
3204,1,0,6,0,-6
3205,1,1,425,1233,808
3206,1,1,1024,1988,964
3207,1,0,101,0,-101
3208,0,0,10,0,-10
3209,1,1,458,1343,885
3210,1,0,48,0,-48
3211,1,0,19,0,-19
3212,0,0,131,0,-131
3213,1,0,9,0,-9
3214,0,0,137,0,-137
3215,0,0,49,0,-49
3216,1,1,344,1278,934
3217,1,1,1381,2062,681
3218,0,0,3,0,-3
3219,1,1,241,1255,1014
3220,0,0,10,0,-10
3221,1,1,820,1357,537
3222,1,0,12,0,-12
3223,1,1,97,1620,1523
3224,1,1,1006,1616,610
3225,0,0,34,0,-34
3226,1,1,579,1297,718
3227,0,0,32,0,-32
3228,1,1,1998,1311,-687
3229,1,1,287,1388,1101
3230,1,1,610,1278,668
3231,0,0,21,0,-21
3232,1,1,140,1588,1448
3233,0,0,36,0,-36
3234,1,1,146,1552,1406
3235,1,1,206,1223,1017
3236,1,1,103,1661,1558
3237,1,1,507,1345,838
3238,1,0,22,0,-22
3239,1,1,372,1295,923
3240,1,0,167,0,-167
3241,1,1,373,1447,1074
3242,0,0,49,0,-49
3243,0,0,69,0,-69
3244,0,0,47,0,-47
3245,1,0,62,0,-62
3246,0,0,3,0,-3
3247,1,0,37,0,-37
3248,0,0,86,0,-86
3249,0,0,45,0,-45
3250,1,1,76,1439,1363
3251,1,0,5,0,-5
3252,0,0,14,0,-14
3253,1,0,80,0,-80
3254,1,0,12,0,-12
3255,1,1,387,1270,883
3256,1,0,84,0,-84
3257,1,0,395,0,-395
3258,1,0,1,0,-1
3259,1,0,9,0,-9
3260,0,0,13,0,-13
3261,0,0,89,0,-89
3262,1,1,455,1733,1278
3263,0,0,18,0,-18
3264,0,0,0,0,0
3265,1,1,753,1333,580
3266,0,0,14,0,-14
3267,1,0,21,0,-21
3268,0,0,13,0,-13
3269,1,0,342,0,-342
3270,0,0,18,0,-18
3271,1,0,51,0,-51
3272,1,0,17,0,-17
3273,0,0,28,0,-28
3274,0,0,11,0,-11
3275,1,0,40,0,-40
3276,1,1,437,1206,769
3277,0,0,92,0,-92
3278,1,1,166,1774,1608
3279,1,1,511,1274,763
3280,1,1,315,1496,1181
3281,1,0,11,0,-11
3282,0,0,69,0,-69
3283,1,0,179,0,-179
3284,0,0,25,0,-25
3285,0,0,54,0,-54
3286,0,0,6,0,-6
3287,0,0,107,0,-107
3288,1,0,31,0,-31
3289,0,0,18,0,-18
3290,1,1,471,1278,807
3291,1,1,200,1336,1136
3292,0,0,4,0,-4
3293,1,1,1029,1638,609
3294,1,0,225,0,-225
3295,0,0,101,0,-101
3296,1,0,9,0,-9
3297,1,1,207,1425,1218
3298,1,1,1263,1210,-53
3299,1,0,42,0,-42
3300,0,0,73,0,-73
3301,0,0,49,0,-49
3302,1,0,146,0,-146
3303,0,0,68,0,-68
3304,1,0,26,0,-26
3305,1,1,78,1230,1152
3306,0,0,94,0,-94
3307,1,1,487,2203,1716
3308,0,0,1,0,-1
3309,1,0,71,0,-71
3310,0,0,43,0,-43
3311,1,0,13,0,-13
3312,1,0,135,0,-135
3313,1,1,278,1316,1038
3314,1,0,69,0,-69
3315,1,0,1,0,-1
3316,1,0,119,0,-119
3317,1,1,134,1204,1070
3318,1,0,13,0,-13
3319,0,0,8,0,-8
3320,1,1,79,1366,1287
3321,0,0,20,0,-20
3322,1,0,140,0,-140
3323,0,0,14,0,-14
3324,1,1,67,1490,1423
3325,1,1,1708,1239,-469
3326,1,1,853,2816,1963
3327,0,0,43,0,-43
3328,1,0,52,0,-52
3329,0,0,21,0,-21
3330,0,0,58,0,-58
3331,1,0,72,0,-72
3332,0,0,10,0,-10
3333,0,0,129,0,-129
3334,1,0,59,0,-59
3335,1,0,19,0,-19
3336,1,0,7,0,-7
3337,1,0,14,0,-14
3338,0,0,142,0,-142
3339,0,0,50,0,-50
3340,0,0,65,0,-65
3341,1,1,389,1222,833
3342,0,0,73,0,-73
3343,0,0,16,0,-16
3344,0,0,52,0,-52
3345,1,0,32,0,-32
3346,1,1,675,1303,628
3347,0,0,71,0,-71
3348,0,0,21,0,-21
3349,0,0,153,0,-153
3350,1,0,42,0,-42
3351,0,0,44,0,-44
3352,1,1,303,1201,898
3353,0,0,5,0,-5
3354,1,0,1,0,-1
3355,0,0,10,0,-10
3356,0,0,152,0,-152
3357,1,0,22,0,-22
3358,0,0,30,0,-30
3359,1,0,5,0,-5
3360,0,0,12,0,-12
3361,1,0,1,0,-1
3362,0,0,15,0,-15
3363,0,0,19,0,-19
3364,1,0,180,0,-180
3365,1,0,14,0,-14
3366,1,0,20,0,-20
3367,1,0,116,0,-116
3368,0,0,214,0,-214
3369,1,0,51,0,-51
3370,1,0,3,0,-3
3371,1,1,514,1324,810
3372,1,0,160,0,-160
3373,0,0,43,0,-43
3374,1,0,42,0,-42
3375,0,0,41,0,-41
3376,0,0,83,0,-83
3377,1,1,186,1224,1038
3378,1,1,186,1981,1795
3379,1,1,79,1572,1493
3380,1,1,150,1542,1392
3381,1,1,261,1300,1039
3382,0,0,105,0,-105
3383,1,1,1219,1536,317
3384,1,1,1353,1347,-6
3385,1,0,88,0,-88
3386,1,0,1,0,-1
3387,1,1,682,1945,1263
3388,1,1,363,1531,1168
3389,1,0,23,0,-23
3390,0,0,42,0,-42
3391,1,0,11,0,-11
3392,0,0,25,0,-25
3393,1,0,19,0,-19
3394,1,0,23,0,-23
3395,0,0,65,0,-65
3396,1,1,1273,1679,406
3397,1,0,0,0,0
3398,0,0,31,0,-31
3399,0,0,34,0,-34
3400,1,0,30,0,-30
3401,1,1,670,1486,816
3402,1,1,548,1203,655
3403,0,0,37,0,-37
3404,1,1,92,1410,1318
3405,1,0,65,0,-65
3406,0,0,3,0,-3
3407,0,0,289,0,-289
3408,1,1,389,1489,1100
3409,1,1,627,1317,690
3410,1,0,352,0,-352
3411,1,0,54,0,-54
3412,1,0,8,0,-8
3413,1,1,31,1422,1391
3414,0,0,37,0,-37
3415,0,0,36,0,-36
3416,1,0,24,0,-24
3417,1,1,223,1729,1506
3418,1,0,92,0,-92
3419,1,1,150,1215,1065
3420,0,0,3,0,-3
3421,1,1,208,1496,1288
3422,1,0,5,0,-5
3423,0,0,162,0,-162
3424,0,0,36,0,-36
3425,0,0,71,0,-71
3426,0,0,78,0,-78
3427,1,0,38,0,-38
3428,1,0,136,0,-136
3429,1,0,21,0,-21
3430,0,0,93,0,-93
3431,0,0,7,0,-7
3432,0,0,63,0,-63
3433,1,1,345,1652,1307
3434,0,0,7,0,-7
3435,1,1,785,2528,1743
3436,0,0,42,0,-42
3437,1,1,321,1244,923
3438,0,0,42,0,-42
3439,0,0,42,0,-42
3440,1,0,21,0,-21
3441,1,0,18,0,-18
3442,1,1,14,2870,2856
3443,1,1,56,1292,1236
3444,1,0,12,0,-12
3445,1,1,608,1250,642
3446,0,0,17,0,-17
3447,1,0,287,0,-287
3448,0,0,83,0,-83
3449,1,0,33,0,-33
3450,0,0,6,0,-6
3451,1,0,160,0,-160
3452,0,0,177,0,-177
3453,1,1,471,1337,866
3454,1,0,20,0,-20
3455,1,1,208,1254,1046
3456,1,0,10,0,-10
3457,0,0,40,0,-40
3458,0,0,26,0,-26
3459,1,1,1231,1653,422
3460,1,0,39,0,-39
3461,0,0,35,0,-35
3462,0,0,87,0,-87
3463,1,0,14,0,-14
3464,0,0,70,0,-70
3465,0,0,3,0,-3
3466,1,0,65,0,-65
3467,0,0,43,0,-43
3468,1,1,632,1388,756
3469,1,1,386,1253,867
3470,0,0,232,0,-232
3471,1,1,337,1350,1013
3472,0,0,3,0,-3
3473,1,1,325,1524,1199
3474,1,1,23,1502,1479
3475,1,1,49,1396,1347
3476,0,0,54,0,-54
3477,0,0,36,0,-36
3478,1,1,958,1216,258
3479,1,1,17,1506,1489
3480,0,0,100,0,-100
3481,1,0,3,0,-3
3482,1,1,79,1817,1738
3483,1,0,7,0,-7
3484,1,1,506,2646,2140
3485,1,1,16,1393,1377
3486,0,0,19,0,-19
3487,1,0,22,0,-22
3488,1,0,32,0,-32
3489,1,0,37,0,-37
3490,0,0,35,0,-35
3491,0,0,58,0,-58
3492,0,0,29,0,-29
3493,1,0,62,0,-62
3494,0,0,6,0,-6
3495,1,0,12,0,-12
3496,0,0,6,0,-6
3497,1,1,183,1252,1069
3498,1,1,97,1344,1247
3499,0,0,191,0,-191
3500,1,1,777,1786,1009
3501,1,0,55,0,-55
3502,0,0,49,0,-49
3503,1,1,557,2041,1484
3504,0,0,61,0,-61
3505,0,0,22,0,-22
3506,0,0,11,0,-11
3507,1,0,55,0,-55
3508,0,0,58,0,-58
3509,0,0,4,0,-4
3510,1,1,216,1283,1067
3511,1,0,6,0,-6
3512,0,0,6,0,-6
3513,1,0,40,0,-40
3514,1,1,488,1235,747
3515,1,0,0,0,0
3516,0,0,5,0,-5
3517,1,0,38,0,-38
3518,0,0,60,0,-60
3519,1,1,911,1755,844
3520,0,0,31,0,-31
3521,1,0,38,0,-38
3522,1,1,439,1457,1018
3523,1,1,2159,1585,-574
3524,0,0,3,0,-3
3525,1,0,111,0,-111
3526,1,1,991,1375,384
3527,1,0,44,0,-44
3528,0,0,9,0,-9
3529,1,0,6,0,-6
3530,1,0,21,0,-21
3531,0,0,16,0,-16
3532,1,0,101,0,-101
3533,0,0,35,0,-35
3534,0,0,15,0,-15
3535,0,0,5,0,-5
3536,0,0,13,0,-13
3537,1,0,83,0,-83
3538,0,0,16,0,-16
3539,1,1,1072,2695,1623
3540,1,0,15,0,-15
3541,0,0,5,0,-5
3542,0,0,24,0,-24
3543,1,0,25,0,-25
3544,1,0,9,0,-9
3545,0,0,38,0,-38
3546,1,1,275,1321,1046
3547,1,1,1184,1352,168
3548,1,1,959,1440,481
3549,1,1,297,1303,1006
3550,1,0,48,0,-48
3551,0,0,126,0,-126
3552,1,0,133,0,-133
3553,0,0,13,0,-13
3554,1,1,121,1223,1102
3555,1,0,82,0,-82
3556,1,0,44,0,-44
3557,0,0,26,0,-26
3558,0,0,16,0,-16
3559,1,0,57,0,-57
3560,1,1,129,1553,1424
3561,0,0,53,0,-53
3562,1,0,91,0,-91
3563,0,0,16,0,-16
3564,0,0,0,0,0
3565,1,1,1226,1845,619
3566,1,0,77,0,-77
3567,0,0,53,0,-53
3568,0,0,74,0,-74
3569,1,0,49,0,-49
3570,0,0,76,0,-76
3571,1,1,67,1249,1182
3572,0,0,13,0,-13
3573,1,1,1227,1495,268
3574,0,0,67,0,-67
3575,0,0,22,0,-22
3576,1,0,62,0,-62
3577,1,0,23,0,-23
3578,0,0,7,0,-7
3579,1,0,17,0,-17
3580,0,0,8,0,-8
3581,1,0,186,0,-186
3582,1,1,485,1885,1400
3583,0,0,18,0,-18
3584,1,0,17,0,-17
3585,1,1,39,1512,1473
3586,1,1,789,1288,499
3587,1,1,97,1953,1856
3588,0,0,81,0,-81
3589,1,1,236,1262,1026
3590,0,0,2,0,-2
3591,0,0,33,0,-33
3592,0,0,8,0,-8
3593,0,0,5,0,-5
3594,0,0,176,0,-176
3595,0,0,138,0,-138
3596,1,1,880,1209,329
3597,0,0,46,0,-46
3598,1,0,50,0,-50
3599,1,0,15,0,-15
3600,1,0,52,0,-52
3601,1,1,622,1742,1120
3602,1,0,13,0,-13
3603,0,0,22,0,-22
3604,1,1,81,1244,1163
3605,1,0,10,0,-10
3606,1,0,34,0,-34
3607,0,0,53,0,-53
3608,1,0,0,0,0
3609,1,0,17,0,-17
3610,1,0,1,0,-1
3611,0,0,25,0,-25
3612,1,1,598,1270,672
3613,0,0,120,0,-120
3614,0,0,69,0,-69
3615,0,0,59,0,-59
3616,1,0,49,0,-49
3617,1,0,74,0,-74
3618,1,1,49,1255,1206
3619,0,0,52,0,-52
3620,1,0,120,0,-120
3621,1,1,284,1519,1235
3622,0,0,12,0,-12
3623,1,0,17,0,-17
3624,1,1,216,1296,1080
3625,1,0,8,0,-8
3626,0,0,15,0,-15
3627,0,0,6,0,-6
3628,1,0,17,0,-17
3629,1,1,1442,1423,-19
3630,0,0,9,0,-9
3631,0,0,75,0,-75
3632,1,1,486,1806,1320
3633,1,0,6,0,-6
3634,1,1,217,3851,3634
3635,1,0,54,0,-54
3636,0,0,6,0,-6
3637,0,0,11,0,-11
3638,1,1,905,1671,766
3639,1,0,29,0,-29
3640,0,0,7,0,-7
3641,1,1,493,1240,747
3642,0,0,2,0,-2
3643,1,1,122,1557,1435
3644,1,0,22,0,-22
3645,0,0,26,0,-26
3646,1,1,270,1481,1211
3647,0,0,32,0,-32
3648,1,1,66,1454,1388
3649,1,0,40,0,-40
3650,0,0,9,0,-9
3651,1,1,1074,1508,434
3652,1,0,56,0,-56
3653,1,0,175,0,-175
3654,0,0,68,0,-68
3655,1,0,229,0,-229
3656,1,0,27,0,-27
3657,1,1,31,1215,1184
3658,0,0,66,0,-66
3659,0,0,65,0,-65
3660,0,0,210,0,-210
3661,1,0,23,0,-23
3662,1,0,178,0,-178
3663,0,0,16,0,-16
3664,1,1,147,1500,1353
3665,1,0,26,0,-26
3666,1,0,19,0,-19
3667,1,0,3,0,-3
3668,0,0,3,0,-3
3669,0,0,20,0,-20
3670,0,0,12,0,-12
3671,1,1,165,1850,1685
3672,0,0,45,0,-45
3673,1,0,27,0,-27
3674,1,1,183,1217,1034
3675,1,1,102,1865,1763
3676,1,1,502,1215,713
3677,1,1,137,1600,1463
3678,1,1,988,2824,1836
3679,0,0,103,0,-103
3680,1,1,359,1453,1094
3681,0,0,1,0,-1
3682,0,0,41,0,-41
3683,1,0,88,0,-88
3684,1,0,85,0,-85
3685,1,1,731,1321,590
3686,0,0,179,0,-179
3687,0,0,14,0,-14
3688,1,1,76,1695,1619
3689,0,0,43,0,-43
3690,0,0,6,0,-6
3691,0,0,38,0,-38
3692,1,1,503,1264,761
3693,1,0,24,0,-24
3694,1,1,107,1989,1882
3695,1,1,1051,2062,1011
3696,1,1,487,1209,722
3697,1,1,220,2529,2309
3698,1,0,18,0,-18
3699,0,0,24,0,-24
3700,0,0,31,0,-31
3701,1,1,1153,1227,74
3702,1,1,216,1202,986
3703,1,1,759,2650,1891
3704,0,0,55,0,-55
3705,0,0,8,0,-8
3706,1,0,2,0,-2
3707,1,1,62,1356,1294
3708,0,0,42,0,-42
3709,0,0,94,0,-94
3710,1,1,247,1416,1169
3711,1,1,539,1229,690
3712,0,0,81,0,-81
3713,1,0,78,0,-78
3714,0,0,96,0,-96
3715,1,0,9,0,-9
3716,1,0,66,0,-66
3717,0,0,2,0,-2
3718,1,0,33,0,-33
3719,0,0,30,0,-30
3720,0,0,16,0,-16
3721,1,0,10,0,-10
3722,0,0,14,0,-14
3723,0,0,90,0,-90
3724,1,0,206,0,-206
3725,1,1,29,1403,1374
3726,1,1,331,1208,877
3727,1,0,52,0,-52
3728,1,0,8,0,-8
3729,1,0,71,0,-71
3730,1,1,176,6568,6392
3731,1,0,11,0,-11
3732,0,0,119,0,-119
3733,0,0,8,0,-8
3734,0,0,50,0,-50
3735,1,1,102,1325,1223
3736,1,0,116,0,-116
3737,0,0,43,0,-43
3738,0,0,63,0,-63
3739,1,0,40,0,-40
3740,0,0,10,0,-10
3741,0,0,8,0,-8
3742,1,0,23,0,-23
3743,1,0,30,0,-30
3744,1,0,85,0,-85
3745,1,0,78,0,-78
3746,0,0,42,0,-42
3747,1,1,1898,1452,-446
3748,0,0,25,0,-25
3749,0,0,80,0,-80
3750,1,0,9,0,-9
3751,1,0,18,0,-18
3752,1,0,53,0,-53
3753,1,0,39,0,-39
3754,1,1,411,1872,1461
3755,1,0,133,0,-133
3756,1,0,336,0,-336
3757,0,0,11,0,-11
3758,0,0,25,0,-25
3759,0,0,42,0,-42
3760,0,0,77,0,-77
3761,1,0,3,0,-3
3762,1,1,262,1291,1029
3763,0,0,53,0,-53
3764,1,0,60,0,-60
3765,0,0,34,0,-34
3766,1,0,16,0,-16
3767,0,0,9,0,-9
3768,0,0,19,0,-19
3769,1,0,30,0,-30
3770,0,0,51,0,-51
3771,1,0,21,0,-21
3772,1,0,0,0,0
3773,0,0,9,0,-9
3774,0,0,59,0,-59
3775,0,0,23,0,-23
3776,0,0,32,0,-32
3777,1,0,28,0,-28
3778,1,0,0,0,0
3779,0,0,0,0,0
3780,1,0,23,0,-23
3781,0,0,102,0,-102
3782,1,0,423,0,-423
3783,0,0,3,0,-3
3784,0,0,43,0,-43
3785,0,0,67,0,-67
3786,1,0,45,0,-45
3787,1,1,20,1583,1563
3788,1,1,190,1564,1374
3789,0,0,149,0,-149
3790,0,0,27,0,-27
3791,1,1,62,1981,1919
3792,1,1,185,1239,1054
3793,1,1,29,1271,1242
3794,1,1,128,1403,1275
3795,1,0,8,0,-8
3796,1,1,616,1747,1131
3797,1,1,686,1242,556
3798,0,0,2,0,-2
3799,1,0,52,0,-52
3800,1,1,642,2122,1480
3801,1,1,639,1380,741
3802,1,0,14,0,-14
3803,0,0,25,0,-25
3804,1,0,205,0,-205
3805,0,0,77,0,-77
3806,1,1,527,1696,1169
3807,1,0,46,0,-46
3808,1,0,72,0,-72
3809,1,0,17,0,-17
3810,1,0,14,0,-14
3811,0,0,59,0,-59
3812,0,0,6,0,-6
3813,0,0,26,0,-26
3814,0,0,32,0,-32
3815,1,0,65,0,-65
3816,1,0,107,0,-107
3817,1,1,1315,2080,765
3818,0,0,123,0,-123
3819,1,0,75,0,-75
3820,1,0,26,0,-26
3821,1,1,667,1480,813
3822,0,0,125,0,-125
3823,1,1,123,1391,1268
3824,1,0,13,0,-13
3825,0,0,56,0,-56
3826,1,1,151,3708,3557
3827,0,0,33,0,-33
3828,1,0,40,0,-40
3829,0,0,60,0,-60
3830,0,0,80,0,-80
3831,1,0,8,0,-8
3832,1,1,548,1434,886
3833,1,0,60,0,-60
3834,0,0,3,0,-3
3835,1,0,39,0,-39
3836,0,0,82,0,-82
3837,1,0,2,0,-2
3838,0,0,71,0,-71
3839,0,0,36,0,-36
3840,1,1,1131,1312,181
3841,0,0,21,0,-21
3842,1,0,20,0,-20
3843,0,0,32,0,-32
3844,1,0,3,0,-3
3845,1,0,12,0,-12
3846,1,1,722,1522,800
3847,1,0,81,0,-81
3848,1,0,51,0,-51
3849,0,0,5,0,-5
3850,1,1,205,1293,1088
3851,1,1,1051,2167,1116
3852,1,0,38,0,-38
3853,1,0,12,0,-12
3854,1,0,41,0,-41
3855,0,0,26,0,-26
3856,1,0,13,0,-13
3857,1,1,622,1294,672
3858,0,0,123,0,-123
3859,1,0,72,0,-72
3860,1,0,15,0,-15
3861,1,1,398,3134,2736
3862,1,0,3,0,-3
3863,1,1,953,1489,536
3864,0,0,38,0,-38
3865,0,0,194,0,-194
3866,0,0,2,0,-2
3867,0,0,9,0,-9
3868,1,0,96,0,-96
3869,1,0,58,0,-58
3870,1,0,12,0,-12
3871,0,0,134,0,-134
3872,1,1,350,1375,1025
3873,1,1,1825,1984,159
3874,0,0,79,0,-79
3875,0,0,306,0,-306
3876,0,0,15,0,-15
3877,0,0,36,0,-36
3878,1,0,7,0,-7
3879,1,1,461,1363,902
3880,0,0,8,0,-8
3881,1,1,81,1241,1160
3882,1,0,59,0,-59
3883,1,1,343,2291,1948
3884,0,0,12,0,-12
3885,1,0,61,0,-61
3886,1,0,56,0,-56
3887,1,0,81,0,-81
3888,1,1,230,1606,1376
3889,0,0,10,0,-10
3890,0,0,4,0,-4
3891,0,0,101,0,-101
3892,0,0,7,0,-7
3893,0,0,77,0,-77
3894,1,0,140,0,-140
3895,0,0,36,0,-36
3896,1,1,1329,1260,-69
3897,1,0,59,0,-59
3898,0,0,5,0,-5
3899,1,0,5,0,-5
3900,1,1,1486,2214,728
3901,1,1,110,1223,1113
3902,1,1,1010,1524,514
3903,1,1,618,1223,605
3904,1,0,163,0,-163
3905,1,0,45,0,-45
3906,0,0,4,0,-4
3907,0,0,154,0,-154
3908,1,0,0,0,0
3909,1,1,896,1540,644
3910,1,1,23,2717,2694
3911,0,0,104,0,-104
3912,0,0,74,0,-74
3913,0,0,69,0,-69
3914,1,1,139,4856,4717
3915,1,1,272,4984,4712
3916,1,0,41,0,-41
3917,1,1,117,2816,2699
3918,0,0,63,0,-63
3919,0,0,28,0,-28
3920,1,0,53,0,-53
3921,0,0,45,0,-45
3922,1,1,423,1263,840
3923,0,0,15,0,-15
3924,1,0,15,0,-15
3925,1,1,501,2331,1830
3926,1,0,29,0,-29
3927,0,0,32,0,-32
3928,0,0,44,0,-44
3929,1,1,261,1512,1251
3930,0,0,4,0,-4
3931,1,0,81,0,-81
3932,1,1,759,1877,1118
3933,1,1,281,1202,921
3934,0,0,116,0,-116
3935,1,0,48,0,-48
3936,1,1,323,1428,1105
3937,1,1,169,1337,1168
3938,1,0,50,0,-50
3939,1,0,113,0,-113
3940,1,0,59,0,-59
3941,1,0,33,0,-33
3942,1,0,93,0,-93
3943,1,1,1037,1520,483
3944,1,1,577,1254,677
3945,1,1,112,1381,1269
3946,0,0,18,0,-18
3947,0,0,70,0,-70
3948,1,0,20,0,-20
3949,0,0,1,0,-1
3950,0,0,66,0,-66
3951,1,1,306,1305,999
3952,1,0,74,0,-74
3953,0,0,199,0,-199
3954,1,1,1321,1296,-25
3955,1,1,1166,2429,1263
3956,1,0,87,0,-87
3957,0,0,40,0,-40
3958,0,0,44,0,-44
3959,0,0,83,0,-83
3960,1,1,640,1688,1048
3961,0,0,11,0,-11
3962,1,0,15,0,-15
3963,1,1,173,1664,1491
3964,1,0,40,0,-40
3965,1,1,738,1730,992
3966,0,0,103,0,-103
3967,1,0,18,0,-18
3968,0,0,61,0,-61
3969,0,0,51,0,-51
3970,1,0,91,0,-91
3971,0,0,8,0,-8
3972,1,0,32,0,-32
3973,1,0,76,0,-76
3974,0,0,34,0,-34
3975,0,0,176,0,-176
3976,1,1,439,1647,1208
3977,1,0,60,0,-60
3978,1,0,1,0,-1
3979,0,0,39,0,-39
3980,1,1,461,1365,904
3981,1,1,503,2152,1649
3982,0,0,67,0,-67
3983,1,0,91,0,-91
3984,1,1,384,2706,2322
3985,0,0,37,0,-37
3986,0,0,43,0,-43
3987,1,1,186,1615,1429
3988,0,0,93,0,-93
3989,1,0,93,0,-93
3990,1,0,1,0,-1
3991,1,0,8,0,-8
3992,0,0,14,0,-14
3993,1,1,551,1245,694
3994,1,1,98,2077,1979
3995,1,0,56,0,-56
3996,1,0,48,0,-48
3997,1,1,224,1298,1074
3998,0,0,17,0,-17
3999,1,0,20,0,-20
4000,1,0,39,0,-39
4001,1,1,329,1367,1038
4002,0,0,0,0,0
4003,0,0,75,0,-75
4004,1,0,53,0,-53
4005,1,0,16,0,-16
4006,1,1,682,1205,523
4007,1,0,116,0,-116
4008,1,1,481,1239,758
4009,0,0,105,0,-105
4010,1,0,12,0,-12
4011,0,0,48,0,-48
4012,1,0,19,0,-19
4013,1,0,13,0,-13
4014,0,0,2,0,-2
4015,1,1,3,1878,1875
4016,1,0,22,0,-22
4017,0,0,157,0,-157
4018,0,0,236,0,-236
4019,0,0,69,0,-69
4020,1,1,243,1644,1401
4021,1,0,87,0,-87
4022,1,0,5,0,-5
4023,0,0,66,0,-66
4024,0,0,17,0,-17
4025,1,0,187,0,-187
4026,1,0,1,0,-1
4027,1,0,29,0,-29
4028,1,1,149,1316,1167
4029,1,0,20,0,-20
4030,1,1,1044,1821,777
4031,0,0,19,0,-19
4032,1,0,26,0,-26
4033,1,1,169,1873,1704
4034,0,0,145,0,-145
4035,0,0,102,0,-102
4036,1,1,206,1368,1162
4037,1,1,216,1965,1749
4038,1,0,124,0,-124
4039,1,0,11,0,-11
4040,0,0,89,0,-89
4041,1,1,634,1251,617
4042,0,0,11,0,-11
4043,0,0,32,0,-32
4044,0,0,80,0,-80
4045,0,0,39,0,-39
4046,1,1,1039,1212,173
4047,1,0,53,0,-53
4048,1,1,1065,1505,440
4049,0,0,44,0,-44
4050,1,1,935,1315,380
4051,1,0,16,0,-16
4052,0,0,13,0,-13
4053,1,0,71,0,-71
4054,0,0,70,0,-70
4055,1,0,22,0,-22
4056,0,0,45,0,-45
4057,1,0,38,0,-38
4058,0,0,133,0,-133
4059,0,0,67,0,-67
4060,0,0,104,0,-104
4061,0,0,2,0,-2
4062,1,1,206,1294,1088
4063,1,1,357,1291,934
4064,1,1,152,1533,1381
4065,0,0,90,0,-90
4066,1,0,37,0,-37
4067,1,1,83,1698,1615
4068,0,0,33,0,-33
4069,1,1,180,1396,1216
4070,0,0,120,0,-120
4071,1,0,15,0,-15
4072,0,0,73,0,-73
4073,1,0,31,0,-31
4074,0,0,146,0,-146
4075,1,1,750,1404,654
4076,1,1,278,1225,947
4077,0,0,13,0,-13
4078,1,0,94,0,-94
4079,1,1,917,1406,489
4080,1,0,52,0,-52
4081,1,1,721,1477,756
4082,1,1,91,1505,1414
4083,1,0,38,0,-38
4084,0,0,46,0,-46
4085,0,0,114,0,-114
4086,0,0,5,0,-5
4087,0,0,149,0,-149
4088,0,0,121,0,-121
4089,1,1,172,1204,1032
4090,0,0,29,0,-29
4091,1,0,13,0,-13
4092,1,0,12,0,-12
4093,0,0,20,0,-20
4094,0,0,97,0,-97
4095,1,0,20,0,-20
4096,1,1,192,1716,1524
4097,0,0,42,0,-42
4098,0,0,4,0,-4
4099,0,0,116,0,-116
4100,0,0,37,0,-37
4101,1,1,122,1561,1439
4102,0,0,107,0,-107
4103,1,1,1046,1567,521
4104,0,0,55,0,-55
4105,1,0,171,0,-171
4106,0,0,3,0,-3
4107,0,0,122,0,-122
4108,0,0,23,0,-23
4109,1,1,400,2001,1601
4110,1,0,37,0,-37
4111,1,0,71,0,-71
4112,0,0,30,0,-30
4113,1,0,84,0,-84
4114,1,1,40,1876,1836
4115,0,0,8,0,-8
4116,0,0,181,0,-181
4117,0,0,14,0,-14
4118,0,0,173,0,-173
4119,1,0,21,0,-21
4120,1,1,454,1282,828
4121,0,0,39,0,-39
4122,0,0,13,0,-13
4123,0,0,77,0,-77
4124,0,0,82,0,-82
4125,1,1,153,1505,1352
4126,0,0,6,0,-6
4127,1,0,224,0,-224
4128,1,0,80,0,-80
4129,0,0,2,0,-2
4130,0,0,93,0,-93
4131,0,0,221,0,-221
4132,0,0,71,0,-71
4133,0,0,85,0,-85
4134,1,0,133,0,-133
4135,1,0,1,0,-1
4136,1,0,3,0,-3
4137,0,0,54,0,-54
4138,0,0,12,0,-12
4139,1,1,614,1633,1019
4140,0,0,27,0,-27
4141,1,0,58,0,-58
4142,0,0,5,0,-5
4143,1,1,1081,1240,159
4144,0,0,15,0,-15
4145,0,0,82,0,-82
4146,0,0,100,0,-100
4147,1,0,33,0,-33
4148,0,0,0,0,0
4149,1,0,5,0,-5
4150,1,1,527,1662,1135
4151,1,0,51,0,-51
4152,1,0,41,0,-41
4153,0,0,28,0,-28
4154,1,0,132,0,-132
4155,0,0,17,0,-17
4156,1,1,200,1483,1283
4157,1,0,156,0,-156
4158,0,0,56,0,-56
4159,1,1,363,1671,1308
4160,1,1,585,1291,706
4161,0,0,129,0,-129
4162,0,0,58,0,-58
4163,1,1,88,1955,1867
4164,1,0,33,0,-33
4165,1,1,457,1333,876
4166,0,0,66,0,-66
4167,0,0,24,0,-24
4168,1,0,28,0,-28
4169,1,1,1451,2575,1124
4170,1,0,0,0,0
4171,1,0,80,0,-80
4172,0,0,75,0,-75
4173,1,0,47,0,-47
4174,1,0,3,0,-3
4175,1,1,853,1716,863
4176,0,0,7,0,-7
4177,1,1,300,2666,2366
4178,1,1,390,1359,969
4179,1,0,15,0,-15
4180,0,0,19,0,-19
4181,1,1,115,1654,1539
4182,0,0,61,0,-61
4183,1,0,99,0,-99
4184,1,1,781,1523,742
4185,0,0,48,0,-48
4186,1,1,52,1448,1396
4187,1,1,1012,1224,212
4188,1,0,133,0,-133
4189,1,0,81,0,-81
4190,0,0,0,0,0
4191,0,0,70,0,-70
4192,1,0,109,0,-109
4193,0,0,84,0,-84
4194,0,0,35,0,-35
4195,1,1,146,1237,1091
4196,0,0,69,0,-69
4197,1,1,645,1897,1252
4198,0,0,4,0,-4
4199,0,0,31,0,-31
4200,1,0,99,0,-99
4201,0,0,141,0,-141
4202,0,0,32,0,-32
4203,1,1,218,3358,3140
4204,1,0,8,0,-8
4205,0,0,2,0,-2
4206,0,0,46,0,-46
4207,1,0,9,0,-9
4208,1,0,48,0,-48
4209,1,0,4,0,-4
4210,0,0,139,0,-139
4211,1,0,50,0,-50
4212,1,0,28,0,-28
4213,0,0,73,0,-73
4214,0,0,23,0,-23
4215,0,0,4,0,-4
4216,1,1,862,1253,391
4217,1,0,29,0,-29
4218,1,1,208,1304,1096
4219,1,0,12,0,-12
4220,0,0,21,0,-21
4221,1,0,52,0,-52
4222,1,0,117,0,-117
4223,1,0,12,0,-12
4224,1,1,302,1200,898
4225,1,0,5,0,-5
4226,0,0,20,0,-20
4227,1,0,50,0,-50
4228,1,1,784,1478,694
4229,0,0,23,0,-23
4230,0,0,127,0,-127
4231,1,0,52,0,-52
4232,0,0,12,0,-12
4233,1,1,409,1792,1383
4234,1,1,910,4556,3646
4235,0,0,68,0,-68
4236,0,0,43,0,-43
4237,0,0,33,0,-33
4238,1,0,96,0,-96
4239,1,0,14,0,-14
4240,1,0,6,0,-6
4241,0,0,228,0,-228
4242,1,0,35,0,-35
4243,0,0,24,0,-24
4244,0,0,19,0,-19
4245,1,0,14,0,-14
4246,1,1,219,1323,1104
4247,1,0,18,0,-18
4248,1,1,78,1375,1297
4249,1,0,34,0,-34
4250,0,0,2,0,-2
4251,1,1,708,1401,693
4252,0,0,6,0,-6
4253,1,1,704,2379,1675
4254,0,0,2,0,-2
4255,1,1,944,1605,661
4256,0,0,17,0,-17
4257,0,0,75,0,-75
4258,0,0,35,0,-35
4259,1,1,512,1240,728
4260,1,0,92,0,-92
4261,1,0,47,0,-47
4262,1,0,192,0,-192
4263,1,1,775,2470,1695
4264,1,0,49,0,-49
4265,0,0,8,0,-8
4266,0,0,18,0,-18
4267,0,0,224,0,-224
4268,0,0,33,0,-33
4269,1,1,309,1305,996
4270,1,1,910,2348,1438
4271,1,0,87,0,-87
4272,1,1,232,2192,1960
4273,0,0,12,0,-12
4274,1,0,42,0,-42
4275,1,0,44,0,-44
4276,0,0,50,0,-50
4277,0,0,26,0,-26
4278,1,0,4,0,-4
4279,0,0,4,0,-4
4280,1,0,25,0,-25
4281,1,0,245,0,-245
4282,0,0,40,0,-40
4283,1,1,218,1233,1015
4284,1,1,150,1770,1620
4285,1,0,2,0,-2
4286,1,1,384,1222,838
4287,1,1,64,1374,1310
4288,0,0,6,0,-6
4289,1,1,446,1426,980
4290,0,0,53,0,-53
4291,1,1,498,1256,758
4292,0,0,47,0,-47
4293,1,1,292,1370,1078
4294,0,0,114,0,-114
4295,1,1,323,1262,939
4296,0,0,82,0,-82
4297,0,0,38,0,-38
4298,1,0,29,0,-29
4299,1,1,784,2181,1397
4300,0,0,75,0,-75
4301,0,0,55,0,-55
4302,1,0,34,0,-34
4303,1,1,259,1559,1300
4304,1,0,10,0,-10
4305,0,0,109,0,-109
4306,0,0,20,0,-20
4307,1,0,16,0,-16
4308,0,0,11,0,-11
4309,0,0,48,0,-48
4310,0,0,9,0,-9
4311,0,0,46,0,-46
4312,1,1,211,1322,1111
4313,1,0,181,0,-181
4314,1,1,59,1347,1288
4315,0,0,64,0,-64
4316,1,0,235,0,-235
4317,0,0,120,0,-120
4318,0,0,210,0,-210
4319,1,0,9,0,-9
4320,1,0,34,0,-34
4321,1,1,829,1431,602
4322,0,0,113,0,-113
4323,1,0,1,0,-1
4324,1,1,311,1362,1051
4325,1,0,162,0,-162
4326,0,0,1,0,-1
4327,0,0,1,0,-1
4328,1,1,78,2411,2333
4329,1,1,101,1218,1117
4330,1,0,149,0,-149
4331,0,0,0,0,0
4332,1,0,54,0,-54
4333,1,0,30,0,-30
4334,0,0,50,0,-50
4335,0,0,1,0,-1
4336,0,0,27,0,-27
4337,1,0,5,0,-5
4338,0,0,44,0,-44
4339,0,0,58,0,-58
4340,0,0,89,0,-89
4341,1,0,40,0,-40
4342,0,0,28,0,-28
4343,0,0,13,0,-13
4344,0,0,8,0,-8
4345,1,0,76,0,-76
4346,0,0,89,0,-89
4347,1,0,52,0,-52
4348,1,1,295,1256,961
4349,1,0,33,0,-33
4350,0,0,64,0,-64
4351,0,0,7,0,-7
4352,0,0,32,0,-32
4353,1,0,15,0,-15
4354,1,1,3212,1697,-1515
4355,0,0,68,0,-68
4356,1,1,18,1935,1917
4357,0,0,24,0,-24
4358,1,1,332,1360,1028
4359,1,1,1620,1371,-249
4360,0,0,62,0,-62
4361,1,0,97,0,-97
4362,1,0,31,0,-31
4363,1,1,313,1623,1310
4364,0,0,7,0,-7
4365,0,0,96,0,-96
4366,1,0,18,0,-18
4367,1,1,329,1422,1093
4368,0,0,11,0,-11
4369,0,0,27,0,-27
4370,1,1,383,1306,923
4371,1,0,12,0,-12
4372,0,0,21,0,-21
4373,0,0,69,0,-69
4374,0,0,97,0,-97
4375,1,0,29,0,-29
4376,0,0,102,0,-102
4377,0,0,137,0,-137
4378,0,0,15,0,-15
4379,0,0,0,0,0
4380,0,0,41,0,-41
4381,1,0,39,0,-39
4382,1,0,61,0,-61
4383,1,1,1295,1411,116
4384,0,0,55,0,-55
4385,0,0,2,0,-2
4386,1,0,32,0,-32
4387,1,0,1,0,-1
4388,1,0,49,0,-49
4389,0,0,44,0,-44
4390,1,0,62,0,-62
4391,0,0,28,0,-28
4392,1,1,681,1204,523
4393,1,0,27,0,-27
4394,1,1,1478,1226,-252
4395,1,0,30,0,-30
4396,1,0,1,0,-1
4397,1,1,236,1626,1390
4398,0,0,3,0,-3
4399,0,0,25,0,-25
4400,1,0,64,0,-64
4401,1,0,94,0,-94
4402,1,0,14,0,-14
4403,1,1,572,1414,842
4404,0,0,148,0,-148
4405,0,0,46,0,-46
4406,0,0,43,0,-43
4407,1,1,346,1471,1125
4408,1,1,61,1242,1181
4409,1,1,241,1203,962
4410,0,0,14,0,-14
4411,0,0,14,0,-14
4412,0,0,14,0,-14
4413,1,0,25,0,-25
4414,0,0,44,0,-44
4415,1,0,77,0,-77
4416,0,0,15,0,-15
4417,0,0,116,0,-116
4418,0,0,2,0,-2
4419,0,0,120,0,-120
4420,1,1,158,1256,1098
4421,0,0,11,0,-11
4422,1,0,51,0,-51
4423,0,0,8,0,-8
4424,1,0,16,0,-16
4425,1,0,33,0,-33
4426,0,0,2,0,-2
4427,0,0,18,0,-18
4428,0,0,21,0,-21
4429,0,0,65,0,-65
4430,1,1,281,1446,1165
4431,1,1,131,1398,1267
4432,1,0,13,0,-13
4433,1,1,312,1825,1513
4434,0,0,94,0,-94
4435,0,0,4,0,-4
4436,0,0,11,0,-11
4437,1,0,91,0,-91
4438,0,0,158,0,-158
4439,1,1,187,1270,1083
4440,1,0,22,0,-22
4441,0,0,8,0,-8
4442,1,0,202,0,-202
4443,0,0,80,0,-80
4444,1,0,25,0,-25
4445,0,0,71,0,-71
4446,0,0,27,0,-27
4447,1,1,1686,1343,-343
4448,1,0,46,0,-46
4449,1,1,93,4399,4306
4450,0,0,17,0,-17
4451,1,0,47,0,-47
4452,1,1,615,1211,596
4453,1,0,40,0,-40
4454,0,0,2,0,-2
4455,1,0,10,0,-10
4456,0,0,89,0,-89
4457,1,1,670,1632,962
4458,0,0,38,0,-38
4459,1,1,125,1714,1589
4460,0,0,17,0,-17
4461,1,1,174,1209,1035
4462,1,0,65,0,-65
4463,1,1,522,1504,982
4464,1,1,144,1465,1321
4465,0,0,22,0,-22
4466,1,1,151,2413,2262
4467,0,0,54,0,-54
4468,1,1,782,1438,656
4469,0,0,68,0,-68
4470,1,1,1168,1702,534
4471,1,0,58,0,-58
4472,1,0,41,0,-41
4473,1,1,301,1274,973
4474,1,1,365,1718,1353
4475,0,0,28,0,-28
4476,0,0,5,0,-5
4477,0,0,37,0,-37
4478,1,0,4,0,-4
4479,1,1,1199,1437,238
4480,0,0,34,0,-34
4481,1,0,14,0,-14
4482,0,0,12,0,-12
4483,0,0,6,0,-6
4484,1,1,196,1269,1073
4485,1,1,624,1803,1179
4486,1,1,181,1221,1040
4487,1,0,37,0,-37
4488,0,0,16,0,-16
4489,0,0,107,0,-107
4490,1,1,1892,1575,-317
4491,1,0,31,0,-31
4492,0,0,66,0,-66
4493,1,1,180,1220,1040
4494,1,0,14,0,-14
4495,0,0,10,0,-10
4496,1,1,267,1570,1303
4497,1,0,3,0,-3
4498,0,0,66,0,-66
4499,0,0,33,0,-33
4500,0,0,51,0,-51
4501,1,1,556,1620,1064
4502,1,0,25,0,-25
4503,0,0,34,0,-34
4504,1,0,172,0,-172
4505,1,1,27,1438,1411
4506,1,0,100,0,-100
4507,1,0,2,0,-2
4508,0,0,80,0,-80
4509,1,1,1276,1312,36
4510,0,0,11,0,-11
4511,1,1,455,2512,2057
4512,1,0,42,0,-42
4513,1,0,6,0,-6
4514,1,1,518,1360,842
4515,1,1,691,1286,595
4516,1,0,37,0,-37
4517,0,0,29,0,-29
4518,0,0,35,0,-35
4519,1,0,24,0,-24
4520,0,0,91,0,-91
4521,1,0,76,0,-76
4522,1,1,63,1777,1714
4523,0,0,73,0,-73
4524,0,0,66,0,-66
4525,0,0,46,0,-46
4526,0,0,22,0,-22
4527,1,1,468,1365,897
4528,1,1,623,1282,659
4529,1,1,491,1431,940
4530,0,0,16,0,-16
4531,1,1,701,1436,735
4532,0,0,85,0,-85
4533,1,0,21,0,-21
4534,0,0,12,0,-12
4535,0,0,79,0,-79
4536,1,0,1,0,-1
4537,1,0,42,0,-42
4538,0,0,140,0,-140
4539,0,0,45,0,-45
4540,0,0,54,0,-54
4541,1,0,4,0,-4
4542,0,0,0,0,0
4543,0,0,74,0,-74
4544,0,0,11,0,-11
4545,1,0,31,0,-31
4546,0,0,68,0,-68
4547,1,0,52,0,-52
4548,1,0,199,0,-199
4549,0,0,62,0,-62
4550,1,1,194,1211,1017
4551,1,0,12,0,-12
4552,1,1,127,1570,1443
4553,1,0,12,0,-12
4554,0,0,21,0,-21
4555,1,0,13,0,-13
4556,0,0,3,0,-3
4557,1,1,1125,1513,388
4558,1,0,29,0,-29
4559,0,0,56,0,-56
4560,1,0,40,0,-40
4561,0,0,4,0,-4
4562,1,0,20,0,-20
4563,0,0,247,0,-247
4564,0,0,18,0,-18
4565,0,0,6,0,-6
4566,1,0,136,0,-136
4567,0,0,27,0,-27
4568,0,0,79,0,-79
4569,0,0,111,0,-111
4570,0,0,119,0,-119
4571,0,0,8,0,-8
4572,0,0,131,0,-131
4573,0,0,22,0,-22
4574,0,0,277,0,-277
4575,1,1,444,1651,1207
4576,1,0,79,0,-79
4577,0,0,1,0,-1
4578,0,0,160,0,-160
4579,1,0,46,0,-46
4580,0,0,3,0,-3
4581,1,0,27,0,-27
4582,0,0,38,0,-38
4583,1,1,1538,2374,836
4584,0,0,185,0,-185
4585,1,1,46,1374,1328
4586,1,0,7,0,-7
4587,1,1,2058,1518,-540
4588,1,0,35,0,-35
4589,0,0,1,0,-1
4590,1,1,999,1471,472
4591,0,0,173,0,-173
4592,1,1,1363,1251,-112
4593,0,0,68,0,-68
4594,1,0,66,0,-66
4595,0,0,6,0,-6
4596,0,0,221,0,-221
4597,1,1,549,1281,732
4598,1,1,1263,1220,-43
4599,1,1,210,1241,1031
4600,1,1,122,1215,1093
4601,1,0,5,0,-5
4602,0,0,29,0,-29
4603,1,1,832,1288,456
4604,0,0,45,0,-45
4605,1,0,45,0,-45
4606,1,0,48,0,-48
4607,0,0,40,0,-40
4608,0,0,2,0,-2
4609,1,1,360,1252,892
4610,0,0,9,0,-9
4611,0,0,29,0,-29
4612,0,0,35,0,-35
4613,0,0,140,0,-140
4614,1,0,10,0,-10
4615,1,0,75,0,-75
4616,0,0,39,0,-39
4617,1,0,12,0,-12
4618,1,0,2,0,-2
4619,1,0,18,0,-18
4620,1,0,83,0,-83
4621,1,1,1381,1581,200
4622,1,0,176,0,-176
4623,1,0,86,0,-86
4624,0,0,64,0,-64
4625,1,1,333,1239,906
4626,1,1,140,1365,1225
4627,1,0,19,0,-19
4628,1,1,47,1255,1208
4629,1,1,386,1490,1104
4630,1,1,92,1740,1648
4631,1,1,440,1202,762
4632,0,0,59,0,-59
4633,1,1,1297,1498,201
4634,1,1,348,1252,904
4635,0,0,67,0,-67
4636,1,0,105,0,-105
4637,0,0,4,0,-4
4638,1,0,30,0,-30
4639,1,1,354,1259,905
4640,0,0,247,0,-247
4641,0,0,13,0,-13
4642,1,1,473,1248,775
4643,1,1,47,1468,1421
4644,0,0,14,0,-14
4645,0,0,13,0,-13
4646,0,0,3,0,-3
4647,1,1,292,1500,1208
4648,0,0,7,0,-7
4649,0,0,53,0,-53
4650,1,0,126,0,-126
4651,1,0,30,0,-30
4652,0,0,34,0,-34
4653,0,0,50,0,-50
4654,0,0,30,0,-30
4655,1,1,472,1692,1220
4656,1,0,11,0,-11
4657,1,1,61,1277,1216
4658,1,1,638,1220,582
4659,1,1,179,1307,1128
4660,1,0,104,0,-104
4661,0,0,1,0,-1
4662,1,1,130,1885,1755
4663,1,0,40,0,-40
4664,0,0,8,0,-8
4665,1,1,98,1859,1761
4666,0,0,18,0,-18
4667,1,0,85,0,-85
4668,1,1,114,1204,1090
4669,1,0,58,0,-58
4670,1,1,1066,1290,224
4671,1,1,152,1470,1318
4672,1,0,39,0,-39
4673,1,0,148,0,-148
4674,0,0,16,0,-16
4675,0,0,5,0,-5
4676,1,0,0,0,0
4677,0,0,24,0,-24
4678,1,0,59,0,-59
4679,1,1,191,1272,1081
4680,1,0,27,0,-27
4681,0,0,64,0,-64
4682,1,0,72,0,-72
4683,0,0,2,0,-2
4684,1,0,34,0,-34
4685,1,0,72,0,-72
4686,1,0,97,0,-97
4687,0,0,101,0,-101
4688,1,1,801,1825,1024
4689,0,0,45,0,-45
4690,1,1,1155,1582,427
4691,1,1,384,1254,870
4692,1,1,141,1904,1763
4693,0,0,153,0,-153
4694,0,0,42,0,-42
4695,1,0,156,0,-156
4696,0,0,19,0,-19
4697,1,1,5,1611,1606
4698,0,0,198,0,-198
4699,0,0,29,0,-29
4700,0,0,161,0,-161
4701,0,0,57,0,-57
4702,0,0,11,0,-11
4703,0,0,7,0,-7
4704,1,0,35,0,-35
4705,1,0,16,0,-16
4706,1,1,179,1303,1124
4707,1,1,94,1774,1680
4708,1,1,1111,1493,382
4709,0,0,23,0,-23
4710,1,1,667,1678,1011
4711,0,0,3,0,-3
4712,0,0,4,0,-4
4713,1,1,790,1956,1166
4714,0,0,75,0,-75
4715,1,0,195,0,-195
4716,1,1,182,1400,1218
4717,0,0,121,0,-121
4718,1,0,45,0,-45
4719,1,1,807,1681,874
4720,1,1,327,1411,1084
4721,0,0,38,0,-38
4722,1,0,44,0,-44
4723,1,1,300,1253,953
4724,1,1,751,1411,660
4725,1,1,46,1234,1188
4726,0,0,16,0,-16
4727,1,0,6,0,-6
4728,0,0,68,0,-68
4729,1,0,62,0,-62
4730,0,0,13,0,-13
4731,1,1,232,2367,2135
4732,1,0,198,0,-198
4733,1,0,49,0,-49
4734,1,1,665,1219,554
4735,1,1,140,1316,1176
4736,0,0,5,0,-5
4737,1,0,65,0,-65
4738,1,0,5,0,-5
4739,1,0,23,0,-23
4740,0,0,171,0,-171
4741,1,0,51,0,-51
4742,0,0,38,0,-38
4743,1,0,65,0,-65
4744,1,1,470,2006,1536
4745,1,0,21,0,-21
4746,1,0,73,0,-73
4747,0,0,21,0,-21
4748,0,0,43,0,-43
4749,1,1,86,1252,1166
4750,0,0,14,0,-14
4751,1,0,91,0,-91
4752,0,0,26,0,-26
4753,0,0,11,0,-11
4754,0,0,59,0,-59
4755,1,1,66,1345,1279
4756,0,0,8,0,-8
4757,0,0,6,0,-6
4758,1,1,46,1214,1168
4759,1,0,133,0,-133
4760,0,0,37,0,-37
4761,1,1,649,1479,830
4762,1,1,300,3110,2810
4763,0,0,7,0,-7
4764,1,0,10,0,-10
4765,0,0,49,0,-49
4766,1,0,56,0,-56
4767,1,1,349,1266,917
4768,1,1,878,1269,391
4769,0,0,10,0,-10
4770,0,0,13,0,-13
4771,0,0,65,0,-65
4772,0,0,17,0,-17
4773,1,1,552,1765,1213
4774,0,0,3,0,-3
4775,1,1,1402,2368,966
4776,1,1,700,1398,698
4777,0,0,56,0,-56
4778,1,1,101,1226,1125
4779,1,0,33,0,-33
4780,1,1,342,2241,1899
4781,1,1,577,1769,1192
4782,0,0,108,0,-108
4783,1,0,46,0,-46
4784,0,0,52,0,-52
4785,1,0,88,0,-88
4786,1,1,1369,1243,-126
4787,0,0,0,0,0
4788,0,0,103,0,-103
4789,1,1,2761,1353,-1408
4790,1,0,235,0,-235
4791,1,0,48,0,-48
4792,0,0,10,0,-10
4793,1,1,131,1253,1122
4794,0,0,4,0,-4
4795,1,1,970,1355,385
4796,0,0,26,0,-26
4797,1,1,1420,1533,113
4798,1,0,6,0,-6
4799,1,0,25,0,-25
4800,1,1,174,1236,1062
4801,1,0,65,0,-65
4802,0,0,128,0,-128
4803,1,0,89,0,-89
4804,0,0,189,0,-189
4805,0,0,40,0,-40
4806,0,0,17,0,-17
4807,1,0,14,0,-14
4808,1,1,753,1204,451
4809,1,0,115,0,-115
4810,0,0,3,0,-3
4811,0,0,44,0,-44
4812,1,1,1816,1277,-539
4813,1,1,143,2316,2173
4814,0,0,55,0,-55
4815,1,1,1177,1203,26
4816,1,1,413,1268,855
4817,1,0,63,0,-63
4818,0,0,103,0,-103
4819,1,1,254,1450,1196
4820,1,0,54,0,-54
4821,1,1,265,1212,947
4822,1,1,230,1273,1043
4823,1,0,19,0,-19
4824,1,0,6,0,-6
4825,0,0,49,0,-49
4826,1,0,16,0,-16
4827,0,0,42,0,-42
4828,1,0,102,0,-102
4829,1,1,385,1307,922
4830,1,1,230,1267,1037
4831,0,0,128,0,-128
4832,0,0,118,0,-118
4833,0,0,183,0,-183
4834,0,0,183,0,-183
4835,1,0,25,0,-25
4836,0,0,23,0,-23
4837,0,0,22,0,-22
4838,1,1,334,1340,1006
4839,0,0,47,0,-47
4840,1,0,10,0,-10
4841,1,0,85,0,-85
4842,1,0,151,0,-151
4843,1,0,34,0,-34
4844,0,0,44,0,-44
4845,1,1,111,1264,1153
4846,0,0,15,0,-15
4847,1,1,317,1223,906
4848,1,0,125,0,-125
4849,0,0,138,0,-138
4850,0,0,53,0,-53
4851,0,0,50,0,-50
4852,1,0,8,0,-8
4853,0,0,59,0,-59
4854,1,0,76,0,-76
4855,1,1,234,1498,1264
4856,0,0,51,0,-51
4857,1,0,45,0,-45
4858,1,0,62,0,-62
4859,0,0,7,0,-7
4860,0,0,37,0,-37
4861,0,0,37,0,-37
4862,0,0,45,0,-45
4863,1,1,399,1946,1547
4864,1,0,155,0,-155
4865,1,1,542,1429,887
4866,0,0,13,0,-13
4867,0,0,82,0,-82
4868,1,1,94,2073,1979
4869,1,0,21,0,-21
4870,0,0,78,0,-78
4871,0,0,34,0,-34
4872,1,1,174,1205,1031
4873,1,0,152,0,-152
4874,1,1,229,1250,1021
4875,1,0,84,0,-84
4876,0,0,2,0,-2
4877,1,1,410,2125,1715
4878,1,0,8,0,-8
4879,0,0,85,0,-85
4880,1,0,16,0,-16
4881,1,0,14,0,-14
4882,1,0,187,0,-187
4883,1,0,52,0,-52
4884,1,0,2,0,-2
4885,1,0,39,0,-39
4886,1,0,68,0,-68
4887,0,0,25,0,-25
4888,1,0,13,0,-13
4889,1,1,116,1769,1653
4890,0,0,73,0,-73
4891,1,0,102,0,-102
4892,1,0,9,0,-9
4893,1,1,300,1715,1415
4894,0,0,54,0,-54
4895,0,0,94,0,-94
4896,1,0,36,0,-36
4897,1,0,70,0,-70
4898,0,0,54,0,-54
4899,0,0,16,0,-16
4900,1,0,40,0,-40
4901,0,0,53,0,-53
4902,1,1,332,1269,937
4903,1,1,186,1637,1451
4904,0,0,16,0,-16
4905,0,0,2,0,-2
4906,1,0,67,0,-67
4907,1,1,15,1347,1332
4908,1,0,72,0,-72
4909,1,1,591,1244,653
4910,0,0,28,0,-28
4911,0,0,100,0,-100
4912,1,0,173,0,-173
4913,1,0,125,0,-125
4914,0,0,37,0,-37
4915,1,1,114,1420,1306
4916,0,0,62,0,-62
4917,1,1,532,1399,867
4918,1,0,4,0,-4
4919,0,0,16,0,-16
4920,1,1,1612,1305,-307
4921,1,1,377,1463,1086
4922,1,0,113,0,-113
4923,0,0,20,0,-20
4924,1,1,684,1548,864
4925,1,0,53,0,-53
4926,1,0,2,0,-2
4927,1,0,22,0,-22
4928,1,1,730,1271,541
4929,1,1,419,1298,879
4930,0,0,44,0,-44
4931,1,0,63,0,-63
4932,1,1,198,1614,1416
4933,1,1,30,1369,1339
4934,1,0,37,0,-37
4935,1,0,7,0,-7
4936,0,0,20,0,-20
4937,1,1,451,2577,2126
4938,1,0,126,0,-126
4939,1,0,10,0,-10
4940,0,0,67,0,-67
4941,0,0,13,0,-13
4942,1,0,17,0,-17
4943,0,0,12,0,-12
4944,1,0,106,0,-106
4945,1,0,22,0,-22
4946,1,0,12,0,-12
4947,0,0,70,0,-70
4948,1,0,32,0,-32
4949,1,0,4,0,-4
4950,1,1,638,1245,607
4951,1,1,916,1682,766
4952,0,0,107,0,-107
4953,1,1,304,1317,1013
4954,0,0,13,0,-13
4955,0,0,44,0,-44
4956,1,0,6,0,-6
4957,1,0,114,0,-114
4958,0,0,57,0,-57
4959,0,0,58,0,-58
4960,1,1,1378,1760,382
4961,0,0,5,0,-5
4962,1,1,237,1257,1020
4963,1,0,18,0,-18
4964,0,0,21,0,-21
4965,0,0,0,0,0
4966,1,0,43,0,-43
4967,0,0,6,0,-6
4968,0,0,4,0,-4
4969,1,1,117,1282,1165
4970,0,0,59,0,-59
4971,1,1,359,1435,1076
4972,1,0,47,0,-47
4973,1,1,178,1704,1526
4974,1,1,799,1397,598
4975,1,0,119,0,-119
4976,1,0,17,0,-17
4977,1,1,387,1336,949
4978,1,1,439,1648,1209
4979,1,0,171,0,-171
4980,0,0,8,0,-8
4981,1,1,559,2043,1484
4982,0,0,232,0,-232
4983,0,0,92,0,-92
4984,1,1,230,1883,1653
4985,1,1,1167,1235,68
4986,1,1,19,2475,2456
4987,1,0,0,0,0
4988,1,1,570,1207,637
4989,1,1,2148,1328,-820
4990,0,0,137,0,-137
4991,0,0,29,0,-29
4992,1,1,279,1206,927
4993,0,0,4,0,-4
4994,1,0,47,0,-47
4995,1,0,10,0,-10
4996,0,0,13,0,-13
4997,0,0,50,0,-50
4998,1,1,547,1357,810
4999,1,0,65,0,-65
5000,1,1,631,1203,572
5001,1,1,663,2110,1447
5002,1,0,75,0,-75
5003,0,0,49,0,-49
5004,1,1,851,3533,2682
5005,1,0,34,0,-34
5006,1,0,17,0,-17
5007,0,0,96,0,-96
5008,1,1,788,1721,933
5009,0,0,3,0,-3
5010,1,0,18,0,-18
5011,1,1,274,2690,2416
5012,0,0,4,0,-4
5013,0,0,28,0,-28
5014,0,0,5,0,-5
5015,0,0,14,0,-14
5016,1,0,77,0,-77
5017,0,0,56,0,-56
5018,0,0,45,0,-45
5019,0,0,2,0,-2
5020,1,1,1498,1345,-153
5021,1,0,118,0,-118
5022,1,0,71,0,-71
5023,1,1,151,1678,1527
5024,0,0,83,0,-83
5025,1,0,11,0,-11
5026,0,0,70,0,-70
5027,1,0,1,0,-1
5028,1,0,9,0,-9
5029,0,0,14,0,-14
5030,1,1,861,1407,546
5031,0,0,98,0,-98
5032,0,0,68,0,-68
5033,0,0,63,0,-63
5034,0,0,65,0,-65
5035,1,0,10,0,-10
5036,0,0,104,0,-104
5037,1,1,743,1202,459
5038,1,1,486,1283,797
5039,1,0,37,0,-37
5040,1,0,41,0,-41
5041,0,0,66,0,-66
5042,1,0,6,0,-6
5043,1,1,269,1955,1686
5044,1,0,39,0,-39
5045,1,0,0,0,0
5046,0,0,33,0,-33
5047,0,0,8,0,-8
5048,0,0,61,0,-61
5049,0,0,32,0,-32
5050,1,1,803,1386,583
5051,0,0,16,0,-16
5052,1,1,1270,1307,37
5053,1,1,136,1253,1117
5054,1,0,163,0,-163
5055,1,0,33,0,-33
5056,1,1,285,1252,967
5057,1,0,115,0,-115
5058,1,1,349,2022,1673
5059,0,0,127,0,-127
5060,1,1,2047,1416,-631
5061,1,0,65,0,-65
5062,1,0,14,0,-14
5063,0,0,93,0,-93
5064,1,1,1564,1228,-336
5065,1,1,278,1765,1487
5066,1,0,119,0,-119
5067,1,0,34,0,-34
5068,0,0,29,0,-29
5069,1,0,39,0,-39
5070,1,0,23,0,-23
5071,0,0,24,0,-24
5072,1,0,13,0,-13
5073,1,0,13,0,-13
5074,1,1,23,3663,3640
5075,0,0,33,0,-33
5076,1,1,299,1607,1308
5077,1,1,951,1921,970
5078,1,0,6,0,-6
5079,1,1,397,1511,1114
5080,1,1,259,1429,1170
5081,1,1,1346,1439,93
5082,0,0,1,0,-1
5083,1,0,95,0,-95
5084,1,0,58,0,-58
5085,1,0,20,0,-20
5086,1,0,12,0,-12
5087,0,0,66,0,-66
5088,0,0,6,0,-6
5089,1,0,67,0,-67
5090,1,0,33,0,-33
5091,1,0,13,0,-13
5092,1,0,98,0,-98
5093,0,0,3,0,-3
5094,0,0,109,0,-109
5095,1,1,822,1267,445
5096,1,1,1014,2321,1307
5097,1,1,277,1219,942
5098,1,0,33,0,-33
5099,0,0,112,0,-112
5100,0,0,10,0,-10
5101,0,0,32,0,-32
5102,1,0,65,0,-65
5103,0,0,8,0,-8
5104,0,0,54,0,-54
5105,1,0,26,0,-26
5106,1,0,34,0,-34
5107,0,0,16,0,-16
5108,1,1,519,1303,784
5109,0,0,38,0,-38
5110,0,0,63,0,-63
5111,1,0,112,0,-112
5112,1,0,72,0,-72
5113,1,1,232,1397,1165
5114,0,0,2,0,-2
5115,1,0,5,0,-5
5116,1,0,5,0,-5
5117,1,0,122,0,-122
5118,1,0,64,0,-64
5119,1,0,59,0,-59
5120,1,0,237,0,-237
5121,1,0,43,0,-43
5122,0,0,32,0,-32
5123,1,1,210,1231,1021
5124,1,0,9,0,-9
5125,1,0,40,0,-40
5126,0,0,33,0,-33
5127,1,0,18,0,-18
5128,1,0,151,0,-151
5129,0,0,195,0,-195
5130,0,0,6,0,-6
5131,1,0,82,0,-82
5132,1,1,619,1469,850
5133,1,0,11,0,-11
5134,1,1,376,1704,1328
5135,1,1,1168,1254,86
5136,0,0,43,0,-43
5137,1,1,776,1239,463
5138,1,0,37,0,-37
5139,0,0,16,0,-16
5140,0,0,77,0,-77
5141,1,0,19,0,-19
5142,0,0,82,0,-82
5143,1,1,129,2819,2690
5144,0,0,46,0,-46
5145,0,0,3,0,-3
5146,0,0,58,0,-58
5147,1,0,24,0,-24
5148,1,1,76,1227,1151
5149,0,0,8,0,-8
5150,0,0,23,0,-23
5151,0,0,3,0,-3
5152,1,1,325,1507,1182
5153,1,1,802,1887,1085
5154,1,0,132,0,-132
5155,1,0,89,0,-89
5156,1,0,10,0,-10
5157,0,0,78,0,-78
5158,0,0,3,0,-3
5159,1,0,105,0,-105
5160,1,1,1230,1837,607
5161,1,0,50,0,-50
5162,1,0,19,0,-19
5163,1,1,645,1441,796
5164,1,0,29,0,-29
5165,1,1,651,1315,664
5166,0,0,1,0,-1
5167,1,1,331,1439,1108
5168,0,0,9,0,-9
5169,1,1,180,1370,1190
5170,1,1,887,1357,470
5171,1,1,32,6127,6095
5172,1,0,78,0,-78
5173,1,1,451,1702,1251
5174,0,0,232,0,-232
5175,0,0,7,0,-7
5176,1,1,771,1220,449
5177,0,0,130,0,-130
5178,0,0,12,0,-12
5179,1,0,16,0,-16
5180,0,0,27,0,-27
5181,1,1,147,1403,1256
5182,0,0,47,0,-47
5183,0,0,292,0,-292
5184,1,1,682,1214,532
5185,0,0,34,0,-34
5186,0,0,21,0,-21
5187,0,0,37,0,-37
5188,1,0,71,0,-71
5189,1,0,7,0,-7
5190,0,0,13,0,-13
5191,1,1,135,1218,1083
5192,1,1,206,2144,1938
5193,0,0,55,0,-55
5194,1,1,1100,1322,222
5195,1,0,34,0,-34
5196,1,1,98,1312,1214
5197,0,0,77,0,-77
5198,0,0,207,0,-207
5199,0,0,67,0,-67
5200,1,0,36,0,-36
5201,1,0,97,0,-97
5202,1,1,18,2843,2825
5203,0,0,43,0,-43
5204,0,0,21,0,-21
5205,1,0,23,0,-23
5206,0,0,4,0,-4
5207,1,0,64,0,-64
5208,0,0,14,0,-14
5209,0,0,27,0,-27
5210,1,0,48,0,-48
5211,1,1,82,1425,1343
5212,1,1,1341,1228,-113
5213,0,0,52,0,-52
5214,0,0,2,0,-2
5215,1,1,669,1846,1177
5216,1,1,698,1965,1267
5217,1,0,2,0,-2
5218,1,0,3,0,-3
5219,1,0,102,0,-102
5220,1,0,83,0,-83
5221,1,0,4,0,-4
5222,1,1,399,1239,840
5223,1,0,4,0,-4
5224,1,0,13,0,-13
5225,1,1,201,1375,1174
5226,0,0,20,0,-20
5227,0,0,86,0,-86
5228,1,1,182,1319,1137
5229,0,0,1,0,-1
5230,1,1,785,1438,653
5231,1,1,391,1496,1105
5232,1,1,745,1735,990
5233,1,1,475,1534,1059
5234,1,1,349,1539,1190
5235,1,0,127,0,-127
5236,1,0,8,0,-8
5237,0,0,53,0,-53
5238,1,0,3,0,-3
5239,1,0,46,0,-46
5240,0,0,139,0,-139
5241,1,1,1082,1695,613
5242,1,0,36,0,-36
5243,1,1,467,1759,1292
5244,1,0,34,0,-34
5245,0,0,0,0,0
5246,0,0,14,0,-14
5247,0,0,77,0,-77
5248,0,0,112,0,-112
5249,0,0,60,0,-60
5250,0,0,115,0,-115
5251,1,0,22,0,-22
5252,1,1,1472,1404,-68
5253,0,0,23,0,-23
5254,1,0,44,0,-44
5255,1,0,18,0,-18
5256,1,1,1734,2257,523
5257,0,0,82,0,-82
5258,1,0,17,0,-17
5259,0,0,25,0,-25
5260,1,0,133,0,-133
5261,0,0,94,0,-94
5262,1,0,8,0,-8
5263,1,0,49,0,-49
5264,1,1,732,1526,794
5265,1,1,361,1456,1095
5266,1,1,100,2618,2518
5267,1,1,320,1287,967
5268,0,0,239,0,-239
5269,1,1,3732,1313,-2419
5270,1,0,40,0,-40
5271,1,1,481,1347,866
5272,0,0,58,0,-58
5273,0,0,20,0,-20
5274,1,0,27,0,-27
5275,0,0,23,0,-23
5276,1,1,263,1334,1071
5277,1,0,5,0,-5
5278,1,1,327,1404,1077
5279,1,1,2171,1229,-942
5280,0,0,2,0,-2
5281,1,1,138,1333,1195
5282,1,0,285,0,-285
5283,1,0,24,0,-24
5284,1,1,1605,1236,-369
5285,0,0,46,0,-46
5286,1,1,186,1600,1414
5287,0,0,9,0,-9
5288,1,0,6,0,-6
5289,0,0,48,0,-48
5290,1,1,640,1343,703
5291,0,0,4,0,-4
5292,1,0,4,0,-4
5293,0,0,31,0,-31
5294,1,1,480,1583,1103
5295,0,0,63,0,-63
5296,0,0,89,0,-89
5297,1,0,2,0,-2
5298,0,0,0,0,0
5299,0,0,69,0,-69
5300,0,0,22,0,-22
5301,0,0,133,0,-133
5302,1,0,45,0,-45
5303,1,0,157,0,-157
5304,0,0,14,0,-14
5305,1,0,8,0,-8
5306,1,0,89,0,-89
5307,1,1,63,2212,2149
5308,0,0,52,0,-52
5309,1,1,694,1869,1175
5310,0,0,28,0,-28
5311,0,0,41,0,-41
5312,0,0,0,0,0
5313,1,0,122,0,-122
5314,0,0,27,0,-27
5315,1,1,439,1364,925
5316,1,0,20,0,-20
5317,0,0,45,0,-45
5318,1,1,258,1261,1003
5319,0,0,58,0,-58
5320,1,1,487,1360,873
5321,1,0,11,0,-11
5322,0,0,8,0,-8
5323,1,1,733,2246,1513
5324,1,0,8,0,-8
5325,1,1,355,1220,865
5326,0,0,63,0,-63
5327,0,0,42,0,-42
5328,1,0,78,0,-78
5329,1,0,12,0,-12
5330,1,0,43,0,-43
5331,1,1,119,2006,1887
5332,0,0,78,0,-78
5333,1,1,258,1203,945
5334,0,0,36,0,-36
5335,1,0,271,0,-271
5336,0,0,44,0,-44
5337,0,0,35,0,-35
5338,1,1,390,1203,813
5339,1,1,241,1671,1430
5340,0,0,73,0,-73
5341,1,1,509,1360,851
5342,1,0,0,0,0
5343,1,1,377,1201,824
5344,1,1,137,2325,2188
5345,1,0,1,0,-1
5346,1,0,16,0,-16
5347,0,0,117,0,-117
5348,1,0,16,0,-16
5349,0,0,65,0,-65
5350,1,0,142,0,-142
5351,0,0,96,0,-96
5352,0,0,58,0,-58
5353,1,1,282,1614,1332
5354,1,0,18,0,-18
5355,1,0,15,0,-15
5356,1,0,56,0,-56
5357,1,0,183,0,-183
5358,1,0,36,0,-36
5359,0,0,79,0,-79
5360,0,0,3,0,-3
5361,0,0,10,0,-10
5362,1,1,61,1614,1553
5363,1,1,1639,1306,-333
5364,0,0,18,0,-18
5365,1,1,2312,1327,-985
5366,1,0,4,0,-4
5367,0,0,31,0,-31
5368,1,1,1712,1706,-6
5369,0,0,162,0,-162
5370,0,0,34,0,-34
5371,0,0,131,0,-131
5372,0,0,8,0,-8
5373,0,0,10,0,-10
5374,1,1,298,1368,1070
5375,1,0,58,0,-58
5376,1,1,2089,1487,-602
5377,0,0,65,0,-65
5378,1,1,83,1762,1679
5379,1,0,52,0,-52
5380,1,0,66,0,-66
5381,1,1,1239,1470,231
5382,0,0,35,0,-35
5383,0,0,33,0,-33
5384,1,1,607,1228,621
5385,1,0,59,0,-59
5386,1,1,127,1556,1429
5387,1,0,33,0,-33
5388,1,1,1569,1409,-160
5389,1,0,33,0,-33
5390,0,0,49,0,-49
5391,1,1,617,1577,960
5392,0,0,17,0,-17
5393,0,0,80,0,-80
5394,1,0,56,0,-56
5395,1,1,1310,1364,54
5396,0,0,62,0,-62
5397,1,0,27,0,-27
5398,1,1,517,1294,777
5399,0,0,92,0,-92
5400,0,0,44,0,-44
5401,1,0,20,0,-20
5402,1,0,103,0,-103
5403,0,0,63,0,-63
5404,1,0,59,0,-59
5405,1,0,7,0,-7
5406,0,0,15,0,-15
5407,1,1,246,1444,1198
5408,1,0,24,0,-24
5409,0,0,7,0,-7
5410,1,1,174,1232,1058
5411,1,0,7,0,-7
5412,1,0,14,0,-14
5413,1,1,61,1284,1223
5414,1,1,287,1213,926
5415,1,0,12,0,-12
5416,1,0,18,0,-18
5417,1,1,1234,1449,215
5418,1,1,241,1341,1100
5419,1,0,36,0,-36
5420,0,0,169,0,-169
5421,0,0,70,0,-70
5422,1,0,54,0,-54
5423,1,1,208,1273,1065
5424,0,0,0,0,0
5425,1,1,226,2508,2282
5426,1,1,130,1237,1107
5427,1,0,32,0,-32
5428,1,0,127,0,-127
5429,1,0,48,0,-48
5430,1,1,762,1275,513
5431,0,0,9,0,-9
5432,1,0,10,0,-10
5433,1,1,1101,1233,132
5434,1,0,44,0,-44
5435,1,1,1751,1665,-86
5436,0,0,44,0,-44
5437,1,1,618,1607,989
5438,0,0,212,0,-212
5439,0,0,17,0,-17
5440,1,0,37,0,-37
5441,1,1,143,1212,1069
5442,1,0,110,0,-110
5443,0,0,52,0,-52
5444,0,0,419,0,-419
5445,0,0,7,0,-7
5446,0,0,48,0,-48
5447,1,1,803,2278,1475
5448,1,0,72,0,-72
5449,1,0,139,0,-139
5450,0,0,86,0,-86
5451,1,1,73,1622,1549
5452,0,0,12,0,-12
5453,1,0,111,0,-111
5454,1,1,731,1615,884
5455,1,0,31,0,-31
5456,1,1,203,1290,1087
5457,0,0,28,0,-28
5458,0,0,11,0,-11
5459,0,0,16,0,-16
5460,0,0,14,0,-14
5461,1,0,5,0,-5
5462,1,1,104,1557,1453
5463,1,0,82,0,-82
5464,0,0,46,0,-46
5465,0,0,147,0,-147
5466,0,0,160,0,-160
5467,1,1,544,1994,1450
5468,1,1,208,1354,1146
5469,0,0,15,0,-15
5470,0,0,36,0,-36
5471,1,1,74,2143,2069
5472,1,0,153,0,-153
5473,1,0,28,0,-28
5474,1,0,33,0,-33
5475,1,1,81,1298,1217
5476,1,0,15,0,-15
5477,1,0,16,0,-16
5478,0,0,7,0,-7
5479,1,0,67,0,-67
5480,1,1,101,1283,1182
5481,0,0,10,0,-10
5482,1,1,383,1243,860
5483,0,0,113,0,-113
5484,1,1,355,1253,898
5485,0,0,0,0,0
5486,0,0,6,0,-6
5487,1,0,21,0,-21
5488,0,0,16,0,-16
5489,0,0,33,0,-33
5490,1,0,1,0,-1
5491,1,1,802,2455,1653
5492,1,0,10,0,-10
5493,1,0,27,0,-27
5494,1,1,384,1212,828
5495,1,0,45,0,-45
5496,1,1,314,1597,1283
5497,1,0,46,0,-46
5498,0,0,34,0,-34
5499,0,0,8,0,-8
5500,1,1,459,1226,767
5501,1,0,6,0,-6
5502,0,0,29,0,-29
5503,0,0,1,0,-1
5504,1,0,4,0,-4
5505,0,0,6,0,-6
5506,0,0,182,0,-182
5507,1,1,56,2390,2334
5508,0,0,0,0,0
5509,0,0,30,0,-30
5510,1,0,112,0,-112
5511,1,1,1051,1292,241
5512,1,1,164,1528,1364
5513,1,1,128,2081,1953
5514,1,1,267,2377,2110
5515,0,0,63,0,-63
5516,1,0,18,0,-18
5517,0,0,17,0,-17
5518,1,1,1712,1207,-505
5519,0,0,125,0,-125
5520,1,1,294,1339,1045
5521,0,0,64,0,-64
5522,1,0,63,0,-63
5523,1,1,808,1457,649
5524,0,0,19,0,-19
5525,0,0,0,0,0
5526,0,0,28,0,-28
5527,0,0,5,0,-5
5528,0,0,25,0,-25
5529,0,0,0,0,0
5530,1,0,2,0,-2
5531,0,0,162,0,-162
5532,0,0,14,0,-14
5533,0,0,104,0,-104
5534,1,0,174,0,-174
5535,0,0,55,0,-55
5536,0,0,17,0,-17
5537,0,0,8,0,-8
5538,0,0,142,0,-142
5539,0,0,31,0,-31
5540,1,0,9,0,-9
5541,1,1,475,2342,1867
5542,0,0,187,0,-187
5543,0,0,27,0,-27
5544,0,0,26,0,-26
5545,0,0,18,0,-18
5546,1,1,288,1441,1153
5547,0,0,2,0,-2
5548,0,0,15,0,-15
5549,0,0,10,0,-10
5550,1,1,1731,1895,164
5551,1,0,40,0,-40
5552,1,0,15,0,-15
5553,0,0,23,0,-23
5554,0,0,25,0,-25
5555,0,0,72,0,-72
5556,0,0,115,0,-115
5557,0,0,128,0,-128
5558,1,0,69,0,-69
5559,0,0,4,0,-4
5560,0,0,80,0,-80
5561,1,1,94,1245,1151
5562,1,1,460,1708,1248
5563,1,0,129,0,-129
5564,1,0,20,0,-20
5565,1,1,238,1395,1157
5566,1,1,57,1826,1769
5567,0,0,132,0,-132
5568,1,1,710,1816,1106
5569,0,0,124,0,-124
5570,0,0,4,0,-4
5571,1,0,7,0,-7
5572,0,0,4,0,-4
5573,0,0,20,0,-20
5574,0,0,23,0,-23
5575,1,0,8,0,-8
5576,0,0,17,0,-17
5577,1,1,701,1262,561
5578,0,0,6,0,-6
5579,0,0,94,0,-94
5580,0,0,150,0,-150
5581,0,0,56,0,-56
5582,1,0,12,0,-12
5583,1,0,114,0,-114
5584,1,0,31,0,-31
5585,0,0,82,0,-82
5586,1,1,407,1542,1135
5587,1,1,260,1227,967
5588,0,0,21,0,-21
5589,0,0,93,0,-93
5590,1,1,231,1439,1208
5591,1,1,1556,1786,230
5592,1,0,7,0,-7
5593,0,0,53,0,-53
5594,1,1,1459,1590,131
5595,1,1,468,1220,752
5596,1,0,90,0,-90
5597,0,0,29,0,-29
5598,1,1,920,1851,931
5599,1,0,38,0,-38
5600,1,1,419,1226,807
5601,1,1,56,1272,1216
5602,1,0,42,0,-42
5603,1,1,161,1454,1293
5604,1,0,0,0,0
5605,1,0,40,0,-40
5606,1,1,1198,1600,402
5607,1,0,27,0,-27
5608,1,0,55,0,-55
5609,0,0,3,0,-3
5610,1,0,107,0,-107
5611,1,0,41,0,-41
5612,0,0,56,0,-56
5613,1,1,162,1293,1131
5614,1,1,239,1911,1672
5615,0,0,23,0,-23
5616,1,0,122,0,-122
5617,0,0,47,0,-47
5618,1,0,84,0,-84
5619,1,0,22,0,-22
5620,0,0,110,0,-110
5621,1,1,181,5436,5255
5622,1,0,5,0,-5
5623,1,0,12,0,-12
5624,0,0,1,0,-1
5625,0,0,10,0,-10
5626,0,0,106,0,-106
5627,0,0,158,0,-158
5628,1,1,930,1288,358
5629,1,1,397,1212,815
5630,0,0,8,0,-8
5631,0,0,299,0,-299
5632,1,0,12,0,-12
5633,1,1,594,1253,659
5634,1,0,67,0,-67
5635,1,1,829,7023,6194
5636,0,0,37,0,-37
5637,0,0,35,0,-35
5638,0,0,70,0,-70
5639,0,0,80,0,-80
5640,0,0,61,0,-61
5641,0,0,129,0,-129
5642,1,1,306,1213,907
5643,1,1,475,1333,858
5644,0,0,152,0,-152
5645,0,0,51,0,-51
5646,1,0,15,0,-15
5647,1,0,13,0,-13
5648,1,1,404,1349,945
5649,1,1,256,1309,1053
5650,1,1,380,1890,1510
5651,1,1,59,2112,2053
5652,0,0,107,0,-107
5653,1,0,6,0,-6
5654,1,1,167,1499,1332
5655,1,1,541,1664,1123
5656,1,0,23,0,-23
5657,1,0,11,0,-11
5658,0,0,1,0,-1
5659,1,0,18,0,-18
5660,1,1,283,1273,990
5661,1,1,716,1601,885
5662,1,1,912,1278,366
5663,1,1,489,2062,1573
5664,1,0,108,0,-108
5665,0,0,209,0,-209
5666,1,0,55,0,-55
5667,1,0,86,0,-86
5668,1,0,50,0,-50
5669,0,0,17,0,-17
5670,1,1,496,1232,736
5671,0,0,0,0,0
5672,1,1,52,1605,1553
5673,1,1,282,1273,991
5674,0,0,12,0,-12
5675,0,0,18,0,-18
5676,1,0,10,0,-10
5677,1,0,154,0,-154
5678,1,1,235,1747,1512
5679,0,0,16,0,-16
5680,0,0,0,0,0
5681,0,0,58,0,-58
5682,1,1,574,1378,804
5683,1,1,90,1371,1281
5684,0,0,13,0,-13
5685,1,1,1431,1203,-228
5686,1,0,28,0,-28
5687,0,0,1,0,-1
5688,1,1,254,1206,952
5689,0,0,72,0,-72
5690,0,0,19,0,-19
5691,1,1,231,1561,1330
5692,1,0,32,0,-32
5693,0,0,28,0,-28
5694,1,1,112,1410,1298
5695,1,0,67,0,-67
5696,1,0,105,0,-105
5697,0,0,94,0,-94
5698,1,0,8,0,-8
5699,1,0,131,0,-131
5700,1,0,16,0,-16
5701,1,1,450,1224,774
5702,0,0,11,0,-11
5703,1,1,1521,1684,163
5704,0,0,112,0,-112
5705,1,1,349,2423,2074
5706,0,0,32,0,-32
5707,1,1,151,2587,2436
5708,0,0,6,0,-6
5709,0,0,11,0,-11
5710,1,0,88,0,-88
5711,1,0,34,0,-34
5712,1,0,242,0,-242
5713,0,0,58,0,-58
5714,1,1,77,1261,1184
5715,0,0,59,0,-59
5716,1,1,73,1836,1763
5717,1,1,201,1313,1112
5718,0,0,19,0,-19
5719,1,0,118,0,-118
5720,0,0,9,0,-9
5721,1,1,318,1213,895
5722,0,0,31,0,-31
5723,1,1,432,1271,839
5724,0,0,1,0,-1
5725,1,0,129,0,-129
5726,0,0,81,0,-81
5727,1,1,142,2210,2068
5728,1,0,54,0,-54
5729,1,0,2,0,-2
5730,1,1,234,1451,1217
5731,1,0,43,0,-43
5732,0,0,9,0,-9
5733,0,0,27,0,-27
5734,0,0,23,0,-23
5735,1,0,19,0,-19
5736,0,0,56,0,-56
5737,1,0,64,0,-64
5738,0,0,59,0,-59
5739,0,0,42,0,-42
5740,0,0,55,0,-55
5741,0,0,89,0,-89
5742,0,0,116,0,-116
5743,1,1,2788,1358,-1430
5744,1,0,136,0,-136
5745,1,0,6,0,-6
5746,1,0,10,0,-10
5747,0,0,8,0,-8
5748,1,1,172,1402,1230
5749,0,0,48,0,-48
5750,0,0,7,0,-7
5751,1,1,2040,1267,-773
5752,0,0,11,0,-11
5753,0,0,47,0,-47
5754,0,0,1,0,-1
5755,1,0,62,0,-62
5756,0,0,122,0,-122
5757,1,1,1158,1654,496
5758,1,0,83,0,-83
5759,0,0,5,0,-5
5760,1,0,13,0,-13
5761,0,0,13,0,-13
5762,1,1,227,1685,1458
5763,0,0,24,0,-24
5764,1,1,336,1243,907
5765,1,1,891,1227,336
5766,1,0,39,0,-39
5767,0,0,21,0,-21
5768,0,0,42,0,-42
5769,0,0,64,0,-64
5770,0,0,9,0,-9
5771,0,0,43,0,-43
5772,1,0,35,0,-35
5773,0,0,79,0,-79
5774,1,0,28,0,-28
5775,1,1,236,1530,1294
5776,0,0,16,0,-16
5777,1,0,37,0,-37
5778,1,1,637,1510,873
5779,1,1,1176,3544,2368
5780,1,1,1120,1321,201
5781,1,0,37,0,-37
5782,1,0,49,0,-49
5783,1,0,54,0,-54
5784,0,0,43,0,-43
5785,1,1,165,1559,1394
5786,0,0,22,0,-22
5787,1,1,87,1213,1126
5788,1,1,106,1399,1293
5789,1,0,102,0,-102
5790,1,1,556,1276,720
5791,0,0,0,0,0
5792,1,0,91,0,-91
5793,0,0,174,0,-174
5794,0,0,17,0,-17
5795,1,1,650,1347,697
5796,0,0,77,0,-77
5797,1,0,35,0,-35
5798,0,0,71,0,-71
5799,0,0,8,0,-8
5800,0,0,83,0,-83
5801,1,1,1435,1719,284
5802,0,0,163,0,-163
5803,0,0,35,0,-35
5804,1,0,4,0,-4
5805,1,0,13,0,-13
5806,1,0,98,0,-98
5807,1,0,19,0,-19
5808,1,0,10,0,-10
5809,1,0,44,0,-44
5810,1,0,16,0,-16
5811,0,0,203,0,-203
5812,1,0,19,0,-19
5813,1,1,81,1337,1256
5814,1,0,1,0,-1
5815,0,0,151,0,-151
5816,0,0,40,0,-40
5817,1,1,1013,1996,983
5818,0,0,47,0,-47
5819,0,0,72,0,-72
5820,1,1,316,1651,1335
5821,1,1,294,1223,929
5822,0,0,60,0,-60
5823,1,1,248,1521,1273
5824,1,0,27,0,-27
5825,0,0,44,0,-44
5826,0,0,3,0,-3
5827,1,0,2,0,-2
5828,0,0,16,0,-16
5829,1,1,760,1373,613
5830,0,0,122,0,-122
5831,0,0,14,0,-14
5832,1,1,226,1297,1071
5833,0,0,28,0,-28
5834,1,0,122,0,-122
5835,1,0,69,0,-69
5836,1,1,7,1210,1203
5837,1,0,26,0,-26
5838,1,1,685,1701,1016
5839,0,0,10,0,-10
5840,0,0,18,0,-18
5841,1,0,94,0,-94
5842,0,0,148,0,-148
5843,1,1,750,1507,757
5844,1,1,431,1731,1300
5845,0,0,8,0,-8
5846,1,1,499,4115,3616
5847,1,1,98,1438,1340
5848,1,0,3,0,-3
5849,1,1,264,1854,1590
5850,0,0,22,0,-22
5851,1,0,147,0,-147
5852,0,0,10,0,-10
5853,1,1,175,1498,1323
5854,1,1,815,1684,869
5855,1,1,1320,1387,67
5856,1,0,9,0,-9
5857,1,1,147,1767,1620
5858,1,0,7,0,-7
5859,1,0,97,0,-97
5860,1,0,12,0,-12
5861,1,0,7,0,-7
5862,0,0,2,0,-2
5863,0,0,100,0,-100
5864,0,0,118,0,-118
5865,0,0,19,0,-19
5866,1,1,135,1627,1492
5867,1,1,355,1267,912
5868,1,0,47,0,-47
5869,1,0,83,0,-83
5870,1,1,2072,1487,-585
5871,1,0,24,0,-24
5872,0,0,20,0,-20
5873,0,0,165,0,-165
5874,0,0,13,0,-13
5875,1,0,7,0,-7
5876,0,0,29,0,-29
5877,0,0,15,0,-15
5878,1,1,1044,1272,228
5879,1,1,13,1553,1540
5880,0,0,133,0,-133
5881,0,0,122,0,-122
5882,1,1,2352,1218,-1134
5883,1,0,33,0,-33
5884,0,0,108,0,-108
5885,0,0,42,0,-42
5886,1,1,337,1218,881
5887,0,0,122,0,-122
5888,1,1,1008,1563,555
5889,1,0,1,0,-1
5890,1,0,24,0,-24
5891,1,1,417,1613,1196
5892,0,0,135,0,-135
5893,1,1,8,2124,2116
5894,1,1,46,1221,1175
5895,1,1,214,1565,1351
5896,1,1,202,1254,1052
5897,1,1,654,1641,987
5898,1,1,1262,1252,-10
5899,1,0,5,0,-5
5900,1,0,91,0,-91
5901,0,0,7,0,-7
5902,1,0,9,0,-9
5903,1,0,24,0,-24
5904,1,1,117,1974,1857
5905,1,1,458,1594,1136
5906,1,1,578,1254,676
5907,0,0,57,0,-57
5908,1,0,26,0,-26
5909,0,0,13,0,-13
5910,1,0,27,0,-27
5911,0,0,38,0,-38
5912,0,0,22,0,-22
5913,1,1,335,1221,886
5914,1,1,1375,1816,441
5915,1,0,16,0,-16
5916,1,1,208,1266,1058
5917,1,1,289,1908,1619
5918,1,1,53,2034,1981
5919,0,0,26,0,-26
5920,0,0,49,0,-49
5921,1,0,56,0,-56
5922,1,1,147,1237,1090
5923,0,0,94,0,-94
5924,1,0,59,0,-59
5925,1,1,528,1204,676
5926,1,1,466,2172,1706
5927,0,0,142,0,-142
5928,1,1,210,1291,1081
5929,1,0,18,0,-18
5930,1,0,27,0,-27
5931,0,0,208,0,-208
5932,0,0,24,0,-24
5933,1,0,22,0,-22
5934,1,0,14,0,-14
5935,0,0,1,0,-1
5936,1,1,274,2109,1835
5937,1,1,58,1209,1151
5938,0,0,17,0,-17
5939,0,0,39,0,-39
5940,0,0,24,0,-24
5941,1,1,148,3173,3025
5942,1,0,35,0,-35
5943,1,0,136,0,-136
5944,1,1,256,2838,2582
5945,1,1,640,2533,1893
5946,1,1,504,2520,2016
5947,1,0,3,0,-3
5948,1,0,48,0,-48
5949,0,0,10,0,-10
5950,1,1,232,1590,1358
5951,0,0,103,0,-103
5952,0,0,4,0,-4
5953,0,0,272,0,-272
5954,1,0,32,0,-32
5955,0,0,126,0,-126
5956,1,1,573,2374,1801
5957,0,0,26,0,-26
5958,1,1,594,1468,874
5959,1,1,88,1204,1116
5960,1,0,13,0,-13
5961,0,0,26,0,-26
5962,1,1,313,1687,1374
5963,1,0,110,0,-110
5964,1,1,72,1620,1548
5965,1,0,8,0,-8
5966,1,0,5,0,-5
5967,1,0,50,0,-50
5968,0,0,67,0,-67
5969,1,1,1827,1271,-556
5970,1,0,57,0,-57
5971,1,1,452,1227,775
5972,0,0,76,0,-76
5973,1,1,577,1324,747
5974,1,0,5,0,-5
5975,1,1,630,2071,1441
5976,1,1,233,1230,997
5977,1,0,113,0,-113
5978,1,1,569,1236,667
5979,1,0,34,0,-34
5980,1,0,28,0,-28
5981,1,0,199,0,-199
5982,0,0,22,0,-22
5983,1,0,12,0,-12
5984,0,0,12,0,-12
5985,0,0,18,0,-18
5986,1,1,466,1672,1206
5987,0,0,59,0,-59
5988,1,0,62,0,-62
5989,1,0,7,0,-7
5990,1,0,26,0,-26
5991,0,0,46,0,-46
5992,0,0,16,0,-16
5993,0,0,84,0,-84
5994,1,1,309,1451,1142
5995,0,0,93,0,-93
5996,0,0,5,0,-5
5997,1,0,32,0,-32
5998,1,1,248,1459,1211
5999,0,0,196,0,-196
6000,0,0,36,0,-36
6001,1,0,35,0,-35
6002,1,0,25,0,-25
6003,1,1,305,1436,1131
6004,1,1,1909,1249,-660
6005,1,0,16,0,-16
6006,0,0,64,0,-64
6007,0,0,101,0,-101
6008,1,0,10,0,-10
6009,1,1,107,1222,1115
6010,0,0,178,0,-178
6011,1,1,84,1805,1721
6012,1,0,5,0,-5
6013,0,0,20,0,-20
6014,0,0,32,0,-32
6015,1,1,346,1629,1283
6016,0,0,97,0,-97
6017,1,0,40,0,-40
6018,0,0,35,0,-35
6019,0,0,2,0,-2
6020,1,1,435,1396,961
6021,1,1,46,1465,1419
6022,1,0,63,0,-63
6023,0,0,13,0,-13
6024,0,0,26,0,-26
6025,1,1,335,1244,909
6026,0,0,145,0,-145
6027,1,0,0,0,0
6028,1,0,70,0,-70
6029,1,1,1333,1626,293
6030,0,0,80,0,-80
6031,1,0,47,0,-47
6032,1,0,56,0,-56
6033,1,0,31,0,-31
6034,0,0,28,0,-28
6035,1,0,45,0,-45
6036,1,0,14,0,-14
6037,1,0,14,0,-14
6038,1,1,188,1608,1420
6039,1,1,184,1284,1100
6040,0,0,92,0,-92
6041,1,0,9,0,-9
6042,1,1,743,1573,830
6043,1,1,75,1491,1416
6044,0,0,68,0,-68
6045,1,0,74,0,-74
6046,0,0,76,0,-76
6047,1,0,76,0,-76
6048,1,0,36,0,-36
6049,1,0,35,0,-35
6050,1,0,37,0,-37
6051,1,0,26,0,-26
6052,0,0,246,0,-246
6053,1,0,35,0,-35
6054,1,0,12,0,-12
6055,1,1,1229,1296,67
6056,1,0,12,0,-12
6057,0,0,12,0,-12
6058,1,1,740,1316,576
6059,0,0,91,0,-91
6060,1,0,19,0,-19
6061,1,0,5,0,-5
6062,0,0,13,0,-13
6063,1,0,29,0,-29
6064,0,0,6,0,-6
6065,1,1,253,1213,960
6066,1,1,700,1225,525
6067,0,0,48,0,-48
6068,0,0,28,0,-28
6069,0,0,106,0,-106
6070,0,0,66,0,-66
6071,0,0,286,0,-286
6072,0,0,65,0,-65
6073,1,1,862,1789,927
6074,0,0,20,0,-20
6075,0,0,103,0,-103
6076,1,1,888,1240,352
6077,0,0,64,0,-64
6078,1,0,54,0,-54
6079,1,1,165,1776,1611
6080,0,0,269,0,-269
6081,1,0,103,0,-103
6082,1,0,19,0,-19
6083,1,0,1,0,-1
6084,0,0,49,0,-49
6085,1,0,14,0,-14
6086,0,0,105,0,-105
6087,1,0,17,0,-17
6088,1,1,14,1267,1253
6089,0,0,143,0,-143
6090,1,0,86,0,-86
6091,1,0,65,0,-65
6092,0,0,43,0,-43
6093,1,0,29,0,-29
6094,0,0,249,0,-249
6095,1,1,456,1525,1069
6096,0,0,8,0,-8
6097,1,1,43,1279,1236
6098,1,0,0,0,0
6099,1,0,9,0,-9
6100,1,1,179,1370,1191
6101,1,1,406,1263,857
6102,0,0,18,0,-18
6103,0,0,58,0,-58
6104,1,1,804,1473,669
6105,0,0,2,0,-2
6106,1,0,12,0,-12
6107,1,0,140,0,-140
6108,1,1,543,1207,664
6109,1,0,2,0,-2
6110,1,0,43,0,-43
6111,1,1,2144,2054,-90
6112,0,0,22,0,-22
6113,1,0,74,0,-74
6114,0,0,129,0,-129
6115,0,0,58,0,-58
6116,0,0,46,0,-46
6117,0,0,16,0,-16
6118,1,1,65,1239,1174
6119,1,0,0,0,0
6120,1,1,250,1735,1485
6121,0,0,20,0,-20
6122,1,1,203,1615,1412
6123,1,0,46,0,-46
6124,1,1,480,1440,960
6125,0,0,195,0,-195
6126,0,0,8,0,-8
6127,1,1,552,2262,1710
6128,1,0,47,0,-47
6129,0,0,36,0,-36
6130,1,1,185,1248,1063
6131,0,0,20,0,-20
6132,0,0,20,0,-20
6133,1,0,8,0,-8
6134,1,0,78,0,-78
6135,0,0,7,0,-7
6136,1,0,3,0,-3
6137,1,1,328,1307,979
6138,0,0,27,0,-27
6139,1,0,84,0,-84
6140,1,1,512,1561,1049
6141,1,0,91,0,-91
6142,0,0,50,0,-50
6143,1,0,9,0,-9
6144,1,0,22,0,-22
6145,1,1,1070,1437,367
6146,1,0,14,0,-14
6147,1,1,304,1313,1009
6148,1,0,22,0,-22
6149,1,0,9,0,-9
6150,1,1,3072,1380,-1692
6151,1,1,128,1294,1166
6152,0,0,53,0,-53
6153,1,1,200,1714,1514
6154,1,1,73,2104,2031
6155,0,0,6,0,-6
6156,1,0,113,0,-113
6157,1,0,25,0,-25
6158,1,1,204,2021,1817
6159,0,0,45,0,-45
6160,0,0,42,0,-42
6161,1,0,103,0,-103
6162,1,0,84,0,-84
6163,1,0,52,0,-52
6164,0,0,21,0,-21
6165,1,1,334,2004,1670
6166,1,1,682,1241,559
6167,1,1,540,1522,982
6168,1,0,25,0,-25
6169,0,0,152,0,-152
6170,0,0,30,0,-30
6171,1,0,42,0,-42
6172,0,0,111,0,-111
6173,0,0,12,0,-12
6174,1,0,44,0,-44
6175,1,1,266,1307,1041
6176,0,0,99,0,-99
6177,1,1,149,2189,2040
6178,0,0,45,0,-45
6179,0,0,13,0,-13
6180,1,1,273,1573,1300
6181,1,1,277,1356,1079
6182,0,0,1,0,-1
6183,1,0,17,0,-17
6184,1,1,345,2722,2377
6185,0,0,150,0,-150
6186,0,0,10,0,-10
6187,1,1,221,1216,995
6188,1,0,10,0,-10
6189,1,0,76,0,-76
6190,1,0,10,0,-10
6191,1,1,539,1422,883
6192,0,0,4,0,-4
6193,0,0,9,0,-9
6194,0,0,15,0,-15
6195,1,0,8,0,-8
6196,1,1,1768,1205,-563
6197,1,0,41,0,-41
6198,0,0,45,0,-45
6199,1,1,156,2686,2530
6200,0,0,22,0,-22
6201,0,0,12,0,-12
6202,0,0,65,0,-65
6203,1,1,1500,2078,578
6204,1,1,670,1795,1125
6205,1,0,49,0,-49
6206,1,1,91,1348,1257
6207,0,0,238,0,-238
6208,1,1,388,1651,1263
6209,1,1,25,1458,1433
6210,1,0,31,0,-31
6211,1,1,182,1736,1554
6212,0,0,57,0,-57
6213,1,1,1050,1249,199
6214,1,0,3,0,-3
6215,0,0,13,0,-13
6216,1,1,360,2328,1968
6217,1,0,62,0,-62
6218,1,0,45,0,-45
6219,1,0,0,0,0
6220,0,0,1,0,-1
6221,1,0,71,0,-71
6222,1,0,8,0,-8
6223,1,1,996,1841,845
6224,1,1,896,1792,896
6225,1,1,382,1581,1199
6226,1,1,854,1662,808
6227,1,1,318,1707,1389
6228,1,0,23,0,-23
6229,0,0,14,0,-14
6230,0,0,4,0,-4
6231,0,0,9,0,-9
6232,0,0,35,0,-35
6233,0,0,3,0,-3
6234,0,0,23,0,-23
6235,0,0,116,0,-116
6236,1,1,288,1307,1019
6237,1,1,1188,1626,438
6238,1,0,78,0,-78
6239,1,0,19,0,-19
6240,1,1,253,1288,1035
6241,1,1,318,1770,1452
6242,1,0,71,0,-71
6243,1,1,904,1368,464
6244,1,1,2011,1293,-718
6245,1,1,234,1296,1062
6246,1,1,200,1245,1045
6247,1,1,1331,1259,-72
6248,0,0,18,0,-18
6249,0,0,62,0,-62
6250,1,0,6,0,-6
6251,1,0,65,0,-65
6252,1,0,58,0,-58
6253,0,0,32,0,-32
6254,1,0,43,0,-43
6255,0,0,43,0,-43
6256,1,0,27,0,-27
6257,0,0,4,0,-4
6258,1,0,3,0,-3
6259,1,1,129,1683,1554
6260,0,0,20,0,-20
6261,1,1,154,1264,1110
6262,0,0,42,0,-42
6263,1,0,7,0,-7
6264,1,1,579,1954,1375
6265,1,0,73,0,-73
6266,0,0,142,0,-142
6267,1,0,18,0,-18
6268,0,0,108,0,-108
6269,1,0,97,0,-97
6270,1,0,97,0,-97
6271,1,1,851,1256,405
6272,0,0,0,0,0
6273,0,0,23,0,-23
6274,1,0,87,0,-87
6275,0,0,47,0,-47
6276,0,0,51,0,-51
6277,1,0,11,0,-11
6278,0,0,106,0,-106
6279,1,0,6,0,-6
6280,1,1,122,1416,1294
6281,1,1,30,1465,1435
6282,0,0,49,0,-49
6283,0,0,26,0,-26
6284,1,0,48,0,-48
6285,0,0,118,0,-118
6286,0,0,19,0,-19
6287,0,0,21,0,-21
6288,0,0,31,0,-31
6289,0,0,29,0,-29
6290,1,1,442,1410,968
6291,0,0,10,0,-10
6292,1,0,3,0,-3
6293,0,0,32,0,-32
6294,1,1,73,1676,1603
6295,0,0,92,0,-92
6296,1,0,39,0,-39
6297,1,1,256,1478,1222
6298,0,0,240,0,-240
6299,0,0,85,0,-85
6300,1,1,349,4338,3989
6301,1,1,985,1818,833
6302,0,0,110,0,-110
6303,1,0,43,0,-43
6304,0,0,20,0,-20
6305,1,1,370,1700,1330
6306,1,0,35,0,-35
6307,0,0,31,0,-31
6308,0,0,2,0,-2
6309,0,0,30,0,-30
6310,1,1,106,1908,1802
6311,0,0,6,0,-6
6312,0,0,2,0,-2
6313,0,0,11,0,-11
6314,1,1,264,1406,1142
6315,0,0,35,0,-35
6316,0,0,3,0,-3
6317,0,0,19,0,-19
6318,1,0,74,0,-74
6319,1,1,164,3118,2954
6320,0,0,55,0,-55
6321,0,0,62,0,-62
6322,1,1,188,1271,1083
6323,1,0,16,0,-16
6324,0,0,99,0,-99
6325,1,1,135,1491,1356
6326,1,1,283,1377,1094
6327,0,0,223,0,-223
6328,0,0,2,0,-2
6329,1,1,275,1547,1272
6330,0,0,60,0,-60
6331,1,1,459,1360,901
6332,0,0,55,0,-55
6333,1,0,147,0,-147
6334,1,1,71,1270,1199
6335,1,1,107,1297,1190
6336,0,0,3,0,-3
6337,1,0,11,0,-11
6338,0,0,41,0,-41
6339,1,1,208,1371,1163
6340,1,0,30,0,-30
6341,0,0,29,0,-29
6342,0,0,94,0,-94
6343,1,0,81,0,-81
6344,0,0,7,0,-7
6345,1,1,703,1293,590
6346,0,0,45,0,-45
6347,1,0,8,0,-8
6348,1,0,6,0,-6
6349,0,0,42,0,-42
6350,1,0,40,0,-40
6351,1,0,7,0,-7
6352,1,1,302,1704,1402
6353,0,0,13,0,-13
6354,0,0,14,0,-14
6355,1,1,421,1328,907
6356,1,0,17,0,-17
6357,0,0,56,0,-56
6358,1,0,50,0,-50
6359,1,1,2600,2398,-202
6360,1,0,12,0,-12
6361,1,1,2558,1254,-1304
6362,1,1,224,1668,1444
6363,0,0,103,0,-103
6364,0,0,47,0,-47
6365,1,1,241,1750,1509
6366,0,0,119,0,-119
6367,1,0,0,0,0
6368,0,0,2,0,-2
6369,0,0,174,0,-174
6370,1,1,339,1481,1142
6371,1,0,55,0,-55
6372,0,0,31,0,-31
6373,1,1,1336,1777,441
6374,1,1,317,1267,950
6375,0,0,0,0,0
6376,1,0,13,0,-13
6377,0,0,149,0,-149
6378,1,0,40,0,-40
6379,1,1,1410,1497,87
6380,1,0,50,0,-50
6381,1,1,1350,1506,156
6382,1,1,760,1208,448
6383,0,0,84,0,-84
6384,0,0,17,0,-17
6385,1,1,383,1319,936
6386,1,0,10,0,-10
6387,1,0,154,0,-154
6388,1,0,89,0,-89
6389,1,1,284,1248,964
6390,1,1,246,1377,1131
6391,1,1,400,1349,949
6392,1,1,130,1640,1510
6393,0,0,163,0,-163
6394,1,0,6,0,-6
6395,0,0,94,0,-94
6396,0,0,23,0,-23
6397,1,1,242,1247,1005
6398,0,0,438,0,-438
6399,0,0,95,0,-95
6400,0,0,8,0,-8
6401,0,0,65,0,-65
6402,0,0,21,0,-21
6403,0,0,40,0,-40
6404,1,0,23,0,-23
6405,0,0,63,0,-63
6406,0,0,5,0,-5
6407,0,0,45,0,-45
6408,1,1,211,1326,1115
6409,1,0,140,0,-140
6410,1,0,38,0,-38
6411,1,1,955,1234,279
6412,1,0,48,0,-48
6413,1,1,72,1208,1136
6414,0,0,143,0,-143
6415,1,1,631,1274,643
6416,0,0,42,0,-42
6417,0,0,10,0,-10
6418,1,1,203,1457,1254
6419,1,1,288,1226,938
6420,1,1,409,1410,1001
6421,1,1,602,1374,772
6422,0,0,72,0,-72
6423,0,0,84,0,-84
6424,1,1,344,1331,987
6425,0,0,109,0,-109
6426,0,0,41,0,-41
6427,0,0,33,0,-33
6428,0,0,124,0,-124
6429,1,1,269,1501,1232
6430,1,0,11,0,-11
6431,1,0,40,0,-40
6432,0,0,24,0,-24
6433,0,0,70,0,-70
6434,0,0,3,0,-3
6435,1,1,437,1439,1002
6436,0,0,19,0,-19
6437,0,0,70,0,-70
6438,0,0,18,0,-18
6439,1,0,88,0,-88
6440,0,0,69,0,-69
6441,0,0,50,0,-50
6442,0,0,10,0,-10
6443,0,0,21,0,-21
6444,1,1,304,1467,1163
6445,1,1,120,1582,1462
6446,0,0,103,0,-103
6447,1,1,210,1239,1029
6448,1,0,1,0,-1
6449,0,0,101,0,-101
6450,0,0,218,0,-218
6451,1,0,63,0,-63
6452,0,0,0,0,0
6453,1,0,87,0,-87
6454,0,0,11,0,-11
6455,1,1,2336,2372,36
6456,1,1,1752,1357,-395
6457,0,0,101,0,-101
6458,0,0,34,0,-34
6459,1,1,2081,1655,-426
6460,1,0,82,0,-82
6461,1,1,1866,1808,-58
6462,1,0,65,0,-65
6463,0,0,65,0,-65
6464,1,1,253,2103,1850
6465,0,0,65,0,-65
6466,0,0,55,0,-55
6467,1,0,7,0,-7
6468,1,1,1070,1496,426
6469,1,0,28,0,-28
6470,1,1,1929,1208,-721
6471,1,0,49,0,-49
6472,0,0,11,0,-11
6473,0,0,115,0,-115
6474,0,0,79,0,-79
6475,0,0,133,0,-133
6476,0,0,8,0,-8
6477,0,0,15,0,-15
6478,0,0,19,0,-19
6479,0,0,10,0,-10
6480,1,0,48,0,-48
6481,1,1,932,1352,420
6482,1,0,32,0,-32
6483,1,1,146,1338,1192
6484,1,1,1002,1431,429
6485,1,0,43,0,-43
6486,1,0,88,0,-88
6487,1,1,177,1616,1439
6488,0,0,12,0,-12
6489,1,0,83,0,-83
6490,0,0,202,0,-202
6491,0,0,115,0,-115
6492,1,0,23,0,-23
6493,1,0,47,0,-47
6494,1,0,0,0,0
6495,0,0,10,0,-10
6496,1,0,21,0,-21
6497,0,0,7,0,-7
6498,1,1,327,1224,897
6499,1,0,25,0,-25
6500,0,0,15,0,-15
6501,1,0,20,0,-20
6502,0,0,56,0,-56
6503,0,0,157,0,-157
6504,1,0,121,0,-121
6505,0,0,1,0,-1
6506,0,0,46,0,-46
6507,0,0,4,0,-4
6508,1,0,9,0,-9
6509,1,0,17,0,-17
6510,0,0,72,0,-72
6511,0,0,44,0,-44
6512,1,0,21,0,-21
6513,0,0,69,0,-69
6514,0,0,2,0,-2
6515,1,0,44,0,-44
6516,1,0,74,0,-74
6517,0,0,54,0,-54
6518,1,0,4,0,-4
6519,1,1,212,1377,1165
6520,1,0,13,0,-13
6521,1,1,77,1697,1620
6522,0,0,43,0,-43
6523,0,0,7,0,-7
6524,1,0,49,0,-49
6525,0,0,0,0,0
6526,0,0,37,0,-37
6527,1,0,1,0,-1
6528,0,0,37,0,-37
6529,1,0,59,0,-59
6530,0,0,29,0,-29
6531,0,0,31,0,-31
6532,0,0,76,0,-76
6533,1,1,69,1434,1365
6534,1,0,55,0,-55
6535,1,1,343,1940,1597
6536,0,0,55,0,-55
6537,0,0,49,0,-49
6538,0,0,59,0,-59
6539,1,0,72,0,-72
6540,1,0,22,0,-22
6541,1,1,489,1714,1225
6542,1,0,87,0,-87
6543,1,1,162,1232,1070
6544,0,0,66,0,-66
6545,0,0,12,0,-12
6546,0,0,78,0,-78
6547,1,0,46,0,-46
6548,1,0,143,0,-143
6549,1,1,18,1440,1422
6550,0,0,132,0,-132
6551,1,1,1781,1290,-491
6552,1,0,28,0,-28
6553,1,1,1059,1675,616
6554,0,0,28,0,-28
6555,0,0,91,0,-91
6556,0,0,159,0,-159
6557,0,0,89,0,-89
6558,1,0,11,0,-11
6559,1,1,100,1616,1516
6560,0,0,20,0,-20
6561,0,0,10,0,-10
6562,0,0,29,0,-29
6563,1,0,0,0,0
6564,0,0,13,0,-13
6565,0,0,18,0,-18
6566,1,0,15,0,-15
6567,1,0,15,0,-15
6568,1,0,27,0,-27
6569,0,0,52,0,-52
6570,1,1,585,1952,1367
6571,1,1,400,2008,1608
6572,1,0,26,0,-26
6573,1,0,73,0,-73
6574,1,0,4,0,-4
6575,0,0,0,0,0
6576,1,0,40,0,-40
6577,0,0,48,0,-48
6578,1,1,43,1294,1251
6579,1,1,632,2057,1425
6580,0,0,83,0,-83
6581,0,0,55,0,-55
6582,1,1,494,1293,799
6583,1,0,31,0,-31
6584,0,0,60,0,-60
6585,0,0,33,0,-33
6586,1,0,5,0,-5
6587,0,0,13,0,-13
6588,1,0,63,0,-63
6589,0,0,30,0,-30
6590,1,0,102,0,-102
6591,1,1,1381,1699,318
6592,0,0,0,0,0
6593,0,0,12,0,-12
6594,1,0,112,0,-112
6595,0,0,5,0,-5
6596,0,0,65,0,-65
6597,1,1,109,1353,1244
6598,0,0,13,0,-13
6599,1,0,70,0,-70
6600,1,1,101,3854,3753
6601,1,0,24,0,-24
6602,1,1,486,1906,1420
6603,0,0,14,0,-14
6604,1,0,10,0,-10
6605,1,0,10,0,-10
6606,1,0,135,0,-135
6607,1,1,937,1945,1008
6608,1,1,264,2667,2403
6609,1,1,161,1675,1514
6610,1,1,765,1292,527
6611,0,0,28,0,-28
6612,0,0,18,0,-18
6613,0,0,82,0,-82
6614,0,0,31,0,-31
6615,0,0,28,0,-28
6616,1,1,136,1472,1336
6617,1,1,1047,1235,188
6618,0,0,18,0,-18
6619,1,0,61,0,-61
6620,1,0,12,0,-12
6621,0,0,120,0,-120
6622,0,0,154,0,-154
6623,1,1,693,1678,985
6624,0,0,38,0,-38
6625,0,0,6,0,-6
6626,1,1,114,1616,1502
6627,1,0,17,0,-17
6628,1,1,302,1238,936
6629,0,0,48,0,-48
6630,1,0,6,0,-6
6631,0,0,142,0,-142
6632,0,0,69,0,-69
6633,1,1,162,2304,2142
6634,1,1,225,1473,1248
6635,1,1,148,1221,1073
6636,0,0,3,0,-3
6637,0,0,42,0,-42
6638,0,0,30,0,-30
6639,0,0,144,0,-144
6640,0,0,25,0,-25
6641,0,0,43,0,-43
6642,0,0,46,0,-46
6643,1,1,280,1272,992
6644,0,0,94,0,-94
6645,0,0,0,0,0
6646,1,1,632,2686,2054
6647,0,0,3,0,-3
6648,1,1,665,1467,802
6649,1,1,259,1201,942
6650,0,0,24,0,-24
6651,1,0,27,0,-27
6652,0,0,63,0,-63
6653,1,1,760,1496,736
6654,0,0,36,0,-36
6655,1,0,25,0,-25
6656,1,1,225,1840,1615
6657,1,1,155,1318,1163
6658,1,1,296,1560,1264
6659,0,0,12,0,-12
6660,0,0,1,0,-1
6661,0,0,4,0,-4
6662,1,1,104,2048,1944
6663,1,1,1320,1328,8
6664,0,0,60,0,-60
6665,1,1,464,1278,814
6666,1,0,31,0,-31
6667,1,0,29,0,-29
6668,0,0,25,0,-25
6669,1,0,88,0,-88
6670,0,0,13,0,-13
6671,1,1,680,1990,1310
6672,1,0,8,0,-8
6673,0,0,134,0,-134
6674,1,1,753,1285,532
6675,1,1,526,1397,871
6676,1,0,59,0,-59
6677,0,0,24,0,-24
6678,1,1,737,1363,626
6679,1,0,10,0,-10
6680,1,0,13,0,-13
6681,1,1,826,1592,766
6682,0,0,68,0,-68
6683,0,0,61,0,-61
6684,1,0,12,0,-12
6685,1,1,88,2272,2184
6686,1,1,149,2273,2124
6687,0,0,24,0,-24
6688,0,0,23,0,-23
6689,1,0,33,0,-33
6690,1,1,1004,2540,1536
6691,0,0,50,0,-50
6692,1,1,791,1497,706
6693,1,1,167,1292,1125
6694,0,0,9,0,-9
6695,0,0,442,0,-442
6696,1,1,160,1335,1175
6697,1,1,449,1229,780
6698,1,1,288,3543,3255
6699,0,0,0,0,0
6700,1,1,2593,1573,-1020
6701,1,0,24,0,-24
6702,1,0,12,0,-12
6703,1,1,981,1370,389
6704,0,0,138,0,-138
6705,1,0,7,0,-7
6706,0,0,144,0,-144
6707,0,0,119,0,-119
6708,1,0,72,0,-72
6709,0,0,12,0,-12
6710,0,0,50,0,-50
6711,1,1,215,1585,1370
6712,0,0,20,0,-20
6713,1,1,962,1241,279
6714,1,0,1,0,-1
6715,0,0,32,0,-32
6716,0,0,124,0,-124
6717,1,0,95,0,-95
6718,1,0,83,0,-83
6719,1,0,7,0,-7
6720,0,0,6,0,-6
6721,0,0,19,0,-19
6722,1,0,23,0,-23
6723,1,1,983,1413,430
6724,0,0,2,0,-2
6725,0,0,116,0,-116
6726,0,0,18,0,-18
6727,1,1,109,1269,1160
6728,1,0,6,0,-6
6729,0,0,61,0,-61
6730,0,0,115,0,-115
6731,0,0,82,0,-82
6732,0,0,75,0,-75
6733,0,0,28,0,-28
6734,1,0,3,0,-3
6735,1,1,842,1470,628
6736,0,0,21,0,-21
6737,1,1,163,1504,1341
6738,1,1,167,1428,1261
6739,1,1,582,2326,1744
6740,0,0,2,0,-2
6741,0,0,126,0,-126
6742,0,0,26,0,-26
6743,1,1,268,1244,976
6744,1,1,1376,1221,-155
6745,0,0,57,0,-57
6746,0,0,49,0,-49
6747,0,0,137,0,-137
6748,1,0,124,0,-124
6749,0,0,82,0,-82
6750,0,0,6,0,-6
6751,1,1,298,1473,1175
6752,1,0,103,0,-103
6753,0,0,65,0,-65
6754,1,0,95,0,-95
6755,1,1,908,1841,933
6756,0,0,99,0,-99
6757,0,0,60,0,-60
6758,1,0,25,0,-25
6759,0,0,39,0,-39
6760,1,0,122,0,-122
6761,0,0,16,0,-16
6762,0,0,82,0,-82
6763,0,0,53,0,-53
6764,0,0,5,0,-5
6765,1,0,45,0,-45
6766,0,0,34,0,-34
6767,1,0,22,0,-22
6768,0,0,57,0,-57
6769,0,0,106,0,-106
6770,1,0,38,0,-38
6771,1,0,35,0,-35
6772,1,0,46,0,-46
6773,1,1,513,2010,1497
6774,1,0,69,0,-69
6775,1,1,700,1581,881
6776,1,1,272,3245,2973
6777,1,1,407,1247,840
6778,1,0,4,0,-4
6779,1,1,786,1230,444
6780,1,0,15,0,-15
6781,0,0,98,0,-98
6782,1,1,527,1902,1375
6783,0,0,84,0,-84
6784,0,0,21,0,-21
6785,0,0,3,0,-3
6786,0,0,36,0,-36
6787,0,0,119,0,-119
6788,0,0,14,0,-14
6789,1,0,177,0,-177
6790,0,0,49,0,-49
6791,1,1,964,1293,329
6792,1,1,1143,1268,125
6793,0,0,124,0,-124
6794,0,0,99,0,-99
6795,1,1,218,1224,1006
6796,1,0,9,0,-9
6797,0,0,205,0,-205
6798,1,1,98,1793,1695
6799,1,0,41,0,-41
6800,1,0,18,0,-18
6801,0,0,108,0,-108
6802,0,0,67,0,-67
6803,0,0,104,0,-104
6804,0,0,45,0,-45
6805,0,0,56,0,-56
6806,0,0,140,0,-140
6807,0,0,96,0,-96
6808,0,0,15,0,-15
6809,1,1,407,1825,1418
6810,1,1,72,1378,1306
6811,0,0,83,0,-83
6812,1,1,82,1390,1308
6813,1,0,38,0,-38
6814,1,1,365,1380,1015
6815,0,0,24,0,-24
6816,0,0,17,0,-17
6817,1,0,81,0,-81
6818,0,0,189,0,-189
6819,0,0,17,0,-17
6820,1,1,2292,1243,-1049
6821,1,0,8,0,-8
6822,0,0,95,0,-95
6823,1,1,978,1947,969
6824,0,0,13,0,-13
6825,1,0,64,0,-64
6826,1,1,561,1592,1031
6827,1,1,1490,1384,-106
6828,1,1,888,1256,368
6829,1,1,115,2881,2766
6830,0,0,57,0,-57
6831,0,0,54,0,-54
6832,0,0,5,0,-5
6833,0,0,55,0,-55
6834,1,1,44,1203,1159
6835,1,1,1184,2297,1113
6836,0,0,6,0,-6
6837,1,0,38,0,-38
6838,0,0,15,0,-15
6839,0,0,52,0,-52
6840,0,0,93,0,-93
6841,0,0,7,0,-7
6842,1,1,226,1351,1125
6843,1,1,240,1371,1131
6844,0,0,73,0,-73
6845,0,0,85,0,-85
6846,1,0,20,0,-20
6847,0,0,47,0,-47
6848,0,0,54,0,-54
6849,1,0,143,0,-143
6850,0,0,19,0,-19
6851,1,0,0,0,0
6852,1,0,11,0,-11
6853,1,1,148,1776,1628
6854,0,0,122,0,-122
6855,0,0,40,0,-40
6856,1,1,280,4447,4167
6857,0,0,117,0,-117
6858,0,0,100,0,-100
6859,1,1,472,1438,966
6860,1,0,164,0,-164
6861,1,1,225,1334,1109
6862,1,0,36,0,-36
6863,1,0,24,0,-24
6864,1,1,1688,1243,-445
6865,1,0,70,0,-70
6866,1,0,44,0,-44
6867,1,1,209,1513,1304
6868,0,0,122,0,-122
6869,0,0,53,0,-53
6870,1,1,654,1257,603
6871,1,0,36,0,-36
6872,0,0,10,0,-10
6873,1,0,4,0,-4
6874,0,0,18,0,-18
6875,1,1,89,1408,1319
6876,1,1,10,1638,1628
6877,0,0,1,0,-1
6878,0,0,79,0,-79
6879,1,0,96,0,-96
6880,1,0,20,0,-20
6881,0,0,11,0,-11
6882,1,0,22,0,-22
6883,1,1,276,1200,924
6884,1,1,2143,1260,-883
6885,1,1,631,2055,1424
6886,1,0,46,0,-46
6887,1,1,1860,1203,-657
6888,0,0,21,0,-21
6889,1,1,1368,1617,249
6890,1,1,173,1611,1438
6891,1,1,669,2909,2240
6892,1,0,34,0,-34
6893,1,1,264,1330,1066
6894,1,1,68,1360,1292
6895,1,0,35,0,-35
6896,1,1,575,1332,757
6897,1,1,299,1739,1440
6898,1,0,373,0,-373
6899,0,0,38,0,-38
6900,0,0,25,0,-25
6901,1,0,49,0,-49
6902,0,0,91,0,-91
6903,1,0,48,0,-48
6904,0,0,140,0,-140
6905,1,1,99,1256,1157
6906,0,0,31,0,-31
6907,1,0,89,0,-89
6908,1,0,65,0,-65
6909,1,1,312,1399,1087
6910,1,1,794,1448,654
6911,1,0,25,0,-25
6912,1,0,18,0,-18
6913,1,1,139,1378,1239
6914,0,0,11,0,-11
6915,1,1,60,1332,1272
6916,1,1,158,1527,1369
6917,1,1,250,1356,1106
6918,1,0,8,0,-8
6919,0,0,29,0,-29
6920,1,1,132,1205,1073
6921,1,1,931,1303,372
6922,0,0,19,0,-19
6923,0,0,2,0,-2
6924,1,0,20,0,-20
6925,1,1,601,1216,615
6926,1,1,522,1452,930
6927,0,0,55,0,-55
6928,1,0,26,0,-26
6929,0,0,59,0,-59
6930,0,0,54,0,-54
6931,1,0,6,0,-6
6932,0,0,24,0,-24
6933,1,1,157,1353,1196
6934,1,0,19,0,-19
6935,1,1,244,1270,1026
6936,1,0,47,0,-47
6937,1,1,313,1283,970
6938,1,1,1013,2653,1640
6939,1,0,57,0,-57
6940,1,0,108,0,-108
6941,1,0,23,0,-23
6942,1,0,12,0,-12
6943,0,0,148,0,-148
6944,1,0,114,0,-114
6945,0,0,40,0,-40
6946,0,0,0,0,0
6947,1,1,115,1385,1270
6948,1,1,381,1376,995
6949,1,1,1043,1431,388
6950,1,1,17,1306,1289
6951,0,0,87,0,-87
6952,1,1,611,1448,837
6953,0,0,34,0,-34
6954,1,0,46,0,-46
6955,0,0,64,0,-64
6956,1,0,70,0,-70
6957,1,0,37,0,-37
6958,1,0,56,0,-56
6959,1,0,24,0,-24
6960,1,1,452,1244,792
6961,0,0,7,0,-7
6962,0,0,85,0,-85
6963,1,0,46,0,-46
6964,0,0,56,0,-56
6965,0,0,109,0,-109
6966,1,1,673,1226,553
6967,1,0,51,0,-51
6968,0,0,25,0,-25
6969,1,0,27,0,-27
6970,1,1,131,1897,1766
6971,1,0,9,0,-9
6972,0,0,159,0,-159
6973,0,0,14,0,-14
6974,0,0,15,0,-15
6975,0,0,19,0,-19
6976,0,0,32,0,-32
6977,1,0,38,0,-38
6978,0,0,65,0,-65
6979,1,1,478,1777,1299
6980,1,1,231,1204,973
6981,0,0,34,0,-34
6982,0,0,25,0,-25
6983,0,0,4,0,-4
6984,1,1,637,1463,826
6985,1,0,85,0,-85
6986,1,0,2,0,-2
6987,0,0,5,0,-5
6988,1,0,7,0,-7
6989,1,0,43,0,-43
6990,0,0,151,0,-151
6991,0,0,183,0,-183
6992,1,1,506,1770,1264
6993,1,1,927,1309,382
6994,0,0,29,0,-29
6995,1,1,410,1275,865
6996,0,0,99,0,-99
6997,0,0,86,0,-86
6998,1,0,126,0,-126
6999,0,0,1,0,-1
7000,1,1,321,1557,1236
7001,1,1,45,2882,2837
7002,0,0,108,0,-108
7003,1,0,83,0,-83
7004,0,0,240,0,-240
7005,1,0,221,0,-221
7006,1,1,225,2522,2297
7007,1,1,93,1490,1397
7008,1,1,340,1628,1288
7009,1,1,103,2409,2306
7010,1,0,24,0,-24
7011,0,0,17,0,-17
7012,1,1,694,1793,1099
7013,1,0,20,0,-20
7014,1,0,95,0,-95
7015,1,1,1706,1550,-156
7016,1,1,628,1628,1000
7017,0,0,13,0,-13
7018,1,1,95,1916,1821
7019,0,0,37,0,-37
7020,0,0,83,0,-83
7021,0,0,67,0,-67
7022,1,0,10,0,-10
7023,1,1,418,1376,958
7024,1,0,12,0,-12
7025,0,0,38,0,-38
7026,0,0,9,0,-9
7027,1,1,146,3171,3025
7028,0,0,39,0,-39
7029,1,0,11,0,-11
7030,0,0,67,0,-67
7031,1,0,54,0,-54
7032,1,0,51,0,-51
7033,0,0,2,0,-2
7034,1,1,263,1216,953
7035,1,1,886,3075,2189
7036,1,1,1354,1332,-22
7037,0,0,73,0,-73
7038,0,0,44,0,-44
7039,0,0,12,0,-12
7040,0,0,26,0,-26
7041,0,0,76,0,-76
7042,1,0,31,0,-31
7043,1,0,18,0,-18
7044,0,0,21,0,-21
7045,1,0,70,0,-70
7046,1,0,6,0,-6
7047,1,0,17,0,-17
7048,1,1,196,1407,1211
7049,1,1,662,1862,1200
7050,1,1,134,1473,1339
7051,0,0,5,0,-5
7052,1,1,120,1415,1295
7053,1,0,34,0,-34
7054,1,1,926,2401,1475
7055,0,0,41,0,-41
7056,1,1,211,1740,1529
7057,0,0,100,0,-100
7058,0,0,24,0,-24
7059,1,0,123,0,-123
7060,1,0,27,0,-27
7061,0,0,106,0,-106
7062,1,1,183,2173,1990
7063,0,0,45,0,-45
7064,0,0,67,0,-67
7065,1,0,19,0,-19
7066,0,0,2,0,-2
7067,1,0,68,0,-68
7068,0,0,7,0,-7
7069,1,0,5,0,-5
7070,1,1,425,1286,861
7071,0,0,104,0,-104
7072,1,0,6,0,-6
7073,1,1,762,1214,452
7074,0,0,25,0,-25
7075,0,0,2,0,-2
7076,0,0,58,0,-58
7077,0,0,32,0,-32
7078,0,0,44,0,-44
7079,1,0,78,0,-78
7080,1,1,237,3038,2801
7081,0,0,8,0,-8
7082,0,0,70,0,-70
7083,0,0,77,0,-77
7084,0,0,10,0,-10
7085,0,0,12,0,-12
7086,1,0,57,0,-57
7087,0,0,41,0,-41
7088,1,0,1,0,-1
7089,1,1,350,1565,1215
7090,1,1,449,1209,760
7091,1,0,42,0,-42
7092,1,0,14,0,-14
7093,1,0,70,0,-70
7094,1,0,157,0,-157
7095,1,1,721,1315,594
7096,1,0,34,0,-34
7097,1,1,852,1567,715
7098,0,0,4,0,-4
7099,0,0,5,0,-5
7100,0,0,26,0,-26
7101,1,1,1420,2382,962
7102,1,0,85,0,-85
7103,1,0,37,0,-37
7104,1,0,23,0,-23
7105,0,0,37,0,-37
7106,1,1,417,1634,1217
7107,0,0,125,0,-125
7108,1,1,1259,1607,348
7109,1,1,214,1369,1155
7110,0,0,40,0,-40
7111,0,0,110,0,-110
7112,1,0,18,0,-18
7113,0,0,5,0,-5
7114,1,0,40,0,-40
7115,1,0,27,0,-27
7116,1,0,49,0,-49
7117,0,0,9,0,-9
7118,1,0,17,0,-17
7119,0,0,20,0,-20
7120,1,1,112,1987,1875
7121,1,1,385,1874,1489
7122,0,0,70,0,-70
7123,1,0,95,0,-95
7124,0,0,10,0,-10
7125,0,0,39,0,-39
7126,0,0,83,0,-83
7127,0,0,2,0,-2
7128,1,1,687,1498,811
7129,1,1,1123,1307,184
7130,1,0,59,0,-59
7131,1,1,356,1704,1348
7132,1,1,1730,1679,-51
7133,1,1,569,1385,816
7134,0,0,34,0,-34
7135,0,0,22,0,-22
7136,1,0,0,0,0
7137,0,0,4,0,-4
7138,1,0,49,0,-49
7139,1,1,488,2307,1819
7140,0,0,29,0,-29
7141,0,0,31,0,-31
7142,1,1,456,1208,752
7143,1,0,12,0,-12
7144,1,0,176,0,-176
7145,1,0,175,0,-175
7146,1,1,122,1523,1401
7147,0,0,39,0,-39
7148,1,1,187,1391,1204
7149,0,0,36,0,-36
7150,1,1,426,1483,1057
7151,0,0,73,0,-73
7152,1,1,564,1446,882
7153,0,0,72,0,-72
7154,1,1,277,2599,2322
7155,0,0,62,0,-62
7156,1,1,362,1934,1572
7157,0,0,53,0,-53
7158,1,1,1207,1543,336
7159,0,0,61,0,-61
7160,1,1,1336,1279,-57
7161,1,0,66,0,-66
7162,1,0,31,0,-31
7163,0,0,34,0,-34
7164,1,1,144,1253,1109
7165,0,0,133,0,-133
7166,1,1,293,1860,1567
7167,1,1,285,1706,1421
7168,0,0,19,0,-19
7169,1,1,836,1372,536
7170,1,0,138,0,-138
7171,1,0,52,0,-52
7172,1,0,1,0,-1
7173,1,1,289,1489,1200
7174,1,1,732,1926,1194
7175,1,0,21,0,-21
7176,0,0,72,0,-72
7177,0,0,54,0,-54
7178,1,0,76,0,-76
7179,1,1,117,2422,2305
7180,1,0,10,0,-10
7181,1,0,6,0,-6
7182,0,0,40,0,-40
7183,0,0,8,0,-8
7184,1,1,362,1241,879
7185,0,0,15,0,-15
7186,1,1,113,1218,1105
7187,1,0,82,0,-82
7188,1,1,297,1382,1085
7189,1,0,46,0,-46
7190,1,1,990,1460,470
7191,1,1,118,1794,1676
7192,1,1,737,1305,568
7193,1,0,187,0,-187
7194,0,0,4,0,-4
7195,0,0,63,0,-63
7196,0,0,86,0,-86
7197,1,1,106,1612,1506
7198,1,0,128,0,-128
7199,0,0,12,0,-12
7200,1,1,69,1422,1353
7201,1,1,87,1276,1189
7202,1,1,1265,1734,469
7203,0,0,39,0,-39
7204,0,0,165,0,-165
7205,0,0,24,0,-24
7206,1,0,50,0,-50
7207,0,0,51,0,-51
7208,1,0,92,0,-92
7209,1,0,14,0,-14
7210,0,0,14,0,-14
7211,0,0,6,0,-6
7212,1,1,1031,1328,297
7213,1,1,312,1272,960
7214,1,1,436,1695,1259
7215,1,0,54,0,-54
7216,0,0,32,0,-32
7217,1,1,333,1356,1023
7218,0,0,173,0,-173
7219,0,0,110,0,-110
7220,1,1,402,1213,811
7221,0,0,51,0,-51
7222,1,1,536,1387,851
7223,1,1,283,1447,1164
7224,0,0,83,0,-83
7225,1,0,36,0,-36
7226,0,0,4,0,-4
7227,0,0,27,0,-27
7228,1,0,47,0,-47
7229,1,1,163,1282,1119
7230,1,0,39,0,-39
7231,1,0,5,0,-5
7232,0,0,16,0,-16
7233,1,1,680,1372,692
7234,1,1,120,1266,1146
7235,0,0,62,0,-62
7236,0,0,172,0,-172
7237,1,0,47,0,-47
7238,0,0,0,0,0
7239,0,0,17,0,-17
7240,0,0,80,0,-80
7241,0,0,43,0,-43
7242,0,0,39,0,-39
7243,1,1,41,1686,1645
7244,1,1,557,2141,1584
7245,1,0,87,0,-87
7246,1,1,609,1228,619
7247,1,1,760,1378,618
7248,1,1,256,1211,955
7249,1,1,482,1570,1088
7250,0,0,3,0,-3
7251,1,1,178,1359,1181
7252,1,1,547,1491,944
7253,0,0,41,0,-41
7254,1,0,36,0,-36
7255,1,1,254,1242,988
7256,1,1,736,1247,511
7257,1,0,52,0,-52
7258,0,0,36,0,-36
7259,1,1,233,1266,1033
7260,1,1,425,1637,1212
7261,0,0,42,0,-42
7262,0,0,48,0,-48
7263,1,0,11,0,-11
7264,1,0,22,0,-22
7265,0,0,36,0,-36
7266,1,1,868,1611,743
7267,0,0,0,0,0
7268,1,0,7,0,-7
7269,0,0,11,0,-11
7270,0,0,7,0,-7
7271,0,0,36,0,-36
7272,1,0,25,0,-25
7273,1,1,1139,2510,1371
7274,1,0,170,0,-170
7275,1,0,38,0,-38
7276,0,0,10,0,-10
7277,1,0,46,0,-46
7278,1,0,1,0,-1
7279,1,0,5,0,-5
7280,0,0,2,0,-2
7281,1,0,27,0,-27
7282,0,0,155,0,-155
7283,0,0,26,0,-26
7284,1,0,44,0,-44
7285,1,1,1150,1742,592
7286,0,0,91,0,-91
7287,1,0,60,0,-60
7288,1,1,138,1829,1691
7289,1,0,4,0,-4
7290,1,1,259,1956,1697
7291,1,0,15,0,-15
7292,0,0,7,0,-7
7293,0,0,219,0,-219
7294,1,1,826,1339,513
7295,0,0,67,0,-67
7296,0,0,20,0,-20
7297,0,0,23,0,-23
7298,0,0,41,0,-41
7299,0,0,42,0,-42
7300,0,0,3,0,-3
7301,1,1,1014,1350,336
7302,1,1,688,3065,2377
7303,1,0,100,0,-100
7304,0,0,171,0,-171
7305,1,1,221,1861,1640
7306,1,1,660,1233,573
7307,0,0,51,0,-51
7308,1,0,13,0,-13
7309,1,0,110,0,-110
7310,1,1,203,1478,1275
7311,1,1,685,1330,645
7312,1,0,39,0,-39
7313,1,1,92,2130,2038
7314,0,0,81,0,-81
7315,1,0,30,0,-30
7316,1,1,148,1302,1154
7317,1,1,840,1300,460
7318,1,1,822,2308,1486
7319,1,1,1211,1727,516
7320,0,0,4,0,-4
7321,1,1,1029,1322,293
7322,1,1,2264,1444,-820
7323,0,0,5,0,-5
7324,1,0,3,0,-3
7325,1,1,134,1264,1130
7326,1,1,970,2053,1083
7327,0,0,26,0,-26
7328,0,0,63,0,-63
7329,0,0,35,0,-35
7330,1,1,25,2473,2448
7331,0,0,270,0,-270
7332,0,0,13,0,-13
7333,0,0,32,0,-32
7334,0,0,7,0,-7
7335,1,1,156,1626,1470
7336,0,0,159,0,-159
7337,0,0,48,0,-48
7338,0,0,185,0,-185
7339,1,1,845,3529,2684
7340,1,1,47,1580,1533
7341,1,1,251,1424,1173
7342,0,0,55,0,-55
7343,1,1,38,1378,1340
7344,0,0,41,0,-41
7345,0,0,52,0,-52
7346,1,0,5,0,-5
7347,0,0,8,0,-8
7348,0,0,186,0,-186
7349,1,0,34,0,-34
7350,0,0,32,0,-32
7351,0,0,132,0,-132
7352,1,1,29,1378,1349
7353,0,0,51,0,-51
7354,1,1,191,1252,1061
7355,1,0,203,0,-203
7356,1,1,288,1218,930
7357,0,0,4,0,-4
7358,1,0,19,0,-19
7359,1,1,581,3346,2765
7360,1,0,14,0,-14
7361,0,0,69,0,-69
7362,1,1,703,1491,788
7363,0,0,39,0,-39
7364,0,0,5,0,-5
7365,0,0,15,0,-15
7366,0,0,98,0,-98
7367,0,0,0,0,0
7368,1,0,75,0,-75
7369,1,0,13,0,-13
7370,1,1,1561,1412,-149
7371,1,0,77,0,-77
7372,1,1,1293,1652,359
7373,0,0,46,0,-46
7374,1,0,117,0,-117
7375,1,0,27,0,-27
7376,0,0,15,0,-15
7377,1,1,978,2569,1591
7378,0,0,53,0,-53
7379,0,0,19,0,-19
7380,0,0,53,0,-53
7381,0,0,0,0,0
7382,1,0,9,0,-9
7383,0,0,64,0,-64
7384,1,1,922,1228,306
7385,0,0,11,0,-11
7386,1,1,148,1390,1242
7387,1,0,51,0,-51
7388,1,1,948,1289,341
7389,0,0,15,0,-15
7390,1,0,109,0,-109
7391,1,1,111,1201,1090
7392,1,1,319,1314,995
7393,1,0,51,0,-51
7394,0,0,61,0,-61
7395,1,0,140,0,-140
7396,1,0,5,0,-5
7397,0,0,57,0,-57
7398,1,1,751,1461,710
7399,0,0,29,0,-29
7400,1,0,41,0,-41
7401,1,0,41,0,-41
7402,0,0,3,0,-3
7403,1,0,142,0,-142
7404,0,0,8,0,-8
7405,1,0,18,0,-18
7406,1,0,70,0,-70
7407,1,1,208,1243,1035
7408,0,0,79,0,-79
7409,0,0,13,0,-13
7410,0,0,16,0,-16
7411,1,1,384,1408,1024
7412,0,0,34,0,-34
7413,0,0,72,0,-72
7414,1,1,1830,1716,-114
7415,1,0,159,0,-159
7416,0,0,171,0,-171
7417,0,0,30,0,-30
7418,0,0,83,0,-83
7419,1,0,96,0,-96
7420,1,0,61,0,-61
7421,1,1,240,1322,1082
7422,1,1,235,1206,971
7423,0,0,107,0,-107
7424,0,0,35,0,-35
7425,0,0,36,0,-36
7426,1,0,98,0,-98
7427,0,0,133,0,-133
7428,0,0,90,0,-90
7429,0,0,45,0,-45
7430,1,0,42,0,-42
7431,1,0,53,0,-53
7432,0,0,44,0,-44
7433,0,0,38,0,-38
7434,1,1,294,1255,961
7435,1,1,300,1247,947
7436,1,1,1218,1334,116
7437,1,0,26,0,-26
7438,1,1,366,3484,3118
7439,0,0,25,0,-25
7440,0,0,10,0,-10
7441,1,1,396,1219,823
7442,1,0,16,0,-16
7443,1,0,19,0,-19
7444,1,1,100,1426,1326
7445,1,0,49,0,-49
7446,1,0,67,0,-67
7447,1,1,491,1440,949
7448,0,0,219,0,-219
7449,1,1,1277,1448,171
7450,1,0,30,0,-30
7451,0,0,32,0,-32
7452,1,0,22,0,-22
7453,1,1,140,1578,1438
7454,1,1,1032,1206,174
7455,0,0,4,0,-4
7456,0,0,0,0,0
7457,0,0,15,0,-15
7458,0,0,29,0,-29
7459,1,1,199,2313,2114
7460,1,0,54,0,-54
7461,0,0,78,0,-78
7462,1,1,1209,1549,340
7463,0,0,13,0,-13
7464,1,0,22,0,-22
7465,0,0,44,0,-44
7466,1,1,719,1306,587
7467,1,0,46,0,-46
7468,0,0,50,0,-50
7469,1,0,53,0,-53
7470,1,0,47,0,-47
7471,1,1,374,1456,1082
7472,1,1,577,2938,2361
7473,0,0,26,0,-26
7474,1,0,22,0,-22
7475,1,1,745,1283,538
7476,0,0,32,0,-32
7477,1,0,39,0,-39
7478,0,0,12,0,-12
7479,1,1,716,1279,563
7480,1,0,69,0,-69
7481,0,0,111,0,-111
7482,1,0,182,0,-182
7483,0,0,56,0,-56
7484,1,0,98,0,-98
7485,0,0,14,0,-14
7486,1,0,11,0,-11
7487,1,0,36,0,-36
7488,0,0,125,0,-125
7489,1,1,349,1252,903
7490,0,0,29,0,-29
7491,1,1,1213,1296,83
7492,0,0,268,0,-268
7493,1,1,231,1287,1056
7494,0,0,1,0,-1
7495,1,0,30,0,-30
7496,0,0,162,0,-162
7497,0,0,20,0,-20
7498,1,0,26,0,-26
7499,0,0,0,0,0
7500,1,1,229,1610,1381
7501,0,0,9,0,-9
7502,0,0,5,0,-5
7503,0,0,38,0,-38
7504,1,0,44,0,-44
7505,1,0,244,0,-244
7506,1,1,1002,2349,1347
7507,0,0,103,0,-103
7508,1,1,291,1814,1523
7509,1,0,157,0,-157
7510,0,0,25,0,-25
7511,1,1,1062,1344,282
7512,1,1,158,2083,1925
7513,1,1,187,1541,1354
7514,1,0,39,0,-39
7515,0,0,15,0,-15
7516,1,0,39,0,-39
7517,0,0,80,0,-80
7518,0,0,18,0,-18
7519,1,1,252,1426,1174
7520,1,0,47,0,-47
7521,0,0,89,0,-89
7522,1,1,129,1745,1616
7523,1,0,8,0,-8
7524,1,0,57,0,-57
7525,0,0,18,0,-18
7526,0,0,27,0,-27
7527,0,0,58,0,-58
7528,1,1,721,1418,697
7529,0,0,11,0,-11
7530,1,1,1131,1585,454
7531,1,0,97,0,-97
7532,1,1,241,1215,974
7533,1,0,8,0,-8
7534,1,0,26,0,-26
7535,1,0,1,0,-1
7536,0,0,4,0,-4
7537,0,0,25,0,-25
7538,1,0,55,0,-55
7539,0,0,54,0,-54
7540,1,0,66,0,-66
7541,0,0,39,0,-39
7542,0,0,1,0,-1
7543,1,0,53,0,-53
7544,1,0,81,0,-81
7545,1,0,21,0,-21
7546,1,0,64,0,-64
7547,0,0,29,0,-29
7548,1,0,54,0,-54
7549,1,0,59,0,-59
7550,0,0,53,0,-53
7551,0,0,51,0,-51
7552,0,0,28,0,-28
7553,1,0,71,0,-71
7554,1,0,122,0,-122
7555,1,0,20,0,-20
7556,0,0,2,0,-2
7557,1,1,566,1233,667
7558,1,0,95,0,-95
7559,1,1,286,1535,1249
7560,0,0,71,0,-71
7561,1,0,20,0,-20
7562,1,1,275,1614,1339
7563,1,1,172,1505,1333
7564,1,1,441,1213,772
7565,1,0,15,0,-15
7566,0,0,41,0,-41
7567,0,0,13,0,-13
7568,1,1,665,1383,718
7569,0,0,3,0,-3
7570,1,1,1502,1989,487
7571,1,1,556,1396,840
7572,0,0,153,0,-153
7573,1,0,19,0,-19
7574,1,0,8,0,-8
7575,0,0,3,0,-3
7576,0,0,4,0,-4
7577,1,0,1,0,-1
7578,0,0,18,0,-18
7579,1,0,105,0,-105
7580,1,1,1210,2138,928
7581,1,0,317,0,-317
7582,1,1,84,1559,1475
7583,1,0,146,0,-146
7584,0,0,8,0,-8
7585,1,0,167,0,-167
7586,0,0,46,0,-46
7587,1,1,237,1383,1146
7588,1,1,644,1204,560
7589,0,0,26,0,-26
7590,0,0,10,0,-10
7591,0,0,57,0,-57
7592,1,1,554,2571,2017
7593,0,0,21,0,-21
7594,1,0,24,0,-24
7595,1,1,1262,1201,-61
7596,0,0,20,0,-20
7597,0,0,26,0,-26
7598,1,0,19,0,-19
7599,0,0,59,0,-59
7600,1,1,91,1267,1176
7601,1,1,1094,1279,185
7602,0,0,37,0,-37
7603,0,0,21,0,-21
7604,1,0,26,0,-26
7605,0,0,79,0,-79
7606,0,0,5,0,-5
7607,1,0,12,0,-12
7608,1,0,58,0,-58
7609,1,1,636,1408,772
7610,0,0,12,0,-12
7611,0,0,17,0,-17
7612,1,0,127,0,-127
7613,0,0,16,0,-16
7614,1,1,124,2210,2086
7615,0,0,269,0,-269
7616,1,0,17,0,-17
7617,1,1,374,1301,927
7618,1,0,59,0,-59
7619,1,1,186,1208,1022
7620,0,0,131,0,-131
7621,0,0,89,0,-89
7622,0,0,57,0,-57
7623,0,0,3,0,-3
7624,0,0,32,0,-32
7625,0,0,61,0,-61
7626,1,1,812,2126,1314
7627,1,0,25,0,-25
7628,1,1,193,1744,1551
7629,1,1,60,1220,1160
7630,0,0,3,0,-3
7631,0,0,120,0,-120
7632,1,0,40,0,-40
7633,1,0,34,0,-34
7634,0,0,69,0,-69
7635,1,1,417,1352,935
7636,1,1,322,1293,971
7637,1,1,1040,1538,498
7638,1,0,9,0,-9
7639,0,0,4,0,-4
7640,1,0,15,0,-15
7641,1,1,1894,2086,192
7642,1,1,911,1272,361
7643,1,0,40,0,-40
7644,0,0,45,0,-45
7645,1,0,21,0,-21
7646,1,0,58,0,-58
7647,0,0,10,0,-10
7648,1,1,318,1222,904
7649,0,0,9,0,-9
7650,1,0,1,0,-1
7651,1,1,1170,1347,177
7652,1,0,191,0,-191
7653,0,0,34,0,-34
7654,0,0,19,0,-19
7655,1,1,818,1499,681
7656,1,0,77,0,-77
7657,1,1,401,1726,1325
7658,0,0,46,0,-46
7659,1,1,24,1240,1216
7660,1,0,70,0,-70
7661,1,1,552,1293,741
7662,1,0,102,0,-102
7663,0,0,111,0,-111
7664,1,1,1535,1518,-17
7665,1,0,33,0,-33
7666,1,1,913,1569,656
7667,0,0,67,0,-67
7668,0,0,176,0,-176
7669,1,0,33,0,-33
7670,0,0,75,0,-75
7671,0,0,158,0,-158
7672,0,0,42,0,-42
7673,0,0,61,0,-61
7674,0,0,34,0,-34
7675,1,0,76,0,-76
7676,1,1,116,1258,1142
7677,0,0,32,0,-32
7678,0,0,96,0,-96
7679,0,0,8,0,-8
7680,1,0,58,0,-58
7681,1,0,27,0,-27
7682,1,0,88,0,-88
7683,1,0,8,0,-8
7684,1,0,23,0,-23
7685,1,0,53,0,-53
7686,1,0,59,0,-59
7687,0,0,124,0,-124
7688,1,1,451,1453,1002
7689,1,1,360,1309,949
7690,1,0,266,0,-266
7691,0,0,71,0,-71
7692,1,1,352,1447,1095
7693,0,0,115,0,-115
7694,0,0,0,0,0
7695,0,0,93,0,-93
7696,1,1,153,1560,1407
7697,0,0,6,0,-6
7698,0,0,26,0,-26
7699,0,0,18,0,-18
7700,1,1,611,1842,1231
7701,1,0,190,0,-190
7702,0,0,0,0,0
7703,0,0,119,0,-119
7704,0,0,7,0,-7
7705,0,0,81,0,-81
7706,0,0,12,0,-12
7707,1,0,185,0,-185
7708,1,0,41,0,-41
7709,1,0,52,0,-52
7710,0,0,33,0,-33
7711,0,0,59,0,-59
7712,0,0,13,0,-13
7713,1,1,1257,1613,356
7714,0,0,117,0,-117
7715,0,0,17,0,-17
7716,0,0,14,0,-14
7717,0,0,198,0,-198
7718,0,0,3,0,-3
7719,1,1,389,2105,1716
7720,1,0,40,0,-40
7721,1,1,1055,1208,153
7722,0,0,111,0,-111
7723,1,1,1084,3955,2871
7724,1,1,525,1319,794
7725,0,0,43,0,-43
7726,1,0,12,0,-12
7727,1,1,1378,1517,139
7728,1,0,15,0,-15
7729,0,0,16,0,-16
7730,0,0,228,0,-228
7731,1,1,179,1212,1033
7732,1,1,319,1373,1054
7733,1,0,11,0,-11
7734,1,0,6,0,-6
7735,1,1,666,1698,1032
7736,1,1,271,1523,1252
7737,1,0,121,0,-121
7738,1,0,20,0,-20
7739,1,0,91,0,-91
7740,0,0,43,0,-43
7741,1,0,144,0,-144
7742,1,1,77,1397,1320
7743,1,1,705,1312,607
7744,0,0,66,0,-66
7745,1,0,18,0,-18
7746,1,0,63,0,-63
7747,1,1,60,1316,1256
7748,1,0,133,0,-133
7749,1,1,1042,1605,563
7750,0,0,10,0,-10
7751,1,1,318,1260,942
7752,0,0,41,0,-41
7753,0,0,41,0,-41
7754,1,0,42,0,-42
7755,0,0,41,0,-41
7756,1,1,617,1318,701
7757,1,1,137,1212,1075
7758,1,1,8,1318,1310
7759,1,1,33,1307,1274
7760,0,0,191,0,-191
7761,0,0,26,0,-26
7762,0,0,7,0,-7
7763,0,0,0,0,0
7764,1,1,1830,1288,-542
7765,1,0,23,0,-23
7766,1,0,7,0,-7
7767,0,0,274,0,-274
7768,0,0,46,0,-46
7769,0,0,115,0,-115
7770,1,1,249,1779,1530
7771,0,0,9,0,-9
7772,0,0,40,0,-40
7773,0,0,61,0,-61
7774,1,1,36,1286,1250
7775,1,0,73,0,-73
7776,0,0,1,0,-1
7777,0,0,122,0,-122
7778,1,1,837,2166,1329
7779,0,0,52,0,-52
7780,0,0,120,0,-120
7781,1,1,392,1206,814
7782,1,0,88,0,-88
7783,1,0,66,0,-66
7784,1,0,41,0,-41
7785,1,0,12,0,-12
7786,0,0,66,0,-66
7787,0,0,105,0,-105
7788,0,0,38,0,-38
7789,1,0,10,0,-10
7790,1,0,135,0,-135
7791,1,1,79,1792,1713
7792,0,0,7,0,-7
7793,1,1,429,1230,801
7794,1,1,399,1289,890
7795,0,0,43,0,-43
7796,1,1,382,1284,902
7797,1,0,39,0,-39
7798,0,0,140,0,-140
7799,0,0,29,0,-29
7800,0,0,67,0,-67
7801,0,0,45,0,-45
7802,0,0,137,0,-137
7803,0,0,203,0,-203
7804,1,0,17,0,-17
7805,0,0,51,0,-51
7806,0,0,40,0,-40
7807,1,1,786,1360,574
7808,1,1,368,1296,928
7809,0,0,321,0,-321
7810,0,0,32,0,-32
7811,1,1,300,1549,1249
7812,1,0,20,0,-20
7813,1,0,58,0,-58
7814,1,1,1321,1944,623
7815,1,0,81,0,-81
7816,1,0,68,0,-68
7817,1,0,43,0,-43
7818,1,1,106,1344,1238
7819,1,1,301,1431,1130
7820,1,0,33,0,-33
7821,0,0,57,0,-57
7822,0,0,23,0,-23
7823,1,0,36,0,-36
7824,0,0,1,0,-1
7825,0,0,3,0,-3
7826,1,1,212,1782,1570
7827,0,0,113,0,-113
7828,1,1,670,1891,1221
7829,1,1,1509,1612,103
7830,0,0,14,0,-14
7831,1,1,250,1844,1594
7832,0,0,304,0,-304
7833,0,0,81,0,-81
7834,1,0,11,0,-11
7835,1,1,153,1593,1440
7836,1,1,1191,1281,90
7837,1,0,70,0,-70
7838,1,0,4,0,-4
7839,1,0,48,0,-48
7840,1,1,130,1268,1138
7841,0,0,23,0,-23
7842,1,1,159,1486,1327
7843,1,1,31,1411,1380
7844,1,0,37,0,-37
7845,0,0,82,0,-82
7846,1,1,696,1614,918
7847,0,0,46,0,-46
7848,1,1,70,1688,1618
7849,1,0,80,0,-80
7850,1,1,199,1267,1068
7851,0,0,26,0,-26
7852,1,0,14,0,-14
7853,1,1,765,1212,447
7854,1,0,42,0,-42
7855,1,1,365,1740,1375
7856,1,1,713,1626,913
7857,0,0,28,0,-28
7858,1,1,602,1830,1228
7859,0,0,110,0,-110
7860,1,1,442,1261,819
7861,0,0,41,0,-41
7862,0,0,17,0,-17
7863,1,0,35,0,-35
7864,0,0,11,0,-11
7865,0,0,12,0,-12
7866,1,0,19,0,-19
7867,1,0,261,0,-261
7868,0,0,171,0,-171
7869,1,0,66,0,-66
7870,0,0,30,0,-30
7871,1,1,365,1406,1041
7872,1,0,42,0,-42
7873,0,0,12,0,-12
7874,1,1,56,1551,1495
7875,1,0,13,0,-13
7876,0,0,208,0,-208
7877,1,1,101,1481,1380
7878,1,1,112,1291,1179
7879,1,1,434,1575,1141
7880,0,0,1,0,-1
7881,0,0,52,0,-52
7882,0,0,19,0,-19
7883,1,0,53,0,-53
7884,1,0,93,0,-93
7885,0,0,67,0,-67
7886,0,0,22,0,-22
7887,1,1,481,1878,1397
7888,1,1,101,1684,1583
7889,1,1,798,1246,448
7890,1,0,5,0,-5
7891,1,0,80,0,-80
7892,1,1,666,1324,658
7893,0,0,16,0,-16
7894,0,0,71,0,-71
7895,1,0,91,0,-91
7896,1,0,56,0,-56
7897,1,1,388,1537,1149
7898,0,0,5,0,-5
7899,0,0,16,0,-16
7900,0,0,5,0,-5
7901,0,0,10,0,-10
7902,0,0,21,0,-21
7903,1,0,62,0,-62
7904,1,0,140,0,-140
7905,0,0,54,0,-54
7906,1,0,23,0,-23
7907,1,0,83,0,-83
7908,0,0,42,0,-42
7909,1,0,114,0,-114
7910,1,1,103,3029,2926
7911,1,1,224,1261,1037
7912,1,1,412,1354,942
7913,0,0,11,0,-11
7914,1,0,31,0,-31
7915,0,0,16,0,-16
7916,1,0,37,0,-37
7917,1,0,25,0,-25
7918,1,1,299,2165,1866
7919,1,1,1554,1397,-157
7920,0,0,120,0,-120
7921,1,1,47,1982,1935
7922,1,0,59,0,-59
7923,1,1,219,1474,1255
7924,0,0,86,0,-86
7925,1,1,68,1202,1134
7926,0,0,3,0,-3
7927,1,0,2,0,-2
7928,1,1,1607,1302,-305
7929,0,0,76,0,-76
7930,0,0,45,0,-45
7931,1,1,812,3316,2504
7932,1,1,220,1282,1062
7933,0,0,82,0,-82
7934,1,0,79,0,-79
7935,1,0,15,0,-15
7936,0,0,168,0,-168
7937,0,0,10,0,-10
7938,1,1,94,2162,2068
7939,1,0,75,0,-75
7940,1,1,588,1223,635
7941,1,0,227,0,-227
7942,0,0,1,0,-1
7943,1,1,250,3056,2806
7944,1,0,52,0,-52
7945,1,1,2443,1414,-1029
7946,1,1,1204,1558,354
7947,1,1,101,1867,1766
7948,0,0,105,0,-105
7949,1,1,378,1265,887
7950,0,0,26,0,-26
7951,1,0,63,0,-63
7952,0,0,19,0,-19
7953,0,0,172,0,-172
7954,0,0,11,0,-11
7955,1,1,842,2167,1325
7956,0,0,25,0,-25
7957,0,0,39,0,-39
7958,0,0,220,0,-220
7959,0,0,10,0,-10
7960,0,0,30,0,-30
7961,1,0,107,0,-107
7962,1,1,122,1240,1118
7963,0,0,143,0,-143
7964,1,1,724,1203,479
7965,0,0,13,0,-13
7966,1,0,22,0,-22
7967,0,0,70,0,-70
7968,1,0,0,0,0
7969,1,0,9,0,-9
7970,1,0,33,0,-33
7971,0,0,12,0,-12
7972,1,1,484,2053,1569
7973,1,0,51,0,-51
7974,1,0,14,0,-14
7975,1,0,37,0,-37
7976,1,0,21,0,-21
7977,1,0,22,0,-22
7978,0,0,35,0,-35
7979,1,1,888,1481,593
7980,1,0,17,0,-17
7981,1,0,10,0,-10
7982,1,1,696,1272,576
7983,0,0,6,0,-6
7984,0,0,12,0,-12
7985,1,0,10,0,-10
7986,0,0,22,0,-22
7987,0,0,25,0,-25
7988,1,1,595,1216,621
7989,1,0,42,0,-42
7990,1,0,1,0,-1
7991,1,1,301,2371,2070
7992,1,1,246,2427,2181
7993,0,0,12,0,-12
7994,1,1,1676,1268,-408
7995,1,1,515,1556,1041
7996,1,0,6,0,-6
7997,1,1,632,1242,610
7998,0,0,137,0,-137
7999,0,0,67,0,-67
8000,0,0,0,0,0
8001,0,0,41,0,-41
8002,1,0,31,0,-31
8003,1,0,65,0,-65
8004,1,0,48,0,-48
8005,0,0,13,0,-13
8006,0,0,54,0,-54
8007,0,0,72,0,-72
8008,1,0,7,0,-7
8009,1,0,36,0,-36
8010,0,0,82,0,-82
8011,1,1,170,1406,1236
8012,1,0,121,0,-121
8013,1,1,142,1530,1388
8014,0,0,18,0,-18
8015,0,0,15,0,-15
8016,1,1,134,1280,1146
8017,1,0,4,0,-4
8018,1,0,50,0,-50
8019,1,1,221,1832,1611
8020,1,0,43,0,-43
8021,1,0,40,0,-40
8022,1,0,39,0,-39
8023,1,0,12,0,-12
8024,0,0,58,0,-58
8025,1,0,239,0,-239
8026,1,0,2,0,-2
8027,1,1,143,1840,1697
8028,0,0,119,0,-119
8029,0,0,77,0,-77
8030,0,0,32,0,-32
8031,0,0,10,0,-10
8032,0,0,4,0,-4
8033,0,0,109,0,-109
8034,0,0,22,0,-22
8035,0,0,42,0,-42
8036,1,1,2712,1272,-1440
8037,1,1,277,1597,1320
8038,0,0,23,0,-23
8039,0,0,135,0,-135
8040,1,1,178,2861,2683
8041,0,0,280,0,-280
8042,1,0,81,0,-81
8043,0,0,13,0,-13
8044,1,0,11,0,-11
8045,0,0,3,0,-3
8046,1,1,131,1475,1344
8047,1,0,5,0,-5
8048,1,1,114,1244,1130
8049,0,0,12,0,-12
8050,1,1,219,1596,1377
8051,1,0,15,0,-15
8052,1,0,57,0,-57
8053,1,1,606,1275,669
8054,0,0,35,0,-35
8055,1,0,35,0,-35
8056,1,1,1001,2169,1168
8057,0,0,3,0,-3
8058,0,0,50,0,-50
8059,0,0,13,0,-13
8060,0,0,9,0,-9
8061,1,1,64,1337,1273
8062,0,0,24,0,-24
8063,1,1,292,1402,1110
8064,1,1,1171,1418,247
8065,1,1,117,1501,1384
8066,1,1,114,1416,1302
8067,0,0,1,0,-1
8068,0,0,19,0,-19
8069,0,0,37,0,-37
8070,0,0,16,0,-16
8071,1,0,138,0,-138
8072,1,1,1054,1636,582
8073,0,0,121,0,-121
8074,0,0,3,0,-3
8075,0,0,55,0,-55
8076,0,0,19,0,-19
8077,0,0,52,0,-52
8078,0,0,2,0,-2
8079,1,1,27,1386,1359
8080,1,1,138,1897,1759
8081,0,0,2,0,-2
8082,1,1,414,1243,829
8083,1,1,69,1219,1150
8084,1,0,6,0,-6
8085,0,0,34,0,-34
8086,0,0,76,0,-76
8087,1,0,10,0,-10
8088,1,1,345,1969,1624
8089,1,0,6,0,-6
8090,0,0,3,0,-3
8091,1,0,52,0,-52
8092,1,0,3,0,-3
8093,1,0,36,0,-36
8094,1,1,479,1355,876
8095,1,1,1080,1922,842
8096,1,1,198,1294,1096
8097,1,0,4,0,-4
8098,1,0,39,0,-39
8099,0,0,43,0,-43
8100,1,1,447,1222,775
8101,1,0,87,0,-87
8102,1,1,1449,1323,-126
8103,1,1,466,1261,795
8104,1,1,327,1299,972
8105,1,0,46,0,-46
8106,0,0,53,0,-53
8107,0,0,49,0,-49
8108,1,1,1241,1545,304
8109,1,0,195,0,-195
8110,1,0,42,0,-42
8111,1,1,829,1984,1155
8112,0,0,91,0,-91
8113,0,0,64,0,-64
8114,1,1,365,1309,944
8115,0,0,4,0,-4
8116,1,1,470,1399,929
8117,1,0,47,0,-47
8118,1,0,23,0,-23
8119,1,0,21,0,-21
8120,1,0,7,0,-7
8121,1,0,16,0,-16
8122,1,0,17,0,-17
8123,1,0,102,0,-102
8124,1,0,66,0,-66
8125,0,0,17,0,-17
8126,1,0,47,0,-47
8127,1,0,17,0,-17
8128,0,0,48,0,-48
8129,0,0,38,0,-38
8130,1,0,7,0,-7
8131,0,0,4,0,-4
8132,1,0,8,0,-8
8133,1,1,938,1398,460
8134,0,0,10,0,-10
8135,1,1,320,1208,888
8136,0,0,4,0,-4
8137,1,1,196,1525,1329
8138,1,0,23,0,-23
8139,1,1,162,1212,1050
8140,1,1,88,1245,1157
8141,0,0,64,0,-64
8142,1,0,7,0,-7
8143,1,0,55,0,-55
8144,1,0,224,0,-224
8145,1,1,571,1290,719
8146,1,0,23,0,-23
8147,1,1,915,1345,430
8148,0,0,18,0,-18
8149,1,0,12,0,-12
8150,1,1,494,1586,1092
8151,1,0,202,0,-202
8152,1,1,1111,1362,251
8153,0,0,6,0,-6
8154,0,0,53,0,-53
8155,0,0,29,0,-29
8156,1,0,31,0,-31
8157,0,0,56,0,-56
8158,0,0,183,0,-183
8159,0,0,19,0,-19
8160,1,0,39,0,-39
8161,1,1,504,1375,871
8162,1,0,21,0,-21
8163,0,0,42,0,-42
8164,1,0,6,0,-6
8165,1,0,83,0,-83
8166,1,0,14,0,-14
8167,0,0,8,0,-8
8168,1,0,18,0,-18
8169,0,0,98,0,-98
8170,0,0,22,0,-22
8171,0,0,8,0,-8
8172,0,0,74,0,-74
8173,1,1,122,1408,1286
8174,1,0,85,0,-85
8175,1,1,418,1331,913
8176,1,0,46,0,-46
8177,1,1,334,2078,1744
8178,1,1,132,2448,2316
8179,1,0,71,0,-71
8180,0,0,136,0,-136
8181,1,0,12,0,-12
8182,0,0,71,0,-71
8183,0,0,19,0,-19
8184,0,0,2,0,-2
8185,0,0,73,0,-73
8186,0,0,5,0,-5
8187,0,0,64,0,-64
8188,1,1,291,1227,936
8189,1,0,4,0,-4
8190,0,0,43,0,-43
8191,1,0,118,0,-118
8192,1,1,189,1719,1530
8193,0,0,0,0,0
8194,1,1,1250,3588,2338
8195,1,0,136,0,-136
8196,0,0,34,0,-34
8197,1,0,6,0,-6
8198,0,0,0,0,0
8199,0,0,8,0,-8
8200,1,1,35,2399,2364
8201,1,1,1232,1505,273
8202,0,0,139,0,-139
8203,1,0,41,0,-41
8204,1,1,487,1358,871
8205,0,0,115,0,-115
8206,1,0,89,0,-89
8207,1,1,1189,1319,130
8208,0,0,47,0,-47
8209,1,1,258,1230,972
8210,1,0,8,0,-8
8211,0,0,35,0,-35
8212,0,0,14,0,-14
8213,1,0,6,0,-6
8214,1,1,43,1550,1507
8215,1,1,384,1415,1031
8216,1,1,208,1491,1283
8217,1,0,19,0,-19
8218,1,0,38,0,-38
8219,1,0,16,0,-16
8220,1,1,171,1370,1199
8221,1,1,313,1305,992
8222,0,0,58,0,-58
8223,1,0,131,0,-131
8224,1,1,688,1356,668
8225,1,1,127,1387,1260
8226,1,0,6,0,-6
8227,1,1,772,1271,499
8228,0,0,176,0,-176
8229,1,1,10,1630,1620
8230,0,0,104,0,-104
8231,1,0,38,0,-38
8232,1,1,789,1216,427
8233,0,0,12,0,-12
8234,0,0,30,0,-30
8235,1,0,25,0,-25
8236,1,0,87,0,-87
8237,0,0,16,0,-16
8238,0,0,56,0,-56
8239,1,1,571,1396,825
8240,0,0,10,0,-10
8241,1,0,101,0,-101
8242,1,0,92,0,-92
8243,0,0,68,0,-68
8244,1,1,890,1291,401
8245,0,0,172,0,-172
8246,0,0,87,0,-87
8247,1,0,6,0,-6
8248,0,0,12,0,-12
8249,1,1,147,1300,1153
8250,0,0,75,0,-75
8251,1,1,279,1725,1446
8252,1,0,61,0,-61
8253,1,0,31,0,-31
8254,0,0,36,0,-36
8255,1,1,93,2396,2303
8256,1,1,950,2326,1376
8257,0,0,25,0,-25
8258,0,0,68,0,-68
8259,1,1,1163,1749,586
8260,0,0,3,0,-3
8261,1,1,1235,1493,258
8262,1,1,493,1682,1189
8263,0,0,110,0,-110
8264,1,1,161,1647,1486
8265,1,0,4,0,-4
8266,1,1,643,1372,729
8267,1,1,616,1363,747
8268,1,0,57,0,-57
8269,1,1,45,1304,1259
8270,0,0,30,0,-30
8271,0,0,23,0,-23
8272,0,0,72,0,-72
8273,0,0,44,0,-44
8274,0,0,55,0,-55
8275,0,0,27,0,-27
8276,1,1,93,1384,1291
8277,0,0,13,0,-13
8278,1,1,886,1247,361
8279,0,0,73,0,-73
8280,0,0,16,0,-16
8281,1,1,89,1268,1179
8282,1,0,18,0,-18
8283,1,1,851,1300,449
8284,0,0,17,0,-17
8285,1,1,54,1358,1304
8286,1,0,0,0,0
8287,1,0,84,0,-84
8288,1,0,52,0,-52
8289,0,0,50,0,-50
8290,1,0,33,0,-33
8291,1,0,127,0,-127
8292,1,1,895,1383,488
8293,1,0,62,0,-62
8294,0,0,48,0,-48
8295,0,0,26,0,-26
8296,0,0,67,0,-67
8297,1,0,34,0,-34
8298,0,0,36,0,-36
8299,1,0,23,0,-23
8300,1,0,138,0,-138
8301,0,0,41,0,-41
8302,1,0,3,0,-3
8303,0,0,21,0,-21
8304,1,1,65,1466,1401
8305,1,1,334,1201,867
8306,1,1,797,1354,557
8307,1,1,1103,1519,416
8308,1,0,12,0,-12
8309,1,1,663,1204,541
8310,0,0,67,0,-67
8311,1,0,1,0,-1
8312,0,0,25,0,-25
8313,0,0,15,0,-15
8314,1,0,23,0,-23
8315,0,0,65,0,-65
8316,0,0,47,0,-47
8317,1,0,52,0,-52
8318,1,1,1569,2595,1026
8319,1,1,1034,1212,178
8320,0,0,102,0,-102
8321,0,0,20,0,-20
8322,1,0,20,0,-20
8323,1,0,6,0,-6
8324,1,1,162,1325,1163
8325,1,0,60,0,-60
8326,1,1,79,1335,1256
8327,0,0,1,0,-1
8328,0,0,10,0,-10
8329,1,0,55,0,-55
8330,1,0,114,0,-114
8331,1,0,42,0,-42
8332,1,0,15,0,-15
8333,0,0,156,0,-156
8334,1,0,4,0,-4
8335,0,0,8,0,-8
8336,1,1,75,1251,1176
8337,1,0,27,0,-27
8338,1,0,74,0,-74
8339,1,0,5,0,-5
8340,1,0,2,0,-2
8341,0,0,54,0,-54
8342,1,1,425,1971,1546
8343,1,0,82,0,-82
8344,1,0,105,0,-105
8345,1,0,38,0,-38
8346,0,0,40,0,-40
8347,1,0,18,0,-18
8348,1,0,59,0,-59
8349,1,1,182,1222,1040
8350,0,0,1,0,-1
8351,1,1,877,1481,604
8352,1,0,11,0,-11
8353,1,1,501,1421,920
8354,0,0,70,0,-70
8355,0,0,0,0,0
8356,0,0,165,0,-165
8357,0,0,99,0,-99
8358,0,0,43,0,-43
8359,1,0,3,0,-3
8360,1,0,68,0,-68
8361,1,1,104,1797,1693
8362,1,1,61,1743,1682
8363,0,0,26,0,-26
8364,0,0,49,0,-49
8365,1,0,4,0,-4
8366,1,0,28,0,-28
8367,0,0,86,0,-86
8368,1,0,109,0,-109
8369,0,0,2,0,-2
8370,1,1,691,2279,1588
8371,0,0,40,0,-40
8372,1,0,76,0,-76
8373,0,0,3,0,-3
8374,1,1,307,1986,1679
8375,1,0,24,0,-24
8376,1,1,382,1205,823
8377,0,0,114,0,-114
8378,0,0,22,0,-22
8379,0,0,34,0,-34
8380,1,1,843,1462,619
8381,1,0,23,0,-23
8382,1,1,543,1332,789
8383,1,0,91,0,-91
8384,0,0,74,0,-74
8385,1,1,137,1592,1455
8386,1,1,138,1455,1317
8387,0,0,178,0,-178
8388,0,0,29,0,-29
8389,1,0,69,0,-69
8390,1,1,254,1220,966
8391,0,0,152,0,-152
8392,0,0,70,0,-70
8393,1,0,12,0,-12
8394,0,0,1,0,-1
8395,1,1,319,1275,956
8396,0,0,19,0,-19
8397,0,0,22,0,-22
8398,0,0,4,0,-4
8399,0,0,3,0,-3
8400,0,0,3,0,-3
8401,1,0,64,0,-64
8402,1,0,46,0,-46
8403,0,0,153,0,-153
8404,0,0,42,0,-42
8405,0,0,1,0,-1
8406,1,1,838,1797,959
8407,1,0,15,0,-15
8408,1,0,14,0,-14
8409,1,0,1,0,-1
8410,1,1,204,1459,1255
8411,0,0,8,0,-8
8412,0,0,44,0,-44
8413,1,0,10,0,-10
8414,0,0,168,0,-168
8415,1,1,91,1474,1383
8416,1,0,52,0,-52
8417,1,1,255,2046,1791
8418,0,0,53,0,-53
8419,0,0,59,0,-59
8420,1,0,1,0,-1
8421,0,0,11,0,-11
8422,0,0,143,0,-143
8423,1,0,42,0,-42
8424,1,0,81,0,-81
8425,1,1,195,1383,1188
8426,1,1,208,1237,1029
8427,0,0,58,0,-58
8428,1,1,369,1445,1076
8429,1,1,511,1238,727
8430,0,0,58,0,-58
8431,1,0,75,0,-75
8432,1,0,136,0,-136
8433,1,0,142,0,-142
8434,0,0,50,0,-50
8435,1,1,242,1615,1373
8436,1,1,134,1839,1705
8437,1,1,176,1265,1089
8438,0,0,15,0,-15
8439,1,1,603,1273,670
8440,1,0,68,0,-68
8441,1,1,886,1899,1013
8442,1,0,74,0,-74
8443,0,0,8,0,-8
8444,0,0,23,0,-23
8445,1,1,533,2372,1839
8446,1,0,20,0,-20
8447,0,0,1,0,-1
8448,1,0,74,0,-74
8449,1,0,20,0,-20
8450,1,0,153,0,-153
8451,1,1,300,1305,1005
8452,0,0,48,0,-48
8453,1,1,427,1762,1335
8454,1,1,115,1557,1442
8455,1,0,51,0,-51
8456,1,0,2,0,-2
8457,0,0,20,0,-20
8458,0,0,0,0,0
8459,1,0,15,0,-15
8460,1,1,1147,1306,159
8461,1,0,57,0,-57
8462,1,0,119,0,-119
8463,0,0,199,0,-199
8464,0,0,79,0,-79
8465,0,0,23,0,-23
8466,1,0,16,0,-16
8467,1,0,109,0,-109
8468,0,0,5,0,-5
8469,0,0,0,0,0
8470,1,1,232,1896,1664
8471,0,0,137,0,-137
8472,0,0,124,0,-124
8473,1,0,32,0,-32
8474,0,0,47,0,-47
8475,0,0,76,0,-76
8476,1,1,453,1424,971
8477,0,0,11,0,-11
8478,1,1,272,1634,1362
8479,1,0,313,0,-313
8480,1,0,99,0,-99
8481,1,0,16,0,-16
8482,0,0,3,0,-3
8483,1,1,1005,1228,223
8484,1,1,775,1381,606
8485,0,0,32,0,-32
8486,0,0,3,0,-3
8487,0,0,48,0,-48
8488,1,1,338,1273,935
8489,1,0,69,0,-69
8490,0,0,3,0,-3
8491,0,0,6,0,-6
8492,0,0,33,0,-33
8493,1,0,10,0,-10
8494,1,0,42,0,-42
8495,0,0,8,0,-8
8496,0,0,82,0,-82
8497,0,0,11,0,-11
8498,0,0,19,0,-19
8499,1,0,17,0,-17
8500,1,0,49,0,-49
8501,0,0,104,0,-104
8502,1,1,171,2739,2568
8503,1,0,4,0,-4
8504,1,0,37,0,-37
8505,0,0,3,0,-3
8506,0,0,43,0,-43
8507,0,0,1,0,-1
8508,1,0,2,0,-2
8509,1,0,66,0,-66
8510,1,1,13,1260,1247
8511,1,0,93,0,-93
8512,1,0,9,0,-9
8513,1,0,51,0,-51
8514,1,1,561,1521,960
8515,1,1,131,1396,1265
8516,0,0,20,0,-20
8517,0,0,15,0,-15
8518,0,0,57,0,-57
8519,1,1,634,1651,1017
8520,1,0,2,0,-2
8521,0,0,82,0,-82
8522,1,1,176,1415,1239
8523,0,0,38,0,-38
8524,1,0,116,0,-116
8525,1,1,749,1239,490
8526,0,0,111,0,-111
8527,0,0,6,0,-6
8528,1,0,78,0,-78
8529,1,0,21,0,-21
8530,0,0,47,0,-47
8531,0,0,13,0,-13
8532,0,0,163,0,-163
8533,1,0,116,0,-116
8534,0,0,28,0,-28
8535,0,0,5,0,-5
8536,1,0,19,0,-19
8537,0,0,98,0,-98
8538,1,0,9,0,-9
8539,1,1,583,1233,650
8540,1,0,31,0,-31
8541,0,0,36,0,-36
8542,1,0,30,0,-30
8543,0,0,59,0,-59
8544,1,0,1,0,-1
8545,0,0,0,0,0
8546,0,0,71,0,-71
8547,0,0,68,0,-68
8548,0,0,21,0,-21
8549,0,0,77,0,-77
8550,1,1,445,1361,916
8551,1,1,961,1207,246
8552,1,1,276,1324,1048
8553,0,0,37,0,-37
8554,1,0,135,0,-135
8555,0,0,1,0,-1
8556,0,0,33,0,-33
8557,1,0,123,0,-123
8558,1,1,2052,1894,-158
8559,1,1,1309,1202,-107
8560,1,1,1019,2239,1220
8561,1,0,67,0,-67
8562,1,0,48,0,-48
8563,0,0,6,0,-6
8564,0,0,15,0,-15
8565,1,1,135,1290,1155
8566,1,1,471,1408,937
8567,1,1,214,1238,1024
8568,0,0,124,0,-124
8569,1,1,920,1667,747
8570,1,0,9,0,-9
8571,0,0,72,0,-72
8572,0,0,68,0,-68
8573,0,0,8,0,-8
8574,1,0,94,0,-94
8575,1,1,382,1456,1074
8576,1,1,629,1928,1299
8577,1,0,74,0,-74
8578,0,0,73,0,-73
8579,0,0,12,0,-12
8580,1,1,968,1360,392
8581,1,1,389,4029,3640
8582,0,0,14,0,-14
8583,0,0,23,0,-23
8584,1,1,570,1921,1351
8585,0,0,7,0,-7
8586,0,0,22,0,-22
8587,0,0,43,0,-43
8588,0,0,53,0,-53
8589,1,0,104,0,-104
8590,0,0,5,0,-5
8591,1,0,55,0,-55
8592,0,0,102,0,-102
8593,0,0,29,0,-29
8594,1,1,1075,3340,2265
8595,1,1,149,1566,1417
8596,1,0,45,0,-45
8597,1,0,3,0,-3
8598,0,0,56,0,-56
8599,1,0,18,0,-18
8600,1,0,16,0,-16
8601,1,0,2,0,-2
8602,1,1,475,2171,1696
8603,0,0,22,0,-22
8604,1,1,271,1565,1294
8605,1,1,309,1824,1515
8606,1,0,2,0,-2
8607,0,0,34,0,-34
8608,0,0,2,0,-2
8609,1,0,73,0,-73
8610,1,0,19,0,-19
8611,1,1,1784,1260,-524
8612,1,0,16,0,-16
8613,1,0,9,0,-9
8614,0,0,14,0,-14
8615,1,0,24,0,-24
8616,1,1,288,1583,1295
8617,0,0,8,0,-8
8618,1,0,61,0,-61
8619,1,0,96,0,-96
8620,0,0,2,0,-2
8621,0,0,5,0,-5
8622,0,0,11,0,-11
8623,0,0,36,0,-36
8624,0,0,60,0,-60
8625,0,0,136,0,-136
8626,1,0,207,0,-207
8627,0,0,25,0,-25
8628,0,0,121,0,-121
8629,1,1,1622,1343,-279
8630,1,0,14,0,-14
8631,0,0,56,0,-56
8632,1,0,7,0,-7
8633,1,0,35,0,-35
8634,1,1,254,1842,1588
8635,0,0,6,0,-6
8636,1,0,16,0,-16
8637,0,0,180,0,-180
8638,0,0,3,0,-3
8639,1,0,3,0,-3
8640,1,1,270,1392,1122
8641,1,1,563,6187,5624
8642,0,0,41,0,-41
8643,0,0,23,0,-23
8644,1,0,33,0,-33
8645,0,0,250,0,-250
8646,1,0,18,0,-18
8647,1,1,171,2553,2382
8648,1,0,42,0,-42
8649,0,0,42,0,-42
8650,0,0,53,0,-53
8651,1,0,32,0,-32
8652,0,0,127,0,-127
8653,0,0,1,0,-1
8654,0,0,15,0,-15
8655,1,0,35,0,-35
8656,1,1,2307,1344,-963
8657,1,0,17,0,-17
8658,1,1,218,1472,1254
8659,1,0,4,0,-4
8660,0,0,33,0,-33
8661,1,1,513,1425,912
8662,1,1,327,1560,1233
8663,0,0,48,0,-48
8664,0,0,79,0,-79
8665,1,1,238,1778,1540
8666,0,0,81,0,-81
8667,1,1,1441,1547,106
8668,0,0,95,0,-95
8669,1,0,40,0,-40
8670,1,1,325,1850,1525
8671,0,0,82,0,-82
8672,0,0,90,0,-90
8673,1,0,34,0,-34
8674,1,1,266,1323,1057
8675,1,0,41,0,-41
8676,1,1,130,1209,1079
8677,1,1,144,1654,1510
8678,0,0,18,0,-18
8679,0,0,124,0,-124
8680,1,1,73,1415,1342
8681,1,1,170,2042,1872
8682,0,0,17,0,-17
8683,0,0,49,0,-49
8684,0,0,261,0,-261
8685,1,0,12,0,-12
8686,1,1,495,1225,730
8687,0,0,27,0,-27
8688,1,0,49,0,-49
8689,0,0,11,0,-11
8690,1,1,338,1222,884
8691,1,0,72,0,-72
8692,0,0,12,0,-12
8693,1,1,250,1287,1037
8694,0,0,2,0,-2
8695,0,0,8,0,-8
8696,0,0,20,0,-20
8697,0,0,34,0,-34
8698,1,1,379,1838,1459
8699,1,1,327,1641,1314
8700,0,0,41,0,-41
8701,1,1,646,1956,1310
8702,1,1,293,1439,1146
8703,1,1,305,1956,1651
8704,0,0,3,0,-3
8705,1,1,864,1654,790
8706,1,1,330,1764,1434
8707,1,0,44,0,-44
8708,0,0,33,0,-33
8709,1,1,400,1242,842
8710,0,0,32,0,-32
8711,1,0,61,0,-61
8712,0,0,33,0,-33
8713,1,0,28,0,-28
8714,1,0,35,0,-35
8715,0,0,7,0,-7
8716,1,0,56,0,-56
8717,0,0,61,0,-61
8718,1,1,1120,1387,267
8719,0,0,1,0,-1
8720,1,1,665,1828,1163
8721,0,0,42,0,-42
8722,1,0,1,0,-1
8723,1,0,23,0,-23
8724,1,0,70,0,-70
8725,1,0,101,0,-101
8726,1,0,7,0,-7
8727,0,0,23,0,-23
8728,1,1,77,1323,1246
8729,1,1,261,1653,1392
8730,1,1,2058,2336,278
8731,0,0,171,0,-171
8732,1,0,1,0,-1
8733,1,1,257,1200,943
8734,0,0,11,0,-11
8735,1,1,89,1328,1239
8736,0,0,116,0,-116
8737,1,0,14,0,-14
8738,1,0,5,0,-5
8739,0,0,3,0,-3
8740,1,0,12,0,-12
8741,1,1,50,1977,1927
8742,1,1,29,1572,1543
8743,1,0,147,0,-147
8744,1,0,11,0,-11
8745,1,1,231,1372,1141
8746,0,0,113,0,-113
8747,1,1,588,1515,927
8748,1,1,457,1206,749
8749,0,0,22,0,-22
8750,1,1,33,1394,1361
8751,1,1,537,1837,1300
8752,1,0,3,0,-3
8753,1,1,276,3986,3710
8754,0,0,137,0,-137
8755,0,0,2,0,-2
8756,0,0,3,0,-3
8757,1,0,25,0,-25
8758,1,0,0,0,0
8759,0,0,2,0,-2
8760,0,0,77,0,-77
8761,0,0,14,0,-14
8762,0,0,62,0,-62
8763,1,0,9,0,-9
8764,0,0,50,0,-50
8765,1,1,69,1239,1170
8766,1,1,1946,1395,-551
8767,0,0,25,0,-25
8768,1,1,292,1316,1024
8769,1,0,70,0,-70
8770,1,1,772,1333,561
8771,0,0,46,0,-46
8772,0,0,38,0,-38
8773,0,0,19,0,-19
8774,1,0,51,0,-51
8775,1,1,1164,1430,266
8776,0,0,24,0,-24
8777,0,0,11,0,-11
8778,1,1,298,3145,2847
8779,0,0,53,0,-53
8780,0,0,18,0,-18
8781,0,0,1,0,-1
8782,0,0,79,0,-79
8783,1,0,89,0,-89
8784,0,0,1,0,-1
8785,0,0,32,0,-32
8786,1,1,1441,1526,85
8787,1,0,20,0,-20
8788,1,1,392,1528,1136
8789,1,0,7,0,-7
8790,0,0,15,0,-15
8791,0,0,110,0,-110
8792,1,0,12,0,-12
8793,1,0,58,0,-58
8794,1,1,325,1474,1149
8795,0,0,79,0,-79
8796,1,0,27,0,-27
8797,1,0,30,0,-30
8798,1,0,17,0,-17
8799,1,0,28,0,-28
8800,0,0,9,0,-9
8801,0,0,5,0,-5
8802,0,0,18,0,-18
8803,1,0,8,0,-8
8804,1,1,341,1312,971
8805,1,1,182,1390,1208
8806,0,0,55,0,-55
8807,1,1,146,1571,1425
8808,0,0,30,0,-30
8809,1,1,151,1976,1825
8810,0,0,35,0,-35
8811,1,1,1377,1245,-132
8812,1,1,126,1246,1120
8813,0,0,9,0,-9
8814,1,0,48,0,-48
8815,1,1,133,1315,1182
8816,1,0,191,0,-191
8817,1,1,867,1473,606
8818,1,1,366,1335,969
8819,0,0,9,0,-9
8820,0,0,57,0,-57
8821,1,0,49,0,-49
8822,1,0,24,0,-24
8823,1,1,294,1595,1301
8824,1,0,51,0,-51
8825,0,0,50,0,-50
8826,1,1,343,1282,939
8827,1,1,851,1776,925
8828,1,1,698,1288,590
8829,1,0,109,0,-109
8830,0,0,77,0,-77
8831,0,0,7,0,-7
8832,1,1,708,1276,568
8833,1,1,665,2207,1542
8834,1,1,358,1273,915
8835,0,0,13,0,-13
8836,1,1,692,2812,2120
8837,1,0,49,0,-49
8838,0,0,72,0,-72
8839,0,0,54,0,-54
8840,1,0,70,0,-70
8841,0,0,8,0,-8
8842,0,0,41,0,-41
8843,1,0,189,0,-189
8844,1,1,602,1239,637
8845,1,1,356,1338,982
8846,1,0,2,0,-2
8847,1,1,567,1216,649
8848,1,1,866,1388,522
8849,1,1,575,1306,731
8850,1,0,31,0,-31
8851,1,1,254,1230,976
8852,0,0,88,0,-88
8853,0,0,106,0,-106
8854,0,0,26,0,-26
8855,0,0,13,0,-13
8856,0,0,42,0,-42
8857,0,0,50,0,-50
8858,1,1,848,1266,418
8859,1,0,14,0,-14
8860,1,1,46,1310,1264
8861,1,0,8,0,-8
8862,1,1,316,1286,970
8863,1,0,14,0,-14
8864,1,1,1430,1213,-217
8865,1,0,19,0,-19
8866,1,0,8,0,-8
8867,0,0,17,0,-17
8868,0,0,165,0,-165
8869,0,0,24,0,-24
8870,0,0,71,0,-71
8871,1,0,2,0,-2
8872,0,0,0,0,0
8873,0,0,113,0,-113
8874,1,1,290,1254,964
8875,1,1,171,1322,1151
8876,0,0,13,0,-13
8877,0,0,14,0,-14
8878,0,0,24,0,-24
8879,1,0,22,0,-22
8880,0,0,36,0,-36
8881,1,0,105,0,-105
8882,0,0,48,0,-48
8883,1,1,578,1482,904
8884,1,1,395,1973,1578
8885,1,1,172,1503,1331
8886,1,1,795,1675,880
8887,0,0,48,0,-48
8888,0,0,54,0,-54
8889,1,0,46,0,-46
8890,0,0,73,0,-73
8891,1,1,2215,1521,-694
8892,0,0,128,0,-128
8893,1,0,28,0,-28
8894,0,0,37,0,-37
8895,0,0,9,0,-9
8896,0,0,57,0,-57
8897,0,0,6,0,-6
8898,1,1,140,1431,1291
8899,1,1,926,1264,338
8900,0,0,3,0,-3
8901,0,0,62,0,-62
8902,1,0,8,0,-8
8903,1,1,841,1435,594
8904,0,0,42,0,-42
8905,0,0,24,0,-24
8906,1,1,1136,2598,1462
8907,1,1,850,1260,410
8908,1,1,790,1231,441
8909,1,1,314,1881,1567
8910,1,0,21,0,-21
8911,0,0,61,0,-61
8912,0,0,50,0,-50
8913,1,1,219,1674,1455
8914,0,0,19,0,-19
8915,1,0,62,0,-62
8916,0,0,34,0,-34
8917,0,0,8,0,-8
8918,1,0,22,0,-22
8919,0,0,113,0,-113
8920,1,1,1450,1929,479
8921,0,0,64,0,-64
8922,1,1,249,2653,2404
8923,1,0,8,0,-8
8924,1,0,44,0,-44
8925,1,0,122,0,-122
8926,0,0,81,0,-81
8927,0,0,109,0,-109
8928,1,0,25,0,-25
8929,0,0,101,0,-101
8930,1,0,44,0,-44
8931,1,0,147,0,-147
8932,1,0,149,0,-149
8933,0,0,5,0,-5
8934,0,0,13,0,-13
8935,0,0,89,0,-89
8936,0,0,53,0,-53
8937,1,1,1040,2364,1324
8938,0,0,9,0,-9
8939,1,0,122,0,-122
8940,1,0,55,0,-55
8941,1,0,24,0,-24
8942,1,0,48,0,-48
8943,1,0,8,0,-8
8944,1,0,29,0,-29
8945,1,1,586,1270,684
8946,1,0,115,0,-115
8947,0,0,19,0,-19
8948,1,1,416,3689,3273
8949,0,0,37,0,-37
8950,1,0,15,0,-15
8951,1,0,71,0,-71
8952,0,0,19,0,-19
8953,1,1,1179,1831,652
8954,1,0,168,0,-168
8955,0,0,41,0,-41
8956,0,0,0,0,0
8957,1,1,197,1293,1096
8958,1,1,380,1407,1027
8959,1,0,176,0,-176
8960,1,0,65,0,-65
8961,0,0,14,0,-14
8962,1,1,358,1401,1043
8963,0,0,13,0,-13
8964,1,0,86,0,-86
8965,0,0,160,0,-160
8966,1,1,336,1204,868
8967,1,0,60,0,-60
8968,0,0,83,0,-83
8969,1,0,38,0,-38
8970,1,0,25,0,-25
8971,1,1,1979,1304,-675
8972,1,0,48,0,-48
8973,0,0,36,0,-36
8974,0,0,4,0,-4
8975,0,0,5,0,-5
8976,0,0,44,0,-44
8977,0,0,34,0,-34
8978,1,1,954,3339,2385
8979,0,0,102,0,-102
8980,1,0,7,0,-7
8981,1,0,19,0,-19
8982,0,0,77,0,-77
8983,0,0,99,0,-99
8984,0,0,26,0,-26
8985,1,1,1520,2388,868
8986,1,0,19,0,-19
8987,0,0,28,0,-28
8988,0,0,70,0,-70
8989,0,0,85,0,-85
8990,1,0,68,0,-68
8991,1,1,222,2587,2365
8992,1,0,52,0,-52
8993,1,1,357,1852,1495
8994,1,0,83,0,-83
8995,1,1,180,1520,1340
8996,0,0,55,0,-55
8997,1,0,5,0,-5
8998,0,0,20,0,-20
8999,0,0,25,0,-25
9000,1,1,247,1689,1442
9001,1,1,31,1346,1315
9002,1,1,821,1267,446
9003,1,1,668,1503,835
9004,1,0,28,0,-28
9005,1,0,67,0,-67
9006,0,0,62,0,-62
9007,0,0,18,0,-18
9008,1,0,23,0,-23
9009,1,1,133,1569,1436
9010,0,0,78,0,-78
9011,1,0,27,0,-27
9012,1,0,46,0,-46
9013,0,0,130,0,-130
9014,1,0,24,0,-24
9015,1,1,356,1408,1052
9016,1,0,4,0,-4
9017,1,0,53,0,-53
9018,1,0,10,0,-10
9019,0,0,214,0,-214
9020,1,0,78,0,-78
9021,0,0,92,0,-92
9022,1,0,16,0,-16
9023,1,1,371,1677,1306
9024,1,0,41,0,-41
9025,1,0,46,0,-46
9026,0,0,8,0,-8
9027,0,0,44,0,-44
9028,0,0,5,0,-5
9029,1,0,131,0,-131
9030,1,1,613,1607,994
9031,0,0,29,0,-29
9032,0,0,36,0,-36
9033,1,0,2,0,-2
9034,1,0,16,0,-16
9035,0,0,149,0,-149
9036,1,1,243,1391,1148
9037,1,0,21,0,-21
9038,0,0,1,0,-1
9039,0,0,26,0,-26
9040,1,1,94,1475,1381
9041,1,1,561,2177,1616
9042,1,1,338,1279,941
9043,0,0,9,0,-9
9044,1,1,185,2170,1985
9045,1,0,60,0,-60
9046,1,0,0,0,0
9047,1,0,12,0,-12
9048,0,0,50,0,-50
9049,1,1,598,3037,2439
9050,1,0,45,0,-45
9051,0,0,75,0,-75
9052,0,0,10,0,-10
9053,1,1,422,1468,1046
9054,0,0,85,0,-85
9055,1,1,39,1811,1772
9056,0,0,5,0,-5
9057,0,0,38,0,-38
9058,0,0,11,0,-11
9059,1,0,1,0,-1
9060,1,1,643,1416,773
9061,0,0,208,0,-208
9062,1,0,248,0,-248
9063,1,1,333,1440,1107
9064,1,0,31,0,-31
9065,0,0,63,0,-63
9066,1,1,822,1255,433
9067,0,0,39,0,-39
9068,1,1,18,1495,1477
9069,1,0,1,0,-1
9070,1,1,235,1820,1585
9071,1,0,19,0,-19
9072,0,0,1,0,-1
9073,0,0,150,0,-150
9074,0,0,13,0,-13
9075,1,0,3,0,-3
9076,1,0,19,0,-19
9077,0,0,6,0,-6
9078,1,1,220,1229,1009
9079,0,0,55,0,-55
9080,1,1,225,1274,1049
9081,1,0,1,0,-1
9082,1,0,46,0,-46
9083,1,0,24,0,-24
9084,1,1,1337,1221,-116
9085,0,0,75,0,-75
9086,1,0,46,0,-46
9087,0,0,10,0,-10
9088,1,1,66,1561,1495
9089,0,0,77,0,-77
9090,0,0,208,0,-208
9091,1,0,17,0,-17
9092,0,0,141,0,-141
9093,1,1,641,1442,801
9094,0,0,23,0,-23
9095,1,1,1069,1241,172
9096,1,1,588,2166,1578
9097,1,1,257,1618,1361
9098,0,0,34,0,-34
9099,1,1,461,1212,751
9100,1,0,4,0,-4
9101,1,0,80,0,-80
9102,1,1,343,1490,1147
9103,0,0,11,0,-11
9104,1,0,13,0,-13
9105,0,0,6,0,-6
9106,0,0,65,0,-65
9107,0,0,74,0,-74
9108,0,0,3,0,-3
9109,0,0,0,0,0
9110,1,1,843,2050,1207
9111,0,0,30,0,-30
9112,1,0,115,0,-115
9113,0,0,11,0,-11
9114,0,0,74,0,-74
9115,1,1,406,2091,1685
9116,1,0,45,0,-45
9117,1,0,49,0,-49
9118,1,1,288,1349,1061
9119,1,0,43,0,-43
9120,0,0,13,0,-13
9121,1,0,86,0,-86
9122,0,0,82,0,-82
9123,0,0,57,0,-57
9124,1,0,72,0,-72
9125,0,0,6,0,-6
9126,0,0,34,0,-34
9127,0,0,10,0,-10
9128,1,1,655,1255,600
9129,1,1,146,1376,1230
9130,1,0,83,0,-83
9131,1,0,59,0,-59
9132,1,1,143,1232,1089
9133,0,0,178,0,-178
9134,0,0,7,0,-7
9135,1,0,67,0,-67
9136,1,1,315,1306,991
9137,0,0,41,0,-41
9138,1,1,269,2523,2254
9139,1,1,994,1201,207
9140,0,0,75,0,-75
9141,0,0,37,0,-37
9142,1,1,2032,1215,-817
9143,0,0,11,0,-11
9144,0,0,93,0,-93
9145,1,1,1746,1474,-272
9146,1,1,77,1935,1858
9147,1,0,61,0,-61
9148,1,1,773,1418,645
9149,1,0,109,0,-109
9150,1,1,69,1374,1305
9151,1,0,99,0,-99
9152,0,0,54,0,-54
9153,0,0,76,0,-76
9154,1,0,204,0,-204
9155,1,0,11,0,-11
9156,1,0,12,0,-12
9157,1,1,1158,1205,47
9158,0,0,60,0,-60
9159,0,0,71,0,-71
9160,1,1,959,1420,461
9161,1,1,910,5025,4115
9162,1,0,22,0,-22
9163,1,1,390,1271,881
9164,1,0,74,0,-74
9165,0,0,93,0,-93
9166,0,0,41,0,-41
9167,1,1,698,1295,597
9168,1,0,94,0,-94
9169,0,0,13,0,-13
9170,1,1,250,1215,965
9171,0,0,5,0,-5
9172,1,0,52,0,-52
9173,1,1,57,1213,1156
9174,0,0,19,0,-19
9175,1,1,797,2070,1273
9176,0,0,45,0,-45
9177,0,0,65,0,-65
9178,0,0,192,0,-192
9179,1,1,123,1456,1333
9180,1,0,53,0,-53
9181,0,0,15,0,-15
9182,1,0,44,0,-44
9183,0,0,108,0,-108
9184,1,0,10,0,-10
9185,1,0,6,0,-6
9186,0,0,176,0,-176
9187,0,0,54,0,-54
9188,0,0,131,0,-131
9189,0,0,55,0,-55
9190,0,0,230,0,-230
9191,1,1,252,1472,1220
9192,1,0,16,0,-16
9193,0,0,15,0,-15
9194,1,1,1071,1769,698
9195,1,1,466,1354,888
9196,1,1,1055,1264,209
9197,1,1,133,1631,1498
9198,0,0,41,0,-41
9199,1,1,205,1370,1165
9200,0,0,16,0,-16
9201,0,0,100,0,-100
9202,0,0,47,0,-47
9203,0,0,71,0,-71
9204,1,1,143,1437,1294
9205,1,1,1101,1294,193
9206,0,0,16,0,-16
9207,1,1,1118,1280,162
9208,1,0,53,0,-53
9209,0,0,18,0,-18
9210,0,0,76,0,-76
9211,1,1,349,1999,1650
9212,0,0,17,0,-17
9213,0,0,8,0,-8
9214,1,0,73,0,-73
9215,0,0,58,0,-58
9216,0,0,23,0,-23
9217,0,0,1,0,-1
9218,0,0,64,0,-64
9219,0,0,55,0,-55
9220,0,0,18,0,-18
9221,1,1,538,1416,878
9222,1,0,10,0,-10
9223,1,0,14,0,-14
9224,0,0,199,0,-199
9225,1,0,37,0,-37
9226,0,0,53,0,-53
9227,0,0,70,0,-70
9228,1,1,92,2526,2434
9229,0,0,8,0,-8
9230,1,1,506,1451,945
9231,1,1,1618,3388,1770
9232,0,0,6,0,-6
9233,1,0,20,0,-20
9234,1,0,10,0,-10
9235,1,1,478,1999,1521
9236,1,1,171,1261,1090
9237,1,1,345,3808,3463
9238,0,0,123,0,-123
9239,1,1,166,1722,1556
9240,0,0,46,0,-46
9241,1,0,11,0,-11
9242,1,0,0,0,0
9243,0,0,77,0,-77
9244,1,1,1286,2188,902
9245,0,0,87,0,-87
9246,1,1,653,1228,575
9247,0,0,6,0,-6
9248,0,0,159,0,-159
9249,1,1,306,1621,1315
9250,0,0,8,0,-8
9251,1,0,23,0,-23
9252,1,1,633,1560,927
9253,0,0,19,0,-19
9254,0,0,9,0,-9
9255,1,0,22,0,-22
9256,0,0,4,0,-4
9257,1,0,20,0,-20
9258,1,0,42,0,-42
9259,1,1,73,3759,3686
9260,0,0,49,0,-49
9261,0,0,35,0,-35
9262,1,1,803,1381,578
9263,1,0,250,0,-250
9264,1,0,2,0,-2
9265,0,0,150,0,-150
9266,0,0,72,0,-72
9267,0,0,74,0,-74
9268,1,0,17,0,-17
9269,1,0,183,0,-183
9270,0,0,44,0,-44
9271,1,1,1061,1310,249
9272,1,1,1581,1227,-354
9273,1,0,65,0,-65
9274,1,1,33,1242,1209
9275,0,0,58,0,-58
9276,0,0,271,0,-271
9277,1,0,54,0,-54
9278,1,0,14,0,-14
9279,0,0,11,0,-11
9280,1,1,530,1279,749
9281,1,0,24,0,-24
9282,1,1,804,1331,527
9283,1,0,2,0,-2
9284,0,0,25,0,-25
9285,1,0,12,0,-12
9286,1,0,39,0,-39
9287,1,1,600,1421,821
9288,1,0,18,0,-18
9289,1,0,54,0,-54
9290,0,0,15,0,-15
9291,0,0,23,0,-23
9292,1,1,383,2588,2205
9293,1,1,677,1740,1063
9294,1,1,2580,3303,723
9295,1,1,104,1375,1271
9296,1,0,173,0,-173
9297,1,1,925,1273,348
9298,0,0,40,0,-40
9299,1,1,144,1208,1064
9300,1,1,178,1235,1057
9301,0,0,21,0,-21
9302,1,0,6,0,-6
9303,0,0,0,0,0
9304,0,0,14,0,-14
9305,1,1,496,1837,1341
9306,1,0,31,0,-31
9307,0,0,189,0,-189
9308,1,0,186,0,-186
9309,1,0,2,0,-2
9310,1,1,736,1422,686
9311,0,0,13,0,-13
9312,0,0,285,0,-285
9313,1,0,25,0,-25
9314,1,0,74,0,-74
9315,1,1,2448,1290,-1158
9316,0,0,20,0,-20
9317,1,0,81,0,-81
9318,1,0,18,0,-18
9319,0,0,30,0,-30
9320,1,0,101,0,-101
9321,1,0,69,0,-69
9322,1,1,1525,1745,220
9323,1,0,151,0,-151
9324,1,0,117,0,-117
9325,1,0,79,0,-79
9326,0,0,18,0,-18
9327,0,0,41,0,-41
9328,0,0,17,0,-17
9329,1,0,21,0,-21
9330,0,0,21,0,-21
9331,1,1,163,1386,1223
9332,0,0,51,0,-51
9333,0,0,51,0,-51
9334,0,0,1,0,-1
9335,1,0,7,0,-7
9336,1,0,37,0,-37
9337,0,0,35,0,-35
9338,1,1,451,1693,1242
9339,0,0,50,0,-50
9340,1,1,362,1270,908
9341,0,0,8,0,-8
9342,0,0,5,0,-5
9343,1,0,0,0,0
9344,1,0,32,0,-32
9345,1,1,1997,1580,-417
9346,1,0,26,0,-26
9347,1,0,6,0,-6
9348,1,1,81,1917,1836
9349,0,0,8,0,-8
9350,1,0,16,0,-16
9351,0,0,9,0,-9
9352,1,0,38,0,-38
9353,0,0,39,0,-39
9354,1,1,360,1954,1594
9355,0,0,1,0,-1
9356,1,1,1622,1259,-363
9357,1,0,50,0,-50
9358,1,1,165,2532,2367
9359,0,0,43,0,-43
9360,1,1,1235,1277,42
9361,0,0,58,0,-58
9362,0,0,25,0,-25
9363,1,1,155,1275,1120
9364,0,0,24,0,-24
9365,1,1,252,1625,1373
9366,0,0,54,0,-54
9367,1,0,33,0,-33
9368,1,1,710,1314,604
9369,1,0,100,0,-100
9370,1,1,454,1291,837
9371,1,0,2,0,-2
9372,1,0,4,0,-4
9373,1,1,37,2354,2317
9374,1,0,6,0,-6
9375,1,0,56,0,-56
9376,0,0,81,0,-81
9377,0,0,95,0,-95
9378,1,1,207,1219,1012
9379,1,1,1515,1213,-302
9380,1,1,125,1542,1417
9381,0,0,39,0,-39
9382,0,0,31,0,-31
9383,0,0,44,0,-44
9384,0,0,3,0,-3
9385,0,0,29,0,-29
9386,1,0,11,0,-11
9387,1,1,225,1426,1201
9388,0,0,21,0,-21
9389,1,1,551,1309,758
9390,1,1,1962,1509,-453
9391,1,0,57,0,-57
9392,1,0,51,0,-51
9393,1,0,23,0,-23
9394,1,1,354,1309,955
9395,0,0,57,0,-57
9396,0,0,4,0,-4
9397,1,1,400,1593,1193
9398,1,1,389,1530,1141
9399,1,0,116,0,-116
9400,0,0,89,0,-89
9401,0,0,96,0,-96
9402,1,1,355,1214,859
9403,0,0,8,0,-8
9404,1,0,112,0,-112
9405,0,0,4,0,-4
9406,1,0,45,0,-45
9407,1,0,47,0,-47
9408,0,0,2,0,-2
9409,1,0,4,0,-4
9410,1,1,102,1284,1182
9411,0,0,119,0,-119
9412,0,0,35,0,-35
9413,0,0,15,0,-15
9414,0,0,34,0,-34
9415,1,0,113,0,-113
9416,1,0,23,0,-23
9417,1,0,5,0,-5
9418,1,1,747,1698,951
9419,1,1,786,1238,452
9420,1,1,2375,2379,4
9421,1,0,64,0,-64
9422,0,0,15,0,-15
9423,1,0,97,0,-97
9424,1,0,133,0,-133
9425,1,0,28,0,-28
9426,0,0,194,0,-194
9427,1,1,257,1224,967
9428,0,0,20,0,-20
9429,1,0,8,0,-8
9430,1,1,315,1717,1402
9431,1,1,574,1485,911
9432,1,1,136,1487,1351
9433,0,0,0,0,0
9434,1,0,30,0,-30
9435,1,1,546,1218,672
9436,0,0,25,0,-25
9437,1,1,261,1214,953
9438,1,1,38,1217,1179
9439,0,0,258,0,-258
9440,0,0,49,0,-49
9441,1,0,89,0,-89
9442,1,1,39,1768,1729
9443,1,1,203,1438,1235
9444,1,1,296,1401,1105
9445,0,0,10,0,-10
9446,0,0,198,0,-198
9447,0,0,56,0,-56
9448,1,1,88,1373,1285
9449,1,0,81,0,-81
9450,1,0,37,0,-37
9451,0,0,157,0,-157
9452,1,0,20,0,-20
9453,1,0,22,0,-22
9454,0,0,53,0,-53
9455,1,1,253,1341,1088
9456,0,0,76,0,-76
9457,1,0,56,0,-56
9458,0,0,32,0,-32
9459,0,0,34,0,-34
9460,1,1,929,1421,492
9461,0,0,29,0,-29
9462,0,0,18,0,-18
9463,0,0,79,0,-79
9464,1,1,714,2316,1602
9465,1,0,43,0,-43
9466,1,1,466,1498,1032
9467,0,0,4,0,-4
9468,1,1,367,1658,1291
9469,0,0,23,0,-23
9470,1,0,15,0,-15
9471,0,0,53,0,-53
9472,1,0,21,0,-21
9473,0,0,117,0,-117
9474,0,0,6,0,-6
9475,1,0,75,0,-75
9476,0,0,14,0,-14
9477,0,0,5,0,-5
9478,0,0,23,0,-23
9479,0,0,30,0,-30
9480,1,0,66,0,-66
9481,0,0,3,0,-3
9482,1,0,34,0,-34
9483,1,0,30,0,-30
9484,0,0,55,0,-55
9485,0,0,36,0,-36
9486,0,0,35,0,-35
9487,0,0,33,0,-33
9488,1,1,1382,1529,147
9489,1,1,1029,1564,535
9490,1,0,97,0,-97
9491,1,1,681,1589,908
9492,0,0,13,0,-13
9493,0,0,103,0,-103
9494,1,1,49,1332,1283
9495,1,1,916,2056,1140
9496,0,0,44,0,-44
9497,0,0,46,0,-46
9498,0,0,27,0,-27
9499,0,0,38,0,-38
9500,1,1,2699,1290,-1409
9501,0,0,32,0,-32
9502,0,0,43,0,-43
9503,1,1,603,1724,1121
9504,1,1,1624,2193,569
9505,1,1,421,1524,1103
9506,0,0,16,0,-16
9507,1,1,172,1463,1291
9508,1,0,48,0,-48
9509,0,0,56,0,-56
9510,0,0,33,0,-33
9511,1,0,57,0,-57
9512,1,0,50,0,-50
9513,1,1,790,1239,449
9514,1,1,395,1434,1039
9515,1,1,894,2336,1442
9516,1,1,469,1223,754
9517,0,0,48,0,-48
9518,1,0,81,0,-81
9519,0,0,47,0,-47
9520,1,1,187,1425,1238
9521,0,0,14,0,-14
9522,1,0,83,0,-83
9523,0,0,26,0,-26
9524,1,0,72,0,-72
9525,0,0,33,0,-33
9526,1,0,100,0,-100
9527,1,1,289,1394,1105
9528,1,0,46,0,-46
9529,1,0,71,0,-71
9530,1,0,99,0,-99
9531,1,1,1118,3931,2813
9532,1,1,1317,1242,-75
9533,1,1,161,1262,1101
9534,0,0,65,0,-65
9535,1,1,305,2360,2055
9536,1,0,53,0,-53
9537,0,0,111,0,-111
9538,1,0,7,0,-7
9539,1,0,176,0,-176
9540,1,1,481,1232,751
9541,0,0,84,0,-84
9542,1,0,53,0,-53
9543,1,0,41,0,-41
9544,0,0,3,0,-3
9545,1,1,80,1348,1268
9546,0,0,265,0,-265
9547,0,0,27,0,-27
9548,1,1,661,1432,771
9549,1,1,285,1239,954
9550,0,0,97,0,-97
9551,1,1,112,1290,1178
9552,1,0,182,0,-182
9553,1,1,689,1449,760
9554,1,0,23,0,-23
9555,0,0,75,0,-75
9556,1,1,312,1213,901
9557,0,0,12,0,-12
9558,1,0,10,0,-10
9559,1,0,7,0,-7
9560,0,0,7,0,-7
9561,1,0,33,0,-33
9562,0,0,7,0,-7
9563,1,1,374,1381,1007
9564,1,1,1365,1402,37
9565,0,0,30,0,-30
9566,1,1,80,1603,1523
9567,1,0,16,0,-16
9568,1,0,19,0,-19
9569,1,0,98,0,-98
9570,1,0,145,0,-145
9571,1,0,37,0,-37
9572,0,0,25,0,-25
9573,0,0,68,0,-68
9574,1,1,22,2378,2356
9575,1,1,188,1275,1087
9576,1,1,903,1239,336
9577,1,0,10,0,-10
9578,0,0,50,0,-50
9579,1,1,275,1647,1372
9580,0,0,34,0,-34
9581,0,0,21,0,-21
9582,1,1,387,1292,905
9583,1,1,155,1349,1194
9584,1,1,109,1514,1405
9585,0,0,4,0,-4
9586,0,0,46,0,-46
9587,1,1,267,1287,1020
9588,0,0,4,0,-4
9589,0,0,84,0,-84
9590,1,1,1073,1575,502
9591,0,0,148,0,-148
9592,0,0,101,0,-101
9593,1,1,232,1308,1076
9594,0,0,12,0,-12
9595,1,1,299,1528,1229
9596,0,0,226,0,-226
9597,1,0,41,0,-41
9598,1,0,98,0,-98
9599,0,0,63,0,-63
9600,1,1,691,1319,628
9601,1,0,5,0,-5
9602,0,0,47,0,-47
9603,1,0,1,0,-1
9604,1,1,1125,1211,86
9605,1,0,28,0,-28
9606,1,1,271,1629,1358
9607,1,0,59,0,-59
9608,1,0,47,0,-47
9609,0,0,35,0,-35
9610,1,1,681,2191,1510
9611,1,0,168,0,-168
9612,0,0,95,0,-95
9613,0,0,68,0,-68
9614,1,1,584,1603,1019
9615,1,0,50,0,-50
9616,0,0,25,0,-25
9617,0,0,63,0,-63
9618,1,0,20,0,-20
9619,0,0,15,0,-15
9620,0,0,100,0,-100
9621,1,1,645,1439,794
9622,0,0,41,0,-41
9623,0,0,35,0,-35
9624,1,0,2,0,-2
9625,1,1,102,1256,1154
9626,0,0,58,0,-58
9627,0,0,15,0,-15
9628,0,0,96,0,-96
9629,0,0,84,0,-84
9630,0,0,127,0,-127
9631,0,0,36,0,-36
9632,0,0,66,0,-66
9633,1,0,179,0,-179
9634,0,0,17,0,-17
9635,1,1,47,1628,1581
9636,1,1,46,1365,1319
9637,0,0,24,0,-24
9638,0,0,4,0,-4
9639,1,0,44,0,-44
9640,1,1,765,1241,476
9641,0,0,155,0,-155
9642,1,1,221,1234,1013
9643,0,0,75,0,-75
9644,1,1,188,2783,2595
9645,1,1,398,1604,1206
9646,1,0,8,0,-8
9647,1,0,0,0,0
9648,1,1,186,2059,1873
9649,1,1,368,1364,996
9650,1,1,33,2219,2186
9651,1,0,49,0,-49
9652,0,0,17,0,-17
9653,1,1,132,1333,1201
9654,0,0,17,0,-17
9655,0,0,50,0,-50
9656,1,1,832,1360,528
9657,0,0,6,0,-6
9658,1,0,22,0,-22
9659,0,0,14,0,-14
9660,1,0,53,0,-53
9661,1,1,335,1393,1058
9662,1,0,13,0,-13
9663,0,0,103,0,-103
9664,0,0,31,0,-31
9665,1,1,403,1224,821
9666,0,0,61,0,-61
9667,0,0,28,0,-28
9668,1,0,29,0,-29
9669,0,0,150,0,-150
9670,0,0,12,0,-12
9671,0,0,0,0,0
9672,1,1,267,2924,2657
9673,1,0,13,0,-13
9674,1,0,21,0,-21
9675,1,0,116,0,-116
9676,1,1,38,1266,1228
9677,1,0,88,0,-88
9678,1,0,4,0,-4
9679,0,0,94,0,-94
9680,1,1,920,1261,341
9681,1,1,300,1328,1028
9682,1,1,932,1553,621
9683,0,0,72,0,-72
9684,1,0,45,0,-45
9685,0,0,89,0,-89
9686,1,1,301,1451,1150
9687,1,0,43,0,-43
9688,1,0,14,0,-14
9689,1,0,43,0,-43
9690,1,1,685,1585,900
9691,0,0,29,0,-29
9692,1,0,37,0,-37
9693,1,0,179,0,-179
9694,1,1,136,1378,1242
9695,1,0,65,0,-65
9696,0,0,22,0,-22
9697,1,1,144,1304,1160
9698,0,0,117,0,-117
9699,1,1,1037,1304,267
9700,1,0,7,0,-7
9701,1,1,596,1411,815
9702,0,0,64,0,-64
9703,1,1,1393,1270,-123
9704,1,0,5,0,-5
9705,0,0,32,0,-32
9706,0,0,19,0,-19
9707,1,0,34,0,-34
9708,1,0,271,0,-271
9709,1,1,56,1318,1262
9710,0,0,143,0,-143
9711,1,1,222,1725,1503
9712,1,0,43,0,-43
9713,1,0,22,0,-22
9714,0,0,52,0,-52
9715,0,0,47,0,-47
9716,1,0,7,0,-7
9717,0,0,7,0,-7
9718,0,0,8,0,-8
9719,1,0,79,0,-79
9720,0,0,19,0,-19
9721,0,0,1,0,-1
9722,1,1,130,1816,1686
9723,0,0,18,0,-18
9724,0,0,127,0,-127
9725,1,1,42,1614,1572
9726,0,0,4,0,-4
9727,1,1,476,1772,1296
9728,1,1,272,1495,1223
9729,0,0,128,0,-128
9730,1,0,1,0,-1
9731,1,0,77,0,-77
9732,1,1,1649,1343,-306
9733,1,0,40,0,-40
9734,1,0,3,0,-3
9735,0,0,232,0,-232
9736,1,0,134,0,-134
9737,1,1,1787,1534,-253
9738,1,0,136,0,-136
9739,1,0,50,0,-50
9740,0,0,45,0,-45
9741,1,1,1965,1434,-531
9742,1,1,503,1667,1164
9743,0,0,12,0,-12
9744,1,1,351,1206,855
9745,1,1,135,1263,1128
9746,0,0,22,0,-22
9747,1,0,28,0,-28
9748,1,1,426,1309,883
9749,0,0,57,0,-57
9750,0,0,54,0,-54
9751,0,0,36,0,-36
9752,1,1,706,2195,1489
9753,1,1,242,1246,1004
9754,1,1,98,1550,1452
9755,0,0,77,0,-77
9756,1,0,22,0,-22
9757,1,1,1149,1233,84
9758,0,0,15,0,-15
9759,1,0,67,0,-67
9760,1,1,24,1610,1586
9761,1,1,650,1484,834
9762,1,0,21,0,-21
9763,0,0,35,0,-35
9764,1,0,2,0,-2
9765,1,1,169,2047,1878
9766,1,0,111,0,-111
9767,0,0,16,0,-16
9768,1,0,24,0,-24
9769,0,0,43,0,-43
9770,1,1,575,1501,926
9771,0,0,32,0,-32
9772,1,1,230,3912,3682
9773,1,0,67,0,-67
9774,0,0,37,0,-37
9775,1,1,1044,2541,1497
9776,1,0,101,0,-101
9777,0,0,80,0,-80
9778,1,1,138,1229,1091
9779,1,1,181,1952,1771
9780,1,0,192,0,-192
9781,1,0,105,0,-105
9782,0,0,50,0,-50
9783,1,0,4,0,-4
9784,0,0,92,0,-92
9785,0,0,24,0,-24
9786,0,0,7,0,-7
9787,0,0,64,0,-64
9788,1,1,270,1264,994
9789,1,1,2525,1289,-1236
9790,1,0,23,0,-23
9791,1,1,94,1508,1414
9792,0,0,68,0,-68
9793,0,0,92,0,-92
9794,1,1,222,3194,2972
9795,0,0,15,0,-15
9796,0,0,85,0,-85
9797,0,0,22,0,-22
9798,1,1,848,1228,380
9799,1,1,26,1340,1314
9800,1,0,11,0,-11
9801,0,0,99,0,-99
9802,1,0,10,0,-10
9803,1,0,21,0,-21
9804,0,0,70,0,-70
9805,1,0,24,0,-24
9806,1,0,3,0,-3
9807,1,1,270,1854,1584
9808,1,0,73,0,-73
9809,1,1,261,1555,1294
9810,1,0,21,0,-21
9811,0,0,42,0,-42
9812,1,0,20,0,-20
9813,1,0,96,0,-96
9814,0,0,1,0,-1
9815,1,0,11,0,-11
9816,0,0,82,0,-82
9817,0,0,10,0,-10
9818,0,0,117,0,-117
9819,1,1,971,1310,339
9820,1,0,162,0,-162
9821,1,1,708,1763,1055
9822,1,1,210,1225,1015
9823,1,1,180,1322,1142
9824,0,0,8,0,-8
9825,0,0,22,0,-22
9826,0,0,5,0,-5
9827,1,1,485,1660,1175
9828,1,0,112,0,-112
9829,1,0,145,0,-145
9830,0,0,169,0,-169
9831,1,1,303,1420,1117
9832,1,0,12,0,-12
9833,1,1,748,1298,550
9834,1,0,32,0,-32
9835,0,0,57,0,-57
9836,0,0,65,0,-65
9837,0,0,35,0,-35
9838,0,0,46,0,-46
9839,1,0,1,0,-1
9840,0,0,197,0,-197
9841,1,0,17,0,-17
9842,1,0,25,0,-25
9843,0,0,11,0,-11
9844,1,0,71,0,-71
9845,0,0,81,0,-81
9846,0,0,16,0,-16
9847,1,0,39,0,-39
9848,0,0,96,0,-96
9849,1,0,93,0,-93
9850,1,0,61,0,-61
9851,1,0,41,0,-41
9852,1,1,2461,1320,-1141
9853,0,0,16,0,-16
9854,1,1,501,2049,1548
9855,1,0,87,0,-87
9856,1,1,1224,1248,24
9857,1,0,4,0,-4
9858,1,1,36,1419,1383
9859,0,0,1,0,-1
9860,0,0,90,0,-90
9861,0,0,10,0,-10
9862,1,0,5,0,-5
9863,0,0,6,0,-6
9864,0,0,87,0,-87
9865,1,1,935,2071,1136
9866,1,1,817,1460,643
9867,0,0,19,0,-19
9868,0,0,40,0,-40
9869,1,1,256,1570,1314
9870,1,0,6,0,-6
9871,1,1,76,2666,2590
9872,0,0,98,0,-98
9873,1,1,167,1770,1603
9874,0,0,13,0,-13
9875,0,0,33,0,-33
9876,1,1,63,1760,1697
9877,1,0,16,0,-16
9878,1,1,131,1267,1136
9879,1,0,82,0,-82
9880,1,0,9,0,-9
9881,0,0,26,0,-26
9882,0,0,12,0,-12
9883,0,0,19,0,-19
9884,0,0,72,0,-72
9885,1,0,126,0,-126
9886,1,0,40,0,-40
9887,1,0,15,0,-15
9888,1,0,37,0,-37
9889,1,0,1,0,-1
9890,0,0,24,0,-24
9891,0,0,82,0,-82
9892,0,0,11,0,-11
9893,1,0,32,0,-32
9894,0,0,52,0,-52
9895,1,1,255,1607,1352
9896,1,1,519,3151,2632
9897,0,0,27,0,-27
9898,1,1,428,1239,811
9899,1,1,213,1287,1074
9900,1,0,19,0,-19
9901,0,0,17,0,-17
9902,0,0,202,0,-202
9903,1,1,865,1629,764
9904,0,0,130,0,-130
9905,0,0,4,0,-4
9906,1,1,157,1547,1390
9907,1,1,1125,1254,129
9908,1,0,18,0,-18
9909,0,0,30,0,-30
9910,0,0,5,0,-5
9911,0,0,19,0,-19
9912,0,0,102,0,-102
9913,1,0,136,0,-136
9914,0,0,33,0,-33
9915,0,0,7,0,-7
9916,0,0,71,0,-71
9917,0,0,98,0,-98
9918,0,0,24,0,-24
9919,1,0,21,0,-21
9920,1,1,313,2144,1831
9921,0,0,67,0,-67
9922,1,0,52,0,-52
9923,1,0,34,0,-34
9924,1,0,21,0,-21
9925,1,0,22,0,-22
9926,0,0,85,0,-85
9927,0,0,8,0,-8
9928,0,0,72,0,-72
9929,1,1,1536,1338,-198
9930,0,0,12,0,-12
9931,1,1,1058,1476,418
9932,1,0,68,0,-68
9933,1,1,383,1225,842
9934,0,0,142,0,-142
9935,1,1,228,1494,1266
9936,1,0,48,0,-48
9937,1,0,26,0,-26
9938,1,1,663,1519,856
9939,1,1,247,1410,1163
9940,0,0,7,0,-7
9941,1,1,160,1278,1118
9942,1,0,24,0,-24
9943,1,0,26,0,-26
9944,1,0,32,0,-32
9945,1,1,151,1559,1408
9946,1,1,877,1417,540
9947,0,0,89,0,-89
9948,1,0,58,0,-58
9949,1,0,1,0,-1
9950,0,0,19,0,-19
9951,1,0,86,0,-86
9952,1,0,47,0,-47
9953,1,1,1776,1254,-522
9954,1,1,1035,1430,395
9955,0,0,67,0,-67
9956,1,1,231,1240,1009
9957,0,0,0,0,0
9958,0,0,23,0,-23
9959,1,1,270,1200,930
9960,0,0,25,0,-25
9961,0,0,14,0,-14
9962,0,0,2,0,-2
9963,0,0,243,0,-243
9964,0,0,25,0,-25
9965,1,1,151,1403,1252
9966,0,0,19,0,-19
9967,1,0,82,0,-82
9968,0,0,7,0,-7
9969,0,0,7,0,-7
9970,1,1,251,1736,1485
9971,1,0,11,0,-11
9972,0,0,60,0,-60
9973,0,0,2,0,-2
9974,1,0,23,0,-23
9975,0,0,58,0,-58
9976,1,1,2229,1371,-858
9977,1,1,488,1858,1370
9978,0,0,27,0,-27
9979,1,0,96,0,-96
9980,1,0,179,0,-179
9981,1,1,585,1331,746
9982,1,1,144,1201,1057
9983,0,0,0,0,0
9984,0,0,0,0,0
9985,0,0,21,0,-21
9986,0,0,59,0,-59
9987,1,0,18,0,-18
9988,1,0,33,0,-33
9989,1,0,30,0,-30
9990,0,0,35,0,-35
9991,1,1,487,1403,916
9992,1,1,294,1367,1073
9993,0,0,88,0,-88
9994,1,0,47,0,-47
9995,1,1,1225,1505,280
9996,1,0,45,0,-45
9997,1,0,78,0,-78
9998,1,0,58,0,-58
9999,1,0,175,0,-175
10000,0,0,7,0,-7
10001,0,0,63,0,-63
10002,1,1,625,1372,747
10003,1,1,750,1208,458
10004,1,0,53,0,-53
10005,1,1,275,1491,1216
10006,0,0,150,0,-150
10007,0,0,15,0,-15
10008,1,0,17,0,-17
10009,1,1,438,1825,1387
10010,0,0,5,0,-5
10011,0,0,59,0,-59
10012,0,0,2,0,-2
10013,1,0,70,0,-70
10014,0,0,129,0,-129
10015,0,0,107,0,-107
10016,0,0,9,0,-9
10017,0,0,8,0,-8
10018,1,1,265,1598,1333
10019,0,0,7,0,-7
10020,1,0,32,0,-32
10021,0,0,11,0,-11
10022,1,0,19,0,-19
10023,0,0,63,0,-63
10024,0,0,4,0,-4
10025,0,0,24,0,-24
10026,1,0,23,0,-23
10027,1,0,46,0,-46
10028,1,1,1476,1289,-187
10029,0,0,8,0,-8
10030,1,0,48,0,-48
10031,1,1,476,2119,1643
10032,1,0,3,0,-3
10033,0,0,11,0,-11
10034,1,0,54,0,-54
10035,0,0,11,0,-11
10036,1,0,5,0,-5
10037,0,0,286,0,-286
10038,0,0,112,0,-112
10039,1,0,42,0,-42
10040,1,0,20,0,-20
10041,1,1,231,1257,1026
10042,0,0,57,0,-57
10043,0,0,71,0,-71
10044,0,0,105,0,-105
10045,0,0,98,0,-98
10046,0,0,121,0,-121
10047,0,0,47,0,-47
10048,1,1,701,1250,549
10049,0,0,82,0,-82
10050,1,0,6,0,-6
10051,1,1,77,1617,1540
10052,1,1,308,1387,1079
10053,1,0,54,0,-54
10054,1,0,108,0,-108
10055,1,0,42,0,-42
10056,1,1,153,1704,1551
10057,1,0,186,0,-186
10058,1,0,22,0,-22
10059,0,0,32,0,-32
10060,1,1,150,2302,2152
10061,1,0,80,0,-80
10062,0,0,34,0,-34
10063,1,0,24,0,-24
10064,0,0,81,0,-81
10065,1,0,24,0,-24
10066,1,0,117,0,-117
10067,1,0,4,0,-4
10068,1,0,8,0,-8
10069,1,0,70,0,-70
10070,1,0,92,0,-92
10071,1,1,251,1695,1444
10072,0,0,242,0,-242
10073,0,0,30,0,-30
10074,1,1,44,1393,1349
10075,0,0,58,0,-58
10076,1,0,14,0,-14
10077,0,0,22,0,-22
10078,1,0,27,0,-27
10079,0,0,32,0,-32
10080,0,0,56,0,-56
10081,1,1,342,1970,1628
10082,1,0,71,0,-71
10083,1,1,1042,1925,883
10084,1,1,531,1549,1018
10085,1,1,54,1261,1207
10086,1,0,6,0,-6
10087,1,0,0,0,0
10088,1,0,53,0,-53
10089,0,0,9,0,-9
10090,1,0,15,0,-15
10091,1,1,470,1306,836
10092,1,0,42,0,-42
10093,1,1,773,1262,489
10094,1,1,255,1244,989
10095,0,0,44,0,-44
10096,0,0,125,0,-125
10097,0,0,16,0,-16
10098,0,0,46,0,-46
10099,1,1,353,1206,853
10100,1,0,236,0,-236
10101,1,1,732,1995,1263
10102,1,1,29,2280,2251
10103,0,0,68,0,-68
10104,1,1,1269,1279,10
10105,0,0,8,0,-8
10106,0,0,30,0,-30
10107,1,1,300,2939,2639
10108,0,0,29,0,-29
10109,1,0,48,0,-48
10110,0,0,25,0,-25
10111,1,0,21,0,-21
10112,0,0,79,0,-79
10113,1,0,74,0,-74
10114,0,0,35,0,-35
10115,0,0,54,0,-54
10116,0,0,40,0,-40
10117,1,1,765,1439,674
10118,0,0,43,0,-43
10119,0,0,60,0,-60
10120,1,1,198,1586,1388
10121,1,1,550,1201,651
10122,1,0,4,0,-4
10123,0,0,32,0,-32
10124,0,0,181,0,-181
10125,1,1,58,1341,1283
10126,0,0,95,0,-95
10127,1,0,0,0,0
10128,1,1,2175,1310,-865
10129,0,0,234,0,-234
10130,1,0,58,0,-58
10131,1,0,0,0,0
10132,1,0,44,0,-44
10133,1,1,1420,1701,281
10134,1,0,21,0,-21
10135,0,0,11,0,-11
10136,1,1,143,1231,1088
10137,0,0,10,0,-10
10138,1,1,335,1945,1610
10139,0,0,41,0,-41
10140,1,0,19,0,-19
10141,1,0,28,0,-28
10142,0,0,14,0,-14
10143,1,0,86,0,-86
10144,0,0,23,0,-23
10145,0,0,7,0,-7
10146,1,1,234,1692,1458
10147,1,0,42,0,-42
10148,0,0,39,0,-39
10149,1,1,858,1374,516
10150,1,0,30,0,-30
10151,0,0,81,0,-81
10152,0,0,92,0,-92
10153,1,1,358,2106,1748
10154,1,0,7,0,-7
10155,0,0,50,0,-50
10156,1,0,44,0,-44
10157,1,0,11,0,-11
10158,1,1,748,1363,615
10159,0,0,195,0,-195
10160,1,0,18,0,-18
10161,1,1,1240,1221,-19
10162,1,1,1087,1311,224
10163,1,0,56,0,-56
10164,0,0,15,0,-15
10165,1,1,603,1342,739
10166,0,0,179,0,-179
10167,1,0,44,0,-44
10168,1,1,1697,1757,60
10169,1,0,101,0,-101
10170,1,1,21,1648,1627
10171,0,0,12,0,-12
10172,0,0,15,0,-15
10173,1,0,63,0,-63
10174,1,1,1389,1482,93
10175,0,0,21,0,-21
10176,1,0,31,0,-31
10177,0,0,14,0,-14
10178,1,1,671,1286,615
10179,0,0,46,0,-46
10180,0,0,80,0,-80
10181,0,0,0,0,0
10182,0,0,106,0,-106
10183,1,0,10,0,-10
10184,1,1,98,1450,1352
10185,0,0,6,0,-6
10186,0,0,21,0,-21
10187,1,1,186,1300,1114
10188,1,1,1146,2323,1177
10189,1,1,106,1283,1177
10190,1,1,1433,1737,304
10191,1,1,230,1302,1072
10192,1,0,44,0,-44
10193,0,0,72,0,-72
10194,1,0,64,0,-64
10195,1,1,346,1921,1575
10196,1,1,296,1303,1007
10197,1,0,47,0,-47
10198,1,1,369,1236,867
10199,1,0,164,0,-164
10200,1,1,897,1677,780
10201,0,0,124,0,-124
10202,1,0,3,0,-3
10203,0,0,4,0,-4
10204,1,1,244,1781,1537
10205,1,0,75,0,-75
10206,1,0,4,0,-4
10207,1,1,344,2272,1928
10208,1,1,39,1421,1382
10209,0,0,66,0,-66
10210,1,0,56,0,-56
10211,1,0,241,0,-241
10212,1,1,56,1975,1919
10213,0,0,13,0,-13
10214,0,0,103,0,-103
10215,1,0,0,0,0
10216,1,0,83,0,-83
10217,1,0,10,0,-10
10218,1,0,46,0,-46
10219,0,0,99,0,-99
10220,1,1,1469,1211,-258
10221,1,1,46,1349,1303
10222,1,1,47,1601,1554
10223,0,0,52,0,-52
10224,0,0,31,0,-31
10225,1,1,65,1721,1656
10226,0,0,128,0,-128
10227,0,0,26,0,-26
10228,1,1,1399,1746,347
10229,1,0,187,0,-187
10230,0,0,55,0,-55
10231,1,0,15,0,-15
10232,0,0,16,0,-16
10233,0,0,63,0,-63
10234,0,0,12,0,-12
10235,1,0,13,0,-13
10236,0,0,3,0,-3
10237,1,0,32,0,-32
10238,1,0,109,0,-109
10239,1,0,68,0,-68
10240,1,0,99,0,-99
10241,0,0,70,0,-70
10242,1,0,22,0,-22
10243,0,0,82,0,-82
10244,0,0,59,0,-59
10245,1,1,34,2693,2659
10246,1,0,22,0,-22
10247,1,0,48,0,-48
10248,1,1,521,2221,1700
10249,0,0,1,0,-1
10250,1,0,88,0,-88
10251,0,0,33,0,-33
10252,1,1,1000,1566,566
10253,1,1,1119,1342,223
10254,1,1,496,2193,1697
10255,1,0,50,0,-50
10256,0,0,75,0,-75
10257,1,1,452,2455,2003
10258,0,0,29,0,-29
10259,1,0,51,0,-51
10260,1,0,15,0,-15
10261,0,0,71,0,-71
10262,0,0,7,0,-7
10263,0,0,29,0,-29
10264,1,1,226,1212,986
10265,1,0,55,0,-55
10266,0,0,177,0,-177
10267,1,0,40,0,-40
10268,0,0,22,0,-22
10269,0,0,9,0,-9
10270,0,0,61,0,-61
10271,0,0,0,0,0
10272,0,0,0,0,0
10273,1,0,41,0,-41
10274,0,0,69,0,-69
10275,0,0,32,0,-32
10276,1,0,6,0,-6
10277,0,0,100,0,-100
10278,0,0,36,0,-36
10279,1,0,7,0,-7
10280,1,0,65,0,-65
10281,0,0,15,0,-15
10282,1,1,503,1583,1080
10283,1,1,164,1271,1107
10284,1,1,1618,2048,430
10285,1,1,45,1348,1303
10286,1,1,295,2022,1727
10287,1,1,154,1477,1323
10288,0,0,140,0,-140
10289,1,1,388,1399,1011
10290,1,0,26,0,-26
10291,1,0,109,0,-109
10292,1,1,112,1767,1655
10293,1,1,1361,1411,50
10294,1,0,22,0,-22
10295,1,1,330,1394,1064
10296,1,1,150,2154,2004
10297,1,0,42,0,-42
10298,1,0,1,0,-1
10299,0,0,99,0,-99
10300,1,1,152,1632,1480
10301,0,0,74,0,-74
10302,1,0,19,0,-19
10303,0,0,17,0,-17
10304,0,0,10,0,-10
10305,1,0,37,0,-37
10306,1,1,1382,1973,591
10307,0,0,99,0,-99
10308,1,1,150,1860,1710
10309,1,0,46,0,-46
10310,1,0,52,0,-52
10311,1,0,36,0,-36
10312,1,1,186,1315,1129
10313,1,1,238,1737,1499
10314,1,0,81,0,-81
10315,1,0,111,0,-111
10316,1,1,320,1746,1426
10317,1,0,144,0,-144
10318,1,1,76,2144,2068
10319,1,1,306,1290,984
10320,1,0,20,0,-20
10321,1,1,2382,2258,-124
10322,0,0,7,0,-7
10323,0,0,0,0,0
10324,1,0,0,0,0
10325,0,0,77,0,-77
10326,0,0,88,0,-88
10327,0,0,5,0,-5
10328,0,0,26,0,-26
10329,0,0,7,0,-7
10330,0,0,15,0,-15
10331,0,0,50,0,-50
10332,0,0,48,0,-48
10333,0,0,61,0,-61
10334,0,0,3,0,-3
10335,1,0,84,0,-84
10336,1,1,82,1714,1632
10337,1,1,674,1365,691
10338,1,0,33,0,-33
10339,1,1,1005,1796,791
10340,1,0,67,0,-67
10341,1,1,1452,1360,-92
10342,0,0,184,0,-184
10343,1,0,65,0,-65
10344,0,0,34,0,-34
10345,1,0,26,0,-26
10346,1,0,16,0,-16
10347,0,0,17,0,-17
10348,0,0,79,0,-79
10349,0,0,14,0,-14
10350,1,1,410,1393,983
10351,1,1,660,2714,2054
10352,1,1,478,1604,1126
10353,0,0,40,0,-40
10354,1,0,13,0,-13
10355,1,0,18,0,-18
10356,0,0,14,0,-14
10357,0,0,36,0,-36
10358,1,1,904,1400,496
10359,1,0,102,0,-102
10360,0,0,76,0,-76
10361,1,1,84,1260,1176
10362,1,1,1281,1427,146
10363,0,0,140,0,-140
10364,0,0,2,0,-2
10365,0,0,61,0,-61
10366,1,1,509,1649,1140
10367,1,1,1677,1242,-435
10368,0,0,45,0,-45
10369,0,0,7,0,-7
10370,1,1,143,1226,1083
10371,0,0,120,0,-120
10372,1,1,154,2220,2066
10373,0,0,68,0,-68
10374,0,0,32,0,-32
10375,1,1,485,1203,718
10376,1,1,531,1329,798
10377,1,1,1515,1350,-165
10378,1,0,63,0,-63
10379,1,1,678,1239,561
10380,1,1,179,1283,1104
10381,1,0,12,0,-12
10382,1,1,187,2087,1900
10383,0,0,76,0,-76
10384,0,0,26,0,-26
10385,1,0,43,0,-43
10386,1,0,31,0,-31
10387,1,0,28,0,-28
10388,0,0,38,0,-38
10389,1,1,126,1235,1109
10390,0,0,49,0,-49
10391,1,1,628,1722,1094
10392,0,0,12,0,-12
10393,0,0,36,0,-36
10394,0,0,31,0,-31
10395,0,0,5,0,-5
10396,1,0,2,0,-2
10397,1,0,6,0,-6
10398,1,1,634,1285,651
10399,1,1,499,1741,1242
10400,1,0,67,0,-67
10401,1,1,60,1453,1393
10402,1,0,100,0,-100
10403,1,1,139,1356,1217
10404,1,1,165,1713,1548
10405,1,0,8,0,-8
10406,1,0,19,0,-19
10407,0,0,31,0,-31
10408,1,0,29,0,-29
10409,1,1,1249,1578,329
10410,1,0,45,0,-45
10411,1,1,54,1302,1248
10412,0,0,59,0,-59
10413,1,0,9,0,-9
10414,1,0,138,0,-138
10415,0,0,13,0,-13
10416,1,1,363,1807,1444
10417,0,0,2,0,-2
10418,1,0,52,0,-52
10419,0,0,4,0,-4
10420,1,1,444,1285,841
10421,0,0,2,0,-2
10422,0,0,9,0,-9
10423,0,0,30,0,-30
10424,1,1,176,1577,1401
10425,1,0,3,0,-3
10426,0,0,28,0,-28
10427,1,1,2230,1243,-987
10428,0,0,4,0,-4
10429,1,1,42,1228,1186
10430,1,1,383,2256,1873
10431,1,1,217,1506,1289
10432,1,0,9,0,-9
10433,0,0,117,0,-117
10434,0,0,101,0,-101
10435,1,1,161,1287,1126
10436,1,0,77,0,-77
10437,1,0,76,0,-76
10438,1,1,253,1431,1178
10439,0,0,44,0,-44
10440,1,1,620,1680,1060
10441,1,1,711,1921,1210
10442,1,1,1042,1241,199
10443,1,0,28,0,-28
10444,1,1,132,1728,1596
10445,1,0,22,0,-22
10446,1,1,506,2464,1958
10447,0,0,46,0,-46
10448,0,0,67,0,-67
10449,1,1,853,1305,452
10450,0,0,67,0,-67
10451,1,0,26,0,-26
10452,1,0,31,0,-31
10453,0,0,29,0,-29
10454,1,0,21,0,-21
10455,1,1,26,1756,1730
10456,0,0,41,0,-41
10457,1,0,7,0,-7
10458,0,0,7,0,-7
10459,1,0,90,0,-90
10460,0,0,20,0,-20
10461,1,1,741,1436,695
10462,1,1,951,1361,410
10463,1,1,120,1735,1615
10464,1,1,1236,1202,-34
10465,1,0,144,0,-144
10466,0,0,44,0,-44
10467,1,0,44,0,-44
10468,1,0,12,0,-12
10469,0,0,15,0,-15
10470,0,0,54,0,-54
10471,0,0,19,0,-19
10472,0,0,34,0,-34
10473,0,0,50,0,-50
10474,0,0,114,0,-114
10475,0,0,65,0,-65
10476,1,0,24,0,-24
10477,1,0,2,0,-2
10478,0,0,29,0,-29
10479,1,0,17,0,-17
10480,1,0,105,0,-105
10481,1,1,592,1300,708
10482,0,0,122,0,-122
10483,1,1,248,1541,1293
10484,1,0,4,0,-4
10485,0,0,98,0,-98
10486,0,0,18,0,-18
10487,1,0,41,0,-41
10488,1,0,9,0,-9
10489,1,0,33,0,-33
10490,0,0,246,0,-246
10491,1,1,388,1593,1205
10492,0,0,13,0,-13
10493,0,0,9,0,-9
10494,1,1,907,1352,445
10495,1,0,33,0,-33
10496,0,0,148,0,-148
10497,0,0,9,0,-9
10498,1,0,220,0,-220
10499,1,0,63,0,-63
10500,1,0,9,0,-9
10501,0,0,68,0,-68
10502,1,1,696,1600,904
10503,0,0,29,0,-29
10504,1,0,2,0,-2
10505,0,0,3,0,-3
10506,1,0,9,0,-9
10507,1,0,84,0,-84
10508,1,0,1,0,-1
10509,1,1,957,1634,677
10510,1,0,1,0,-1
10511,1,1,416,1682,1266
10512,1,1,215,1288,1073
10513,1,0,131,0,-131
10514,1,1,115,1233,1118
10515,0,0,9,0,-9
10516,0,0,190,0,-190
10517,0,0,35,0,-35
10518,1,0,27,0,-27
10519,0,0,26,0,-26
10520,1,1,218,1408,1190
10521,0,0,27,0,-27
10522,1,1,425,1535,1110
10523,0,0,13,0,-13
10524,1,1,247,1208,961
10525,0,0,33,0,-33
10526,1,0,14,0,-14
10527,1,1,2838,1472,-1366
10528,1,1,231,2081,1850
10529,0,0,15,0,-15
10530,1,1,12,1224,1212
10531,1,0,24,0,-24
10532,0,0,47,0,-47
10533,1,0,6,0,-6
10534,0,0,44,0,-44
10535,1,1,271,3193,2922
10536,1,1,1440,1304,-136
10537,1,1,243,1278,1035
10538,0,0,83,0,-83
10539,1,1,318,1414,1096
10540,0,0,83,0,-83
10541,1,1,663,1426,763
10542,0,0,79,0,-79
10543,0,0,10,0,-10
10544,0,0,128,0,-128
10545,0,0,4,0,-4
10546,1,0,145,0,-145
10547,0,0,9,0,-9
10548,0,0,21,0,-21
10549,1,1,230,1536,1306
10550,1,1,1159,1663,504
10551,0,0,7,0,-7
10552,0,0,13,0,-13
10553,1,1,788,1502,714
10554,1,1,120,1216,1096
10555,0,0,48,0,-48
10556,0,0,68,0,-68
10557,0,0,0,0,0
10558,0,0,37,0,-37
10559,1,0,34,0,-34
10560,1,1,1126,1257,131
10561,1,0,14,0,-14
10562,1,1,904,1484,580
10563,0,0,27,0,-27
10564,0,0,31,0,-31
10565,1,1,127,1660,1533
10566,1,0,9,0,-9
10567,0,0,13,0,-13
10568,1,1,327,1462,1135
10569,1,1,734,1327,593
10570,0,0,20,0,-20
10571,1,0,6,0,-6
10572,1,0,5,0,-5
10573,0,0,28,0,-28
10574,1,0,2,0,-2
10575,0,0,5,0,-5
10576,0,0,4,0,-4
10577,0,0,9,0,-9
10578,1,0,1,0,-1
10579,1,1,805,1304,499
10580,0,0,9,0,-9
10581,0,0,92,0,-92
10582,0,0,5,0,-5
10583,1,1,66,1379,1313
10584,1,1,387,1527,1140
10585,0,0,137,0,-137
10586,1,1,301,2124,1823
10587,1,0,50,0,-50
10588,1,1,935,2023,1088
10589,0,0,8,0,-8
10590,1,1,1183,1278,95
10591,1,1,1114,1768,654
10592,0,0,22,0,-22
10593,1,1,1540,1792,252
10594,1,0,56,0,-56
10595,1,1,207,2088,1881
10596,1,1,381,1450,1069
10597,1,1,111,1352,1241
10598,0,0,1,0,-1
10599,1,1,1148,1284,136
10600,1,0,16,0,-16
10601,1,1,433,1235,802
10602,1,1,430,1441,1011
10603,0,0,16,0,-16
10604,0,0,1,0,-1
10605,1,1,666,1444,778
10606,1,1,655,1644,989
10607,1,0,127,0,-127
10608,1,1,197,1802,1605
10609,0,0,98,0,-98
10610,1,0,80,0,-80
10611,0,0,7,0,-7
10612,0,0,4,0,-4
10613,0,0,30,0,-30
10614,0,0,50,0,-50
10615,1,1,1273,1336,63
10616,0,0,5,0,-5
10617,1,0,75,0,-75
10618,0,0,13,0,-13
10619,0,0,53,0,-53
10620,1,0,26,0,-26
10621,1,0,19,0,-19
10622,0,0,24,0,-24
10623,1,1,88,1316,1228
10624,1,1,216,1581,1365
10625,0,0,21,0,-21
10626,1,0,46,0,-46
10627,1,1,692,1309,617
10628,0,0,41,0,-41
10629,0,0,33,0,-33
10630,0,0,9,0,-9
10631,1,0,65,0,-65
10632,0,0,43,0,-43
10633,0,0,55,0,-55
10634,0,0,23,0,-23
10635,0,0,65,0,-65
10636,1,0,75,0,-75
10637,0,0,54,0,-54
10638,1,1,984,2531,1547
10639,1,1,119,1222,1103
10640,1,0,19,0,-19
10641,1,1,1017,1436,419
10642,0,0,104,0,-104
10643,0,0,70,0,-70
10644,1,1,62,1760,1698
10645,0,0,51,0,-51
10646,0,0,14,0,-14
10647,0,0,9,0,-9
10648,0,0,25,0,-25
10649,1,0,3,0,-3
10650,1,1,289,2388,2099
10651,0,0,117,0,-117
10652,1,0,10,0,-10
10653,1,0,27,0,-27
10654,0,0,35,0,-35
10655,0,0,72,0,-72
10656,1,0,54,0,-54
10657,1,0,22,0,-22
10658,0,0,15,0,-15
10659,1,1,149,1470,1321
10660,1,1,358,1274,916
10661,1,0,15,0,-15
10662,1,0,3,0,-3
10663,0,0,26,0,-26
10664,1,1,1001,1393,392
10665,1,1,312,1368,1056
10666,1,1,1541,1239,-302
10667,0,0,1,0,-1
10668,1,0,2,0,-2
10669,1,0,9,0,-9
10670,0,0,95,0,-95
10671,0,0,23,0,-23
10672,1,0,36,0,-36
10673,1,0,54,0,-54
10674,1,1,268,1546,1278
10675,0,0,57,0,-57
10676,1,0,24,0,-24
10677,1,1,357,1203,846
10678,1,1,389,1942,1553
10679,1,1,1259,1465,206
10680,1,0,29,0,-29
10681,1,0,56,0,-56
10682,1,1,1784,1497,-287
10683,1,1,226,1459,1233
10684,1,1,789,1589,800
10685,1,0,269,0,-269
10686,1,1,343,2234,1891
10687,0,0,48,0,-48
10688,0,0,42,0,-42
10689,0,0,12,0,-12
10690,0,0,41,0,-41
10691,1,0,29,0,-29
10692,1,0,5,0,-5
10693,1,1,96,1348,1252
10694,1,0,16,0,-16
10695,0,0,23,0,-23
10696,1,0,49,0,-49
10697,0,0,4,0,-4
10698,0,0,15,0,-15
10699,0,0,15,0,-15
10700,1,1,142,1351,1209
10701,0,0,85,0,-85
10702,1,1,908,1533,625
10703,0,0,13,0,-13
10704,1,1,177,1617,1440
10705,1,0,84,0,-84
10706,1,0,1,0,-1
10707,1,0,12,0,-12
10708,0,0,18,0,-18
10709,0,0,34,0,-34
10710,1,0,5,0,-5
10711,0,0,107,0,-107
10712,1,0,98,0,-98
10713,1,1,337,1209,872
10714,1,0,171,0,-171
10715,0,0,18,0,-18
10716,1,0,75,0,-75
10717,0,0,108,0,-108
10718,1,0,118,0,-118
10719,0,0,116,0,-116
10720,1,0,93,0,-93
10721,1,0,9,0,-9
10722,1,1,1027,1429,402
10723,1,1,511,1529,1018
10724,0,0,57,0,-57
10725,1,1,223,1208,985
10726,1,0,9,0,-9
10727,0,0,57,0,-57
10728,0,0,69,0,-69
10729,1,0,10,0,-10
10730,0,0,51,0,-51
10731,0,0,67,0,-67
10732,0,0,24,0,-24
10733,0,0,0,0,0
10734,0,0,148,0,-148
10735,0,0,29,0,-29
10736,0,0,48,0,-48
10737,1,1,406,1299,893
10738,1,1,67,1221,1154
10739,1,1,355,2262,1907
10740,0,0,63,0,-63
10741,1,1,187,1304,1117
10742,1,0,24,0,-24
10743,1,1,195,1244,1049
10744,1,1,157,1269,1112
10745,0,0,140,0,-140
10746,0,0,21,0,-21
10747,1,1,408,1424,1016
10748,1,1,2676,1436,-1240
10749,1,1,475,1564,1089
10750,0,0,29,0,-29
10751,1,0,0,0,0
10752,0,0,130,0,-130
10753,1,0,53,0,-53
10754,0,0,8,0,-8
10755,0,0,243,0,-243
10756,1,1,1716,4164,2448
10757,0,0,153,0,-153
10758,1,0,34,0,-34
10759,0,0,11,0,-11
10760,1,0,81,0,-81
10761,0,0,107,0,-107
10762,1,1,610,1993,1383
10763,0,0,42,0,-42
10764,0,0,58,0,-58
10765,1,0,58,0,-58
10766,0,0,112,0,-112
10767,0,0,52,0,-52
10768,0,0,7,0,-7
10769,1,0,16,0,-16
10770,0,0,7,0,-7
10771,1,1,398,1484,1086
10772,1,0,50,0,-50
10773,1,0,71,0,-71
10774,1,0,8,0,-8
10775,0,0,21,0,-21
10776,1,1,499,1716,1217
10777,1,0,113,0,-113
10778,1,1,144,1365,1221
10779,0,0,2,0,-2
10780,0,0,59,0,-59
10781,1,1,156,1904,1748
10782,1,0,110,0,-110
10783,1,0,1,0,-1
10784,0,0,34,0,-34
10785,0,0,101,0,-101
10786,0,0,87,0,-87
10787,1,1,892,1500,608
10788,1,1,306,1305,999
10789,0,0,11,0,-11
10790,1,0,137,0,-137
10791,0,0,69,0,-69
10792,0,0,42,0,-42
10793,1,1,73,1243,1170
10794,0,0,11,0,-11
10795,0,0,0,0,0
10796,1,0,17,0,-17
10797,0,0,16,0,-16
10798,1,1,50,1635,1585
10799,0,0,18,0,-18
10800,1,0,91,0,-91
10801,0,0,88,0,-88
10802,1,1,101,1245,1144
10803,1,0,86,0,-86
10804,1,0,76,0,-76
10805,0,0,12,0,-12
10806,1,0,27,0,-27
10807,1,1,117,1817,1700
10808,0,0,54,0,-54
10809,0,0,29,0,-29
10810,0,0,51,0,-51
10811,1,0,19,0,-19
10812,1,1,171,1221,1050
10813,1,0,53,0,-53
10814,1,0,78,0,-78
10815,1,1,1037,1274,237
10816,1,1,1090,1830,740
10817,1,0,14,0,-14
10818,1,0,8,0,-8
10819,1,1,820,1618,798
10820,1,0,300,0,-300
10821,1,1,100,1250,1150
10822,1,1,1152,1895,743
10823,1,0,78,0,-78
10824,0,0,5,0,-5
10825,1,1,511,1263,752
10826,1,1,671,1299,628
10827,1,1,196,1601,1405
10828,1,0,5,0,-5
10829,0,0,33,0,-33
10830,0,0,112,0,-112
10831,1,1,436,1545,1109
10832,1,1,390,2343,1953
10833,1,1,735,1442,707
10834,1,1,779,1971,1192
10835,0,0,38,0,-38
10836,1,0,41,0,-41
10837,1,0,22,0,-22
10838,0,0,49,0,-49
10839,1,1,819,1650,831
10840,0,0,13,0,-13
10841,0,0,167,0,-167
10842,1,0,37,0,-37
10843,0,0,3,0,-3
10844,1,0,7,0,-7
10845,0,0,0,0,0
10846,0,0,30,0,-30
10847,1,0,8,0,-8
10848,1,0,20,0,-20
10849,0,0,97,0,-97
10850,0,0,35,0,-35
10851,1,1,847,1606,759
10852,0,0,86,0,-86
10853,1,1,298,1653,1355
10854,0,0,11,0,-11
10855,0,0,119,0,-119
10856,1,1,100,1382,1282
10857,0,0,115,0,-115
10858,0,0,44,0,-44
10859,1,0,83,0,-83
10860,1,1,183,1226,1043
10861,0,0,20,0,-20
10862,1,0,61,0,-61
10863,0,0,6,0,-6
10864,0,0,233,0,-233
10865,1,0,18,0,-18
10866,1,0,20,0,-20
10867,0,0,12,0,-12
10868,1,1,94,1589,1495
10869,0,0,56,0,-56
10870,0,0,65,0,-65
10871,1,0,10,0,-10
10872,1,0,2,0,-2
10873,0,0,81,0,-81
10874,1,0,85,0,-85
10875,1,1,286,1281,995
10876,1,0,69,0,-69
10877,1,0,7,0,-7
10878,1,1,515,1373,858
10879,1,1,475,1255,780
10880,1,0,161,0,-161
10881,1,0,62,0,-62
10882,1,0,24,0,-24
10883,1,1,263,1970,1707
10884,1,0,3,0,-3
10885,1,0,11,0,-11
10886,1,0,202,0,-202
10887,1,0,13,0,-13
10888,0,0,36,0,-36
10889,1,0,27,0,-27
10890,1,1,296,1672,1376
10891,1,0,115,0,-115
10892,1,0,12,0,-12
10893,1,0,40,0,-40
10894,1,0,4,0,-4
10895,1,1,1267,2012,745
10896,0,0,13,0,-13
10897,0,0,55,0,-55
10898,1,0,8,0,-8
10899,0,0,122,0,-122
10900,1,1,165,1425,1260
10901,1,1,865,1384,519
10902,1,1,744,1578,834
10903,0,0,57,0,-57
10904,1,0,15,0,-15
10905,0,0,19,0,-19
10906,1,1,351,1508,1157
10907,1,1,233,3564,3331
10908,0,0,2,0,-2
10909,1,0,25,0,-25
10910,0,0,98,0,-98
10911,0,0,3,0,-3
10912,1,1,232,1297,1065
10913,1,0,35,0,-35
10914,0,0,83,0,-83
10915,1,0,48,0,-48
10916,0,0,56,0,-56
10917,1,0,19,0,-19
10918,1,0,11,0,-11
10919,1,1,1433,1480,47
10920,0,0,13,0,-13
10921,0,0,8,0,-8
10922,1,0,49,0,-49
10923,1,0,68,0,-68
10924,1,0,1,0,-1
10925,1,1,1186,1266,80
10926,1,0,22,0,-22
10927,0,0,16,0,-16
10928,0,0,1,0,-1
10929,1,0,38,0,-38
10930,1,0,1,0,-1
10931,0,0,14,0,-14
10932,1,1,2162,1249,-913
10933,0,0,79,0,-79
10934,0,0,17,0,-17
10935,0,0,3,0,-3
10936,0,0,72,0,-72
10937,0,0,1,0,-1
10938,1,1,710,1318,608
10939,0,0,4,0,-4
10940,1,0,3,0,-3
10941,0,0,98,0,-98
10942,0,0,66,0,-66
10943,1,1,559,1615,1056
10944,1,1,59,1318,1259
10945,1,1,602,1232,630
10946,1,0,132,0,-132
10947,1,0,3,0,-3
10948,1,0,26,0,-26
10949,0,0,26,0,-26
10950,1,0,11,0,-11
10951,1,1,190,1273,1083
10952,1,1,1981,4765,2784
10953,0,0,10,0,-10
10954,1,1,166,1309,1143
10955,0,0,189,0,-189
10956,1,1,499,1747,1248
10957,1,0,20,0,-20
10958,1,1,57,1219,1162
10959,1,1,1196,1211,15
10960,0,0,43,0,-43
10961,0,0,20,0,-20
10962,1,0,17,0,-17
10963,0,0,26,0,-26
10964,0,0,185,0,-185
10965,1,1,665,1566,901
10966,0,0,88,0,-88
10967,1,1,494,1212,718
10968,1,0,9,0,-9
10969,1,0,84,0,-84
10970,1,0,22,0,-22
10971,1,1,215,1355,1140
10972,0,0,6,0,-6
10973,1,1,245,1228,983
10974,0,0,18,0,-18
10975,0,0,44,0,-44
10976,1,0,49,0,-49
10977,1,0,31,0,-31
10978,1,1,294,1579,1285
10979,1,1,258,1200,942
10980,0,0,208,0,-208
10981,0,0,84,0,-84
10982,1,0,145,0,-145
10983,1,1,737,1212,475
10984,0,0,115,0,-115
10985,1,0,22,0,-22
10986,0,0,23,0,-23
10987,0,0,16,0,-16
10988,1,1,593,1215,622
10989,1,0,43,0,-43
10990,1,1,982,1376,394
10991,1,1,555,2423,1868
10992,0,0,101,0,-101
10993,1,0,133,0,-133
10994,1,0,66,0,-66
10995,0,0,238,0,-238
10996,1,0,1,0,-1
10997,1,1,341,1346,1005
10998,0,0,44,0,-44
10999,1,1,1339,2173,834
11000,1,1,238,1547,1309
11001,1,1,741,2144,1403
11002,1,0,52,0,-52
11003,0,0,8,0,-8
11004,0,0,25,0,-25
11005,1,1,249,1266,1017
11006,1,1,503,3398,2895
11007,1,1,368,1527,1159
11008,0,0,1,0,-1
11009,1,1,310,1231,921
11010,1,0,2,0,-2
11011,1,1,64,1609,1545
11012,1,1,515,1208,693
11013,1,1,239,1587,1348
11014,0,0,54,0,-54
11015,1,1,630,1699,1069
11016,1,1,362,1242,880
11017,1,0,91,0,-91
11018,1,0,149,0,-149
11019,0,0,2,0,-2
11020,1,1,85,1210,1125
11021,1,0,96,0,-96
11022,1,1,104,1510,1406
11023,1,0,115,0,-115
11024,0,0,23,0,-23
11025,0,0,78,0,-78
11026,0,0,161,0,-161
11027,0,0,37,0,-37
11028,0,0,164,0,-164
11029,1,1,637,1807,1170
11030,0,0,119,0,-119
11031,1,0,113,0,-113
11032,0,0,10,0,-10
11033,1,0,18,0,-18
11034,1,1,250,1258,1008
11035,1,1,266,1564,1298
11036,1,1,751,1320,569
11037,0,0,17,0,-17
11038,0,0,69,0,-69
11039,1,0,10,0,-10
11040,1,1,122,3726,3604
11041,1,1,540,2009,1469
11042,1,1,70,1208,1138
11043,1,0,16,0,-16
11044,0,0,38,0,-38
11045,1,1,280,2179,1899
11046,1,1,115,1345,1230
11047,1,1,337,1205,868
11048,1,0,7,0,-7
11049,0,0,66,0,-66
11050,0,0,6,0,-6
11051,1,1,1141,1354,213
11052,1,1,827,1515,688
11053,0,0,150,0,-150
11054,1,1,294,1520,1226
11055,0,0,213,0,-213
11056,1,1,232,1436,1204
11057,1,0,29,0,-29
11058,1,0,136,0,-136
11059,1,0,23,0,-23
11060,1,0,65,0,-65
11061,1,0,29,0,-29
11062,0,0,167,0,-167
11063,1,1,1373,1415,42
11064,0,0,132,0,-132
11065,0,0,108,0,-108
11066,1,0,65,0,-65
11067,1,1,865,1266,401
11068,1,0,68,0,-68
11069,1,0,81,0,-81
11070,0,0,33,0,-33
11071,0,0,19,0,-19
11072,0,0,39,0,-39
11073,0,0,43,0,-43
11074,1,1,896,1608,712
11075,0,0,51,0,-51
11076,0,0,38,0,-38
11077,1,0,71,0,-71
11078,1,1,46,1298,1252
11079,1,1,372,1388,1016
11080,1,1,44,1337,1293
11081,0,0,83,0,-83
11082,1,0,4,0,-4
11083,1,0,27,0,-27
11084,1,1,161,1326,1165
11085,1,0,0,0,0
11086,0,0,72,0,-72
11087,0,0,28,0,-28
11088,1,0,78,0,-78
11089,0,0,44,0,-44
11090,1,0,13,0,-13
11091,1,0,44,0,-44
11092,0,0,131,0,-131
11093,1,0,9,0,-9
11094,1,1,173,1320,1147
11095,1,1,189,1651,1462
11096,0,0,97,0,-97
11097,1,1,529,1504,975
11098,1,0,114,0,-114
11099,0,0,74,0,-74
11100,1,1,693,2539,1846
11101,1,1,213,1276,1063
11102,1,1,702,1547,845
11103,1,0,3,0,-3
11104,0,0,26,0,-26
11105,1,1,1552,1201,-351
11106,1,0,53,0,-53
11107,1,1,615,1396,781
11108,0,0,3,0,-3
11109,1,1,665,1465,800
11110,1,1,992,2824,1832
11111,1,1,326,1244,918
11112,0,0,1,0,-1
11113,1,1,238,1841,1603
11114,1,1,393,1219,826
11115,0,0,62,0,-62
11116,0,0,19,0,-19
11117,1,1,241,1723,1482
11118,1,0,58,0,-58
11119,1,0,110,0,-110
11120,1,0,21,0,-21
11121,1,1,149,1341,1192
11122,1,1,760,1395,635
11123,1,0,30,0,-30
11124,0,0,5,0,-5
11125,1,0,6,0,-6
11126,0,0,36,0,-36
11127,1,1,1023,1806,783
11128,1,1,628,1497,869
11129,1,1,116,2376,2260
11130,0,0,2,0,-2
11131,1,1,533,1451,918
11132,0,0,22,0,-22
11133,1,0,31,0,-31
11134,1,0,58,0,-58
11135,0,0,0,0,0
11136,1,0,9,0,-9
11137,0,0,175,0,-175
11138,1,1,234,1759,1525
11139,1,1,269,2361,2092
11140,1,0,58,0,-58
11141,1,0,15,0,-15
11142,0,0,16,0,-16
11143,0,0,13,0,-13
11144,0,0,11,0,-11
11145,1,1,1284,3072,1788
11146,1,1,296,1427,1131
11147,1,0,104,0,-104
11148,0,0,77,0,-77
11149,1,0,42,0,-42
11150,0,0,73,0,-73
11151,1,1,239,2271,2032
11152,0,0,40,0,-40
11153,0,0,13,0,-13
11154,1,0,92,0,-92
11155,1,1,242,1303,1061
11156,1,1,317,1279,962
11157,0,0,7,0,-7
11158,1,1,104,1448,1344
11159,0,0,22,0,-22
11160,1,0,51,0,-51
11161,0,0,26,0,-26
11162,0,0,20,0,-20
11163,0,0,21,0,-21
11164,1,1,527,1533,1006
11165,1,1,717,1220,503
11166,0,0,162,0,-162
11167,0,0,20,0,-20
11168,1,0,53,0,-53
11169,0,0,24,0,-24
11170,1,1,249,1606,1357
11171,1,0,67,0,-67
11172,0,0,48,0,-48
11173,0,0,3,0,-3
11174,1,1,641,1235,594
11175,1,1,507,1263,756
11176,1,0,25,0,-25
11177,0,0,28,0,-28
11178,1,0,227,0,-227
11179,1,0,218,0,-218
11180,1,0,19,0,-19
11181,0,0,17,0,-17
11182,0,0,4,0,-4
11183,0,0,22,0,-22
11184,1,1,394,1235,841
11185,1,0,64,0,-64
11186,0,0,8,0,-8
11187,1,1,1040,1290,250
11188,1,0,92,0,-92
11189,1,0,12,0,-12
11190,1,0,101,0,-101
11191,1,0,17,0,-17
11192,0,0,81,0,-81
11193,1,1,318,1235,917
11194,1,0,58,0,-58
11195,0,0,23,0,-23
11196,1,0,215,0,-215
11197,0,0,165,0,-165
11198,0,0,47,0,-47
11199,1,1,72,1922,1850
11200,0,0,127,0,-127
11201,0,0,14,0,-14
11202,1,1,1027,2260,1233
11203,0,0,196,0,-196
11204,1,1,853,1566,713
11205,0,0,52,0,-52
11206,0,0,71,0,-71
11207,0,0,22,0,-22
11208,1,1,58,2224,2166
11209,1,1,569,1581,1012
11210,1,0,109,0,-109
11211,1,1,221,1455,1234
11212,1,1,527,1228,701
11213,0,0,23,0,-23
11214,0,0,47,0,-47
11215,0,0,14,0,-14
11216,1,1,1034,1560,526
11217,1,1,334,1385,1051
11218,0,0,26,0,-26
11219,1,0,158,0,-158
11220,1,0,12,0,-12
11221,0,0,8,0,-8
11222,0,0,7,0,-7
11223,0,0,68,0,-68
11224,0,0,11,0,-11
11225,1,0,66,0,-66
11226,1,1,1383,1263,-120
11227,1,0,102,0,-102
11228,1,1,217,1349,1132
11229,0,0,94,0,-94
11230,1,0,100,0,-100
11231,0,0,20,0,-20
11232,1,1,296,1725,1429
11233,1,0,24,0,-24
11234,1,0,183,0,-183
11235,1,1,264,1357,1093
11236,1,1,322,1659,1337
11237,1,0,23,0,-23
11238,1,1,121,1412,1291
11239,1,1,150,1326,1176
11240,0,0,21,0,-21
11241,0,0,59,0,-59
11242,0,0,1,0,-1
11243,0,0,43,0,-43
11244,0,0,83,0,-83
11245,1,0,16,0,-16
11246,1,1,328,1808,1480
11247,0,0,29,0,-29
11248,1,0,23,0,-23
11249,1,1,160,1349,1189
11250,0,0,102,0,-102
11251,1,1,781,2163,1382
11252,1,1,222,2773,2551
11253,1,0,37,0,-37
11254,1,1,776,1379,603
11255,0,0,9,0,-9
11256,1,0,28,0,-28
11257,1,1,1751,1357,-394
11258,1,0,31,0,-31
11259,1,1,903,1506,603
11260,0,0,8,0,-8
11261,1,0,13,0,-13
11262,0,0,21,0,-21
11263,0,0,57,0,-57
11264,1,0,10,0,-10
11265,0,0,4,0,-4
11266,1,0,39,0,-39
11267,0,0,15,0,-15
11268,1,0,160,0,-160
11269,0,0,286,0,-286
11270,1,0,87,0,-87
11271,1,0,12,0,-12
11272,1,1,250,2237,1987
11273,0,0,45,0,-45
11274,1,1,2420,1958,-462
11275,0,0,88,0,-88
11276,1,1,1207,1511,304
11277,1,0,61,0,-61
11278,1,1,900,1684,784
11279,1,1,6,2154,2148
11280,0,0,38,0,-38
11281,1,1,1751,1448,-303
11282,1,0,11,0,-11
11283,0,0,116,0,-116
11284,1,0,51,0,-51
11285,0,0,64,0,-64
11286,1,0,0,0,0
11287,0,0,68,0,-68
11288,0,0,22,0,-22
11289,1,0,18,0,-18
11290,1,0,125,0,-125
11291,0,0,98,0,-98
11292,1,1,1145,9055,7910
11293,0,0,104,0,-104
11294,1,0,18,0,-18
11295,0,0,22,0,-22
11296,0,0,84,0,-84
11297,0,0,1,0,-1
11298,0,0,39,0,-39
11299,1,1,467,1327,860
11300,1,0,16,0,-16
11301,1,1,553,2328,1775
11302,0,0,88,0,-88
11303,0,0,8,0,-8
11304,1,1,429,1305,876
11305,1,1,17,1370,1353
11306,1,1,76,1328,1252
11307,1,0,23,0,-23
11308,0,0,91,0,-91
11309,0,0,171,0,-171
11310,0,0,30,0,-30
11311,1,1,921,1597,676
11312,1,0,30,0,-30
11313,1,0,19,0,-19
11314,0,0,120,0,-120
11315,0,0,17,0,-17
11316,0,0,8,0,-8
11317,1,1,108,1629,1521
11318,1,0,78,0,-78
11319,0,0,27,0,-27
11320,1,1,391,1360,969
11321,1,1,401,1223,822
11322,0,0,12,0,-12
11323,1,1,377,1349,972
11324,1,0,1,0,-1
11325,0,0,86,0,-86
11326,1,1,277,1443,1166
11327,1,0,44,0,-44
11328,1,1,1527,1230,-297
11329,1,1,482,1234,752
11330,0,0,75,0,-75
11331,1,1,1361,1701,340
11332,1,1,357,1322,965
11333,1,0,71,0,-71
11334,1,0,77,0,-77
11335,1,0,4,0,-4
11336,1,0,32,0,-32
11337,1,0,27,0,-27
11338,1,1,227,1340,1113
11339,1,0,75,0,-75
11340,1,1,951,1287,336
11341,0,0,75,0,-75
11342,1,0,8,0,-8
11343,1,0,145,0,-145
11344,0,0,109,0,-109
11345,0,0,8,0,-8
11346,1,0,8,0,-8
11347,1,1,1181,1316,135
11348,1,1,1182,1343,161
11349,1,0,35,0,-35
11350,0,0,1,0,-1
11351,1,0,45,0,-45
11352,0,0,82,0,-82
11353,1,0,20,0,-20
11354,1,1,318,1378,1060
11355,1,0,21,0,-21
11356,1,1,870,1267,397
11357,1,1,84,1686,1602
11358,1,1,1162,1301,139
11359,0,0,6,0,-6
11360,1,0,41,0,-41
11361,0,0,59,0,-59
11362,1,1,1672,3427,1755
11363,1,1,79,1638,1559
11364,1,0,12,0,-12
11365,1,0,29,0,-29
11366,1,1,463,3130,2667
11367,1,0,63,0,-63
11368,1,1,82,1727,1645
11369,1,1,410,1224,814
11370,1,0,17,0,-17
11371,1,1,419,1410,991
11372,1,1,237,1237,1000
11373,0,0,3,0,-3
11374,1,1,94,1300,1206
11375,0,0,78,0,-78
11376,1,0,1,0,-1
11377,1,0,13,0,-13
11378,1,1,343,1618,1275
11379,1,1,276,1536,1260
11380,0,0,62,0,-62
11381,0,0,21,0,-21
11382,1,1,296,1321,1025
11383,1,0,90,0,-90
11384,0,0,27,0,-27
11385,1,1,179,1377,1198
11386,0,0,6,0,-6
11387,1,0,7,0,-7
11388,0,0,31,0,-31
11389,1,0,94,0,-94
11390,1,1,841,1222,381
11391,0,0,4,0,-4
11392,1,1,954,1334,380
11393,0,0,227,0,-227
11394,0,0,176,0,-176
11395,1,1,467,1344,877
11396,0,0,227,0,-227
11397,1,0,21,0,-21
11398,0,0,35,0,-35
11399,0,0,64,0,-64
11400,0,0,21,0,-21
11401,0,0,12,0,-12
11402,0,0,21,0,-21
11403,1,0,57,0,-57
11404,1,1,955,1393,438
11405,1,0,26,0,-26
11406,0,0,13,0,-13
11407,1,0,157,0,-157
11408,1,0,123,0,-123
11409,1,0,10,0,-10
11410,0,0,75,0,-75
11411,0,0,49,0,-49
11412,0,0,87,0,-87
11413,1,0,120,0,-120
11414,0,0,9,0,-9
11415,0,0,32,0,-32
11416,1,0,133,0,-133
11417,0,0,90,0,-90
11418,0,0,42,0,-42
11419,1,0,12,0,-12
11420,1,1,657,1651,994
11421,1,0,1,0,-1
11422,1,0,40,0,-40
11423,1,1,141,1284,1143
11424,1,0,43,0,-43
11425,1,0,15,0,-15
11426,0,0,19,0,-19
11427,0,0,71,0,-71
11428,0,0,154,0,-154
11429,1,0,39,0,-39
11430,1,1,872,1556,684
11431,1,0,0,0,0
11432,0,0,19,0,-19
11433,1,0,5,0,-5
11434,1,1,707,1390,683
11435,0,0,2,0,-2
11436,1,0,119,0,-119
11437,1,0,49,0,-49
11438,1,1,156,1322,1166
11439,1,1,213,1746,1533
11440,1,1,428,1238,810
11441,0,0,58,0,-58
11442,1,1,1453,2958,1505
11443,0,0,67,0,-67
11444,0,0,107,0,-107
11445,1,0,114,0,-114
11446,1,0,69,0,-69
11447,1,1,47,1797,1750
11448,1,1,209,1436,1227
11449,0,0,26,0,-26
11450,1,0,1,0,-1
11451,0,0,48,0,-48
11452,1,0,6,0,-6
11453,0,0,98,0,-98
11454,1,0,34,0,-34
11455,1,1,1538,1271,-267
11456,1,0,3,0,-3
11457,1,0,35,0,-35
11458,1,1,324,1358,1034
11459,0,0,7,0,-7
11460,1,0,24,0,-24
11461,1,0,6,0,-6
11462,1,1,1751,1251,-500
11463,1,0,15,0,-15
11464,0,0,81,0,-81
11465,1,0,46,0,-46
11466,1,1,434,1346,912
11467,1,0,1,0,-1
11468,1,1,482,2150,1668
11469,1,0,50,0,-50
11470,1,0,79,0,-79
11471,0,0,95,0,-95
11472,1,0,81,0,-81
11473,1,1,131,1385,1254
11474,0,0,6,0,-6
11475,0,0,3,0,-3
11476,0,0,11,0,-11
11477,1,0,10,0,-10
11478,1,1,924,1526,602
11479,1,1,73,1305,1232
11480,1,1,108,1681,1573
11481,1,1,576,1297,721
11482,1,0,2,0,-2
11483,1,1,88,1319,1231
11484,0,0,2,0,-2
11485,1,1,444,1334,890
11486,1,0,8,0,-8
11487,1,0,18,0,-18
11488,0,0,24,0,-24
11489,1,1,333,1341,1008
11490,1,1,1052,1212,160
11491,0,0,84,0,-84
11492,0,0,4,0,-4
11493,1,1,237,1395,1158
11494,1,1,222,3342,3120
11495,1,1,1100,1403,303
11496,1,1,456,2386,1930
11497,1,0,15,0,-15
11498,1,1,201,2083,1882
11499,1,0,7,0,-7
11500,1,0,22,0,-22
11501,0,0,70,0,-70
11502,0,0,40,0,-40
11503,1,0,133,0,-133
11504,1,1,526,1625,1099
11505,1,1,248,1406,1158
11506,0,0,21,0,-21
11507,1,0,10,0,-10
11508,0,0,22,0,-22
11509,1,0,34,0,-34
11510,1,1,346,1290,944
11511,0,0,8,0,-8
11512,0,0,119,0,-119
11513,0,0,11,0,-11
11514,1,0,14,0,-14
11515,1,1,43,2406,2363
11516,1,0,42,0,-42
11517,1,0,3,0,-3
11518,0,0,37,0,-37
11519,1,1,1548,1274,-274
11520,1,1,85,1303,1218
11521,0,0,10,0,-10
11522,0,0,27,0,-27
11523,0,0,21,0,-21
11524,1,0,47,0,-47
11525,1,0,38,0,-38
11526,0,0,17,0,-17
11527,1,1,763,1200,437
11528,1,1,262,1254,992
11529,0,0,30,0,-30
11530,1,0,0,0,0
11531,1,1,1783,1489,-294
11532,1,0,19,0,-19
11533,0,0,115,0,-115
11534,1,0,11,0,-11
11535,0,0,6,0,-6
11536,0,0,20,0,-20
11537,0,0,31,0,-31
11538,1,0,0,0,0
11539,0,0,74,0,-74
11540,1,1,579,1934,1355
11541,0,0,48,0,-48
11542,0,0,22,0,-22
11543,0,0,20,0,-20
11544,0,0,153,0,-153
11545,0,0,29,0,-29
11546,1,1,139,1414,1275
11547,0,0,32,0,-32
11548,0,0,30,0,-30
11549,1,1,202,1453,1251
11550,0,0,52,0,-52
11551,1,0,45,0,-45
11552,0,0,41,0,-41
11553,1,1,864,1391,527
11554,1,0,4,0,-4
11555,0,0,12,0,-12
11556,0,0,7,0,-7
11557,0,0,8,0,-8
11558,0,0,41,0,-41
11559,1,0,90,0,-90
11560,1,1,21,1314,1293
11561,1,0,15,0,-15
11562,0,0,0,0,0
11563,0,0,21,0,-21
11564,1,1,3001,1253,-1748
11565,1,1,1225,2650,1425
11566,0,0,23,0,-23
11567,0,0,29,0,-29
11568,0,0,14,0,-14
11569,0,0,34,0,-34
11570,0,0,60,0,-60
11571,0,0,112,0,-112
11572,0,0,134,0,-134
11573,1,0,36,0,-36
11574,1,1,440,1212,772
11575,1,1,376,1448,1072
11576,1,1,1982,1469,-513
11577,1,1,305,1229,924
11578,0,0,28,0,-28
11579,1,1,292,1207,915
11580,1,1,233,1357,1124
11581,0,0,17,0,-17
11582,1,0,125,0,-125
11583,1,1,315,2365,2050
11584,0,0,65,0,-65
11585,0,0,17,0,-17
11586,0,0,37,0,-37
11587,0,0,35,0,-35
11588,1,1,298,1506,1208
11589,0,0,10,0,-10
11590,0,0,5,0,-5
11591,0,0,101,0,-101
11592,1,1,249,1850,1601
11593,1,1,515,1699,1184
11594,1,0,107,0,-107
11595,1,0,76,0,-76
11596,0,0,27,0,-27
11597,0,0,17,0,-17
11598,0,0,17,0,-17
11599,1,1,388,2855,2467
11600,1,0,92,0,-92
11601,1,0,13,0,-13
11602,1,1,330,1327,997
11603,0,0,41,0,-41
11604,0,0,50,0,-50
11605,1,0,108,0,-108
11606,1,1,362,1287,925
11607,1,1,2811,1847,-964
11608,0,0,93,0,-93
11609,0,0,61,0,-61
11610,0,0,85,0,-85
11611,0,0,19,0,-19
11612,1,1,678,2148,1470
11613,1,1,39,1882,1843
11614,0,0,0,0,0
11615,0,0,116,0,-116
11616,1,0,55,0,-55
11617,0,0,32,0,-32
11618,0,0,96,0,-96
11619,0,0,101,0,-101
11620,1,1,230,2251,2021
11621,0,0,56,0,-56
11622,1,1,264,1793,1529
11623,1,0,12,0,-12
11624,0,0,12,0,-12
11625,1,1,52,1412,1360
11626,1,1,71,1270,1199
11627,1,0,19,0,-19
11628,1,1,492,1226,734
11629,0,0,5,0,-5
11630,1,1,2114,1296,-818
11631,1,1,150,1623,1473
11632,0,0,35,0,-35
11633,1,1,610,1311,701
11634,1,0,67,0,-67
11635,1,0,213,0,-213
11636,1,0,32,0,-32
11637,1,0,30,0,-30
11638,1,0,40,0,-40
11639,1,1,278,1396,1118
11640,1,0,30,0,-30
11641,0,0,54,0,-54
11642,1,1,279,1395,1116
11643,0,0,4,0,-4
11644,1,0,1,0,-1
11645,1,1,75,1249,1174
11646,1,1,599,2250,1651
11647,1,0,145,0,-145
11648,0,0,40,0,-40
11649,1,1,34,1859,1825
11650,0,0,329,0,-329
11651,1,1,1363,2215,852
11652,0,0,41,0,-41
11653,1,1,498,2042,1544
11654,1,1,248,1313,1065
11655,0,0,8,0,-8
11656,0,0,10,0,-10
11657,1,1,1011,1319,308
11658,0,0,30,0,-30
11659,0,0,131,0,-131
11660,1,1,641,1791,1150
11661,0,0,36,0,-36
11662,1,1,546,1344,798
11663,1,1,13,1649,1636
11664,1,0,8,0,-8
11665,1,0,56,0,-56
11666,1,1,104,1366,1262
11667,0,0,9,0,-9
11668,1,0,122,0,-122
11669,1,0,56,0,-56
11670,1,1,1101,1210,109
11671,0,0,31,0,-31
11672,1,1,584,1334,750
11673,0,0,11,0,-11
11674,0,0,7,0,-7
11675,1,0,12,0,-12
11676,1,0,86,0,-86
11677,1,0,50,0,-50
11678,0,0,124,0,-124
11679,0,0,24,0,-24
11680,1,1,155,1266,1111
11681,1,1,68,1956,1888
11682,1,1,232,1272,1040
11683,1,1,336,1267,931
11684,0,0,32,0,-32
11685,1,0,64,0,-64
11686,0,0,25,0,-25
11687,1,0,116,0,-116
11688,1,1,569,1833,1264
11689,0,0,41,0,-41
11690,1,1,889,2197,1308
11691,1,1,396,1461,1065
11692,0,0,42,0,-42
11693,0,0,93,0,-93
11694,0,0,30,0,-30
11695,0,0,92,0,-92
11696,1,1,996,1324,328
11697,1,1,74,1326,1252
11698,1,0,40,0,-40
11699,0,0,69,0,-69
11700,0,0,33,0,-33
11701,0,0,15,0,-15
11702,0,0,67,0,-67
11703,1,1,471,2452,1981
11704,0,0,20,0,-20
11705,1,1,398,1230,832
11706,1,0,81,0,-81
11707,0,0,11,0,-11
11708,1,0,242,0,-242
11709,0,0,169,0,-169
11710,1,0,5,0,-5
11711,1,1,2512,1478,-1034
11712,1,1,300,1382,1082
11713,0,0,109,0,-109
11714,1,0,40,0,-40
11715,1,1,122,1242,1120
11716,1,1,314,2803,2489
11717,0,0,26,0,-26
11718,1,1,494,1326,832
11719,0,0,69,0,-69
11720,1,0,156,0,-156
11721,1,0,47,0,-47
11722,0,0,89,0,-89
11723,0,0,20,0,-20
11724,0,0,38,0,-38
11725,0,0,101,0,-101
11726,1,0,131,0,-131
11727,0,0,146,0,-146
11728,1,1,428,2793,2365
11729,0,0,91,0,-91
11730,1,0,0,0,0
11731,1,0,4,0,-4
11732,0,0,74,0,-74
11733,1,1,623,1247,624
11734,0,0,181,0,-181
11735,1,0,23,0,-23
11736,1,1,617,1259,642
11737,1,0,216,0,-216
11738,0,0,51,0,-51
11739,1,1,349,1515,1166
11740,0,0,10,0,-10
11741,1,1,642,1397,755
11742,1,0,54,0,-54
11743,0,0,32,0,-32
11744,1,1,341,1410,1069
11745,1,1,1462,1233,-229
11746,1,1,57,1235,1178
11747,1,1,37,1449,1412
11748,0,0,228,0,-228
11749,0,0,65,0,-65
11750,1,0,70,0,-70
11751,1,1,536,1252,716
11752,1,0,13,0,-13
11753,0,0,14,0,-14
11754,0,0,81,0,-81
11755,1,0,47,0,-47
11756,0,0,86,0,-86
11757,1,0,31,0,-31
11758,1,1,613,1462,849
11759,1,0,65,0,-65
11760,1,1,798,1249,451
11761,0,0,56,0,-56
11762,0,0,48,0,-48
11763,1,1,228,1216,988
11764,0,0,6,0,-6
11765,1,1,549,1382,833
11766,1,1,145,1814,1669
11767,1,0,93,0,-93
11768,0,0,27,0,-27
11769,0,0,112,0,-112
11770,1,0,1,0,-1
11771,1,1,95,1343,1248
11772,1,0,21,0,-21
11773,1,1,151,1278,1127
11774,1,0,38,0,-38
11775,1,1,389,1662,1273
11776,0,0,40,0,-40
11777,1,1,220,1592,1372
11778,0,0,38,0,-38
11779,0,0,43,0,-43
11780,1,0,2,0,-2
11781,1,1,1482,1232,-250
11782,0,0,59,0,-59
11783,1,0,24,0,-24
11784,1,1,624,1905,1281
11785,0,0,40,0,-40
11786,1,0,3,0,-3
11787,0,0,1,0,-1
11788,1,0,16,0,-16
11789,0,0,4,0,-4
11790,1,1,895,1207,312
11791,1,1,524,1715,1191
11792,1,0,15,0,-15
11793,0,0,20,0,-20
11794,0,0,65,0,-65
11795,0,0,29,0,-29
11796,1,1,509,1992,1483
11797,1,1,918,1513,595
11798,1,0,48,0,-48
11799,1,1,284,1920,1636
11800,0,0,97,0,-97
11801,1,0,0,0,0
11802,1,0,46,0,-46
11803,1,1,326,1423,1097
11804,1,0,155,0,-155
11805,1,1,332,1475,1143
11806,1,1,44,2048,2004
11807,1,0,21,0,-21
11808,1,0,7,0,-7
11809,1,0,17,0,-17
11810,1,1,759,1515,756
11811,0,0,50,0,-50
11812,1,1,395,1223,828
11813,1,1,252,1409,1157
11814,0,0,154,0,-154
11815,1,0,18,0,-18
11816,0,0,30,0,-30
11817,1,0,45,0,-45
11818,0,0,0,0,0
11819,1,1,361,1262,901
11820,1,0,157,0,-157
11821,0,0,59,0,-59
11822,0,0,102,0,-102
11823,0,0,160,0,-160
11824,0,0,111,0,-111
11825,0,0,108,0,-108
11826,1,0,37,0,-37
11827,1,0,81,0,-81
11828,1,1,306,1255,949
11829,0,0,9,0,-9
11830,1,1,171,1337,1166
11831,0,0,23,0,-23
11832,1,0,12,0,-12
11833,0,0,77,0,-77
11834,0,0,20,0,-20
11835,1,1,265,1525,1260
11836,0,0,37,0,-37
11837,0,0,188,0,-188
11838,1,0,154,0,-154
11839,1,0,81,0,-81
11840,1,1,1097,3031,1934
11841,0,0,22,0,-22
11842,1,0,2,0,-2
11843,1,1,110,1457,1347
11844,0,0,58,0,-58
11845,1,1,74,1708,1634
11846,1,1,196,1509,1313
11847,0,0,90,0,-90
11848,1,1,475,1664,1189
11849,1,0,102,0,-102
11850,1,1,187,1243,1056
11851,1,1,31,1336,1305
11852,1,1,1159,1622,463
11853,0,0,135,0,-135
11854,1,1,369,1782,1413
11855,0,0,20,0,-20
11856,0,0,16,0,-16
11857,1,0,28,0,-28
11858,0,0,49,0,-49
11859,1,0,29,0,-29
11860,1,1,24,2095,2071
11861,0,0,6,0,-6
11862,1,1,940,1256,316
11863,1,1,538,1558,1020
11864,0,0,12,0,-12
11865,1,0,83,0,-83
11866,1,1,188,1940,1752
11867,0,0,85,0,-85
11868,1,1,212,2538,2326
11869,1,1,509,1954,1445
11870,1,0,8,0,-8
11871,1,0,265,0,-265
11872,1,0,71,0,-71
11873,1,1,1257,2648,1391
11874,0,0,3,0,-3
11875,1,1,2058,1377,-681
11876,0,0,22,0,-22
11877,0,0,37,0,-37
11878,0,0,31,0,-31
11879,1,0,33,0,-33
11880,1,0,54,0,-54
11881,0,0,113,0,-113
11882,1,1,379,1595,1216
11883,1,0,15,0,-15
11884,0,0,42,0,-42
11885,0,0,36,0,-36
11886,1,0,47,0,-47
11887,0,0,73,0,-73
11888,0,0,23,0,-23
11889,1,1,246,2342,2096
11890,0,0,55,0,-55
11891,1,0,4,0,-4
11892,1,1,554,1322,768
11893,0,0,38,0,-38
11894,0,0,84,0,-84
11895,1,0,142,0,-142
11896,1,1,193,1470,1277
11897,0,0,19,0,-19
11898,1,1,1024,1449,425
11899,0,0,65,0,-65
11900,1,1,263,1386,1123
11901,1,0,25,0,-25
11902,1,0,19,0,-19
11903,1,1,65,1839,1774
11904,1,1,1014,1583,569
11905,0,0,13,0,-13
11906,1,0,8,0,-8
11907,0,0,73,0,-73
11908,1,0,4,0,-4
11909,0,0,12,0,-12
11910,1,0,88,0,-88
11911,1,0,85,0,-85
11912,0,0,79,0,-79
11913,1,0,76,0,-76
11914,0,0,34,0,-34
11915,1,0,73,0,-73
11916,0,0,3,0,-3
11917,0,0,84,0,-84
11918,0,0,135,0,-135
11919,1,0,53,0,-53
11920,0,0,224,0,-224
11921,0,0,38,0,-38
11922,1,0,57,0,-57
11923,1,0,131,0,-131
11924,1,1,501,1254,753
11925,0,0,7,0,-7
11926,1,0,13,0,-13
11927,0,0,46,0,-46
11928,0,0,104,0,-104
11929,1,1,682,1669,987
11930,1,1,1224,1318,94
11931,1,0,18,0,-18
11932,1,1,853,2177,1324
11933,1,1,955,3785,2830
11934,1,0,52,0,-52
11935,1,1,500,1273,773
11936,1,1,160,1678,1518
11937,1,0,9,0,-9
11938,0,0,35,0,-35
11939,1,0,17,0,-17
11940,1,0,66,0,-66
11941,1,0,129,0,-129
11942,1,0,49,0,-49
11943,1,1,39,1442,1403
11944,1,0,168,0,-168
11945,1,0,35,0,-35
11946,0,0,139,0,-139
11947,1,0,20,0,-20
11948,0,0,84,0,-84
11949,1,1,556,1276,720
11950,1,1,241,1407,1166
11951,0,0,37,0,-37
11952,1,0,42,0,-42
11953,0,0,4,0,-4
11954,1,1,689,1254,565
11955,0,0,6,0,-6
11956,1,1,323,1220,897
11957,1,0,37,0,-37
11958,1,1,221,1230,1009
11959,0,0,14,0,-14
11960,0,0,9,0,-9
11961,0,0,19,0,-19
11962,0,0,67,0,-67
11963,1,1,69,1300,1231
11964,1,1,340,1219,879
11965,1,0,78,0,-78
11966,1,0,43,0,-43
11967,1,0,67,0,-67
11968,0,0,5,0,-5
11969,0,0,123,0,-123
11970,1,1,113,1594,1481
11971,0,0,22,0,-22
11972,1,1,65,1903,1838
11973,1,1,290,1221,931
11974,1,1,234,1402,1168
11975,1,0,86,0,-86
11976,1,1,893,2145,1252
11977,1,1,434,2066,1632
11978,1,0,70,0,-70
11979,1,1,347,1228,881
11980,1,1,382,1240,858
11981,1,0,12,0,-12
11982,0,0,55,0,-55
11983,1,1,2276,1437,-839
11984,1,1,319,1403,1084
11985,1,0,11,0,-11
11986,1,1,931,1392,461
11987,1,1,515,2019,1504
11988,0,0,1,0,-1
11989,1,1,46,1508,1462
11990,1,0,81,0,-81
11991,1,1,532,1494,962
11992,1,1,190,2120,1930
11993,1,1,350,1365,1015
11994,0,0,27,0,-27
11995,1,0,47,0,-47
11996,1,1,946,1454,508
11997,1,0,51,0,-51
11998,0,0,69,0,-69
11999,0,0,26,0,-26
12000,1,0,10,0,-10
12001,1,0,36,0,-36
12002,1,1,216,1362,1146
12003,0,0,109,0,-109
12004,1,1,31,1303,1272
12005,1,0,26,0,-26
12006,1,0,85,0,-85
12007,1,0,28,0,-28
12008,0,0,106,0,-106
12009,1,1,2461,1288,-1173
12010,1,1,438,2004,1566
12011,1,1,346,1214,868
12012,1,0,33,0,-33
12013,1,0,36,0,-36
12014,1,1,38,1394,1356
12015,0,0,1,0,-1
12016,1,1,396,1401,1005
12017,1,1,514,1271,757
12018,1,0,61,0,-61
12019,1,1,36,1970,1934
12020,0,0,6,0,-6
12021,0,0,122,0,-122
12022,1,0,27,0,-27
12023,0,0,15,0,-15
12024,1,1,1921,1426,-495
12025,0,0,96,0,-96
12026,0,0,14,0,-14
12027,1,1,356,1836,1480
12028,0,0,14,0,-14
12029,0,0,49,0,-49
12030,1,1,797,1863,1066
12031,1,0,3,0,-3
12032,1,1,173,1982,1809
12033,1,1,721,1216,495
12034,1,1,473,1421,948
12035,1,1,519,1565,1046
12036,1,0,56,0,-56
12037,1,1,22,1493,1471
12038,0,0,34,0,-34
12039,0,0,105,0,-105
12040,0,0,50,0,-50
12041,1,1,613,1620,1007
12042,1,0,45,0,-45
12043,1,0,2,0,-2
12044,1,1,50,1335,1285
12045,0,0,7,0,-7
12046,1,1,143,1659,1516
12047,1,0,103,0,-103
12048,1,1,153,1317,1164
12049,1,1,357,1347,990
12050,1,1,355,1214,859
12051,0,0,77,0,-77
12052,1,1,908,1277,369
12053,1,0,43,0,-43
12054,1,1,403,1504,1101
12055,0,0,0,0,0
12056,0,0,33,0,-33
12057,0,0,22,0,-22
12058,0,0,1,0,-1
12059,0,0,49,0,-49
12060,0,0,12,0,-12
12061,0,0,33,0,-33
12062,1,1,1353,1234,-119
12063,1,1,822,1277,455
12064,1,1,387,1260,873
12065,1,0,46,0,-46
12066,0,0,4,0,-4
12067,0,0,26,0,-26
12068,1,1,646,1364,718
12069,1,1,110,1208,1098
12070,1,1,101,1329,1228
12071,1,1,714,1222,508
12072,1,1,1074,1306,232
12073,1,1,187,1218,1031
12074,1,1,81,1931,1850
12075,1,1,672,2741,2069
12076,1,1,19,1677,1658
12077,1,0,99,0,-99
12078,0,0,31,0,-31
12079,1,0,58,0,-58
12080,0,0,3,0,-3
12081,1,1,689,1340,651
12082,0,0,10,0,-10
12083,1,1,153,1436,1283
12084,1,1,592,3165,2573
12085,1,1,311,2075,1764
12086,1,1,719,1826,1107
12087,0,0,118,0,-118
12088,0,0,3,0,-3
12089,1,0,90,0,-90
12090,0,0,3,0,-3
12091,0,0,1,0,-1
12092,0,0,31,0,-31
12093,1,0,7,0,-7
12094,1,1,357,1596,1239
12095,1,1,944,1304,360
12096,1,0,78,0,-78
12097,1,1,232,1331,1099
12098,0,0,12,0,-12
12099,1,1,137,1229,1092
12100,1,0,219,0,-219
12101,0,0,26,0,-26
12102,1,1,924,1935,1011
12103,1,1,321,1370,1049
12104,1,1,28,2558,2530
12105,0,0,23,0,-23
12106,0,0,50,0,-50
12107,1,1,117,2062,1945
12108,0,0,125,0,-125
12109,1,1,157,1319,1162
12110,1,1,507,1221,714
12111,0,0,23,0,-23
12112,0,0,152,0,-152
12113,1,1,1116,1595,479
12114,0,0,17,0,-17
12115,1,0,108,0,-108
12116,0,0,14,0,-14
12117,1,0,7,0,-7
12118,1,0,35,0,-35
12119,1,1,476,1657,1181
12120,1,0,15,0,-15
12121,1,1,805,1433,628
12122,0,0,6,0,-6
12123,1,0,87,0,-87
12124,0,0,8,0,-8
12125,1,0,14,0,-14
12126,1,0,98,0,-98
12127,1,1,291,1734,1443
12128,1,0,57,0,-57
12129,1,1,557,1299,742
12130,1,0,51,0,-51
12131,1,1,150,1235,1085
12132,1,0,1,0,-1
12133,1,0,7,0,-7
12134,0,0,45,0,-45
12135,1,1,1011,1806,795
12136,1,0,41,0,-41
12137,0,0,11,0,-11
12138,0,0,32,0,-32
12139,0,0,3,0,-3
12140,0,0,3,0,-3
12141,0,0,7,0,-7
12142,1,1,1088,2621,1533
12143,0,0,12,0,-12
12144,1,1,53,1677,1624
12145,1,1,336,1503,1167
12146,1,0,15,0,-15
12147,0,0,0,0,0
12148,0,0,64,0,-64
12149,1,1,464,1730,1266
12150,1,0,6,0,-6
12151,0,0,30,0,-30
12152,1,1,99,1527,1428
12153,0,0,39,0,-39
12154,0,0,131,0,-131
12155,1,0,5,0,-5
12156,1,1,498,1220,722
12157,1,1,658,1793,1135
12158,1,1,968,1248,280
12159,0,0,27,0,-27
12160,1,0,9,0,-9
12161,1,0,64,0,-64
12162,1,1,201,2431,2230
12163,1,1,226,2032,1806
12164,0,0,55,0,-55
12165,0,0,52,0,-52
12166,0,0,16,0,-16
12167,1,0,28,0,-28
12168,0,0,63,0,-63
12169,1,1,479,1344,865
12170,0,0,13,0,-13
12171,0,0,64,0,-64
12172,0,0,16,0,-16
12173,0,0,84,0,-84
12174,1,0,20,0,-20
12175,0,0,71,0,-71
12176,1,0,149,0,-149
12177,1,1,374,1249,875
12178,1,1,424,1454,1030
12179,0,0,13,0,-13
12180,1,0,44,0,-44
12181,0,0,104,0,-104
12182,1,1,87,1214,1127
12183,1,1,142,1304,1162
12184,0,0,43,0,-43
12185,1,1,110,1213,1103
12186,0,0,6,0,-6
12187,1,1,392,1284,892
12188,1,0,11,0,-11
12189,1,1,911,1272,361
12190,1,1,531,2733,2202
12191,1,0,0,0,0
12192,1,0,52,0,-52
12193,0,0,161,0,-161
12194,1,1,1085,1298,213
12195,1,0,13,0,-13
12196,0,0,16,0,-16
12197,0,0,133,0,-133
12198,0,0,5,0,-5
12199,1,0,47,0,-47
12200,1,1,631,1266,635
12201,0,0,8,0,-8
12202,1,1,32,1499,1467
12203,0,0,10,0,-10
12204,1,1,298,1415,1117
12205,0,0,15,0,-15
12206,0,0,49,0,-49
12207,0,0,19,0,-19
12208,1,0,139,0,-139
12209,1,1,129,1206,1077
12210,1,1,1407,1494,87
12211,0,0,31,0,-31
12212,0,0,24,0,-24
12213,1,1,178,1270,1092
12214,0,0,17,0,-17
12215,1,0,4,0,-4
12216,1,1,589,1571,982
12217,1,0,35,0,-35
12218,1,0,26,0,-26
12219,1,0,94,0,-94
12220,0,0,21,0,-21
12221,1,1,363,1632,1269
12222,1,1,391,1411,1020
12223,1,0,44,0,-44
12224,1,0,28,0,-28
12225,1,1,178,1328,1150
12226,1,1,418,1213,795
12227,0,0,60,0,-60
12228,0,0,18,0,-18
12229,1,1,314,1264,950
12230,0,0,13,0,-13
12231,0,0,11,0,-11
12232,0,0,76,0,-76
12233,1,0,54,0,-54
12234,1,1,244,1216,972
12235,0,0,23,0,-23
12236,0,0,40,0,-40
12237,1,1,221,1608,1387
12238,0,0,0,0,0
12239,1,1,281,1311,1030
12240,0,0,48,0,-48
12241,0,0,26,0,-26
12242,1,1,1013,1392,379
12243,1,1,1201,1347,146
12244,1,1,163,1505,1342
12245,0,0,46,0,-46
12246,1,1,227,1721,1494
12247,0,0,2,0,-2
12248,0,0,13,0,-13
12249,1,0,55,0,-55
12250,1,0,3,0,-3
12251,1,1,306,1260,954
12252,1,1,402,1917,1515
12253,1,0,30,0,-30
12254,0,0,58,0,-58
12255,1,0,100,0,-100
12256,1,1,316,1264,948
12257,1,0,17,0,-17
12258,1,0,56,0,-56
12259,0,0,85,0,-85
12260,0,0,74,0,-74
12261,0,0,34,0,-34
12262,0,0,72,0,-72
12263,0,0,4,0,-4
12264,1,0,36,0,-36
12265,0,0,72,0,-72
12266,0,0,52,0,-52
12267,1,1,492,1776,1284
12268,0,0,78,0,-78
12269,0,0,8,0,-8
12270,0,0,30,0,-30
12271,1,1,483,1594,1111
12272,0,0,15,0,-15
12273,1,1,237,1308,1071
12274,0,0,48,0,-48
12275,0,0,39,0,-39
12276,1,1,336,1318,982
12277,1,1,288,1205,917
12278,1,0,264,0,-264
12279,1,0,16,0,-16
12280,0,0,33,0,-33
12281,1,1,554,1297,743
12282,1,0,148,0,-148
12283,0,0,104,0,-104
12284,0,0,34,0,-34
12285,1,0,20,0,-20
12286,1,0,144,0,-144
12287,0,0,30,0,-30
12288,0,0,29,0,-29
12289,0,0,21,0,-21
12290,1,0,57,0,-57
12291,0,0,26,0,-26
12292,1,0,55,0,-55
12293,1,1,923,1381,458
12294,0,0,95,0,-95
12295,1,1,642,1308,666
12296,0,0,68,0,-68
12297,1,1,993,1273,280
12298,1,0,25,0,-25
12299,0,0,5,0,-5
12300,1,0,57,0,-57
12301,1,0,19,0,-19
12302,0,0,1,0,-1
12303,1,1,1080,1207,127
12304,0,0,39,0,-39
12305,0,0,3,0,-3
12306,0,0,8,0,-8
12307,1,1,30,1779,1749
12308,1,1,1014,1275,261
12309,0,0,69,0,-69
12310,0,0,36,0,-36
12311,0,0,25,0,-25
12312,1,0,125,0,-125
12313,0,0,4,0,-4
12314,0,0,12,0,-12
12315,1,0,3,0,-3
12316,1,0,12,0,-12
12317,1,1,1501,1362,-139
12318,0,0,79,0,-79
12319,0,0,23,0,-23
12320,1,1,820,1807,987
12321,1,0,9,0,-9
12322,0,0,48,0,-48
12323,1,0,85,0,-85
12324,1,1,410,2778,2368
12325,0,0,1,0,-1
12326,1,0,9,0,-9
12327,1,1,191,1448,1257
12328,0,0,3,0,-3
12329,0,0,14,0,-14
12330,1,1,1212,1214,2
12331,0,0,95,0,-95
12332,1,1,1140,1418,278
12333,1,1,350,2797,2447
12334,1,1,862,1283,421
12335,1,0,14,0,-14
12336,0,0,2,0,-2
12337,0,0,13,0,-13
12338,0,0,44,0,-44
12339,1,1,1137,1546,409
12340,1,1,100,1256,1156
12341,1,0,21,0,-21
12342,1,0,55,0,-55
12343,0,0,8,0,-8
12344,1,1,807,1257,450
12345,0,0,15,0,-15
12346,1,0,11,0,-11
12347,0,0,108,0,-108
12348,0,0,1,0,-1
12349,0,0,23,0,-23
12350,0,0,95,0,-95
12351,0,0,19,0,-19
12352,0,0,115,0,-115
12353,1,1,2047,1201,-846
12354,0,0,3,0,-3
12355,0,0,63,0,-63
12356,1,1,713,1486,773
12357,1,1,525,1500,975
12358,0,0,43,0,-43
12359,1,1,267,1776,1509
12360,1,1,820,1431,611
12361,1,1,745,2139,1394
12362,1,0,11,0,-11
12363,0,0,7,0,-7
12364,0,0,123,0,-123
12365,1,0,18,0,-18
12366,1,1,380,4235,3855
12367,1,1,439,2221,1782
12368,1,1,135,2033,1898
12369,1,0,6,0,-6
12370,1,1,1263,2209,946
12371,0,0,9,0,-9
12372,1,0,55,0,-55
12373,1,0,22,0,-22
12374,1,1,235,1213,978
12375,1,0,13,0,-13
12376,0,0,31,0,-31
12377,1,1,151,1244,1093
12378,1,0,7,0,-7
12379,1,1,447,1889,1442
12380,1,0,44,0,-44
12381,1,0,27,0,-27
12382,1,1,29,1241,1212
12383,0,0,103,0,-103
12384,1,1,1133,1866,733
12385,0,0,32,0,-32
12386,0,0,39,0,-39
12387,0,0,18,0,-18
12388,0,0,26,0,-26
12389,1,0,12,0,-12
12390,1,1,324,3579,3255
12391,1,1,283,1723,1440
12392,0,0,2,0,-2
12393,0,0,25,0,-25
12394,1,1,465,1205,740
12395,1,0,106,0,-106
12396,1,0,5,0,-5
12397,1,1,257,1724,1467
12398,0,0,20,0,-20
12399,0,0,20,0,-20
12400,1,0,72,0,-72
12401,0,0,53,0,-53
12402,1,0,54,0,-54
12403,0,0,1,0,-1
12404,1,1,366,1765,1399
12405,0,0,62,0,-62
12406,0,0,51,0,-51
12407,1,1,194,1267,1073
12408,1,1,264,1253,989
12409,1,0,6,0,-6
12410,1,1,959,1268,309
12411,0,0,51,0,-51
12412,1,0,15,0,-15
12413,1,1,119,1205,1086
12414,0,0,18,0,-18
12415,1,1,1368,1308,-60
12416,0,0,94,0,-94
12417,0,0,0,0,0
12418,1,1,965,1489,524
12419,1,1,1048,1239,191
12420,0,0,103,0,-103
12421,1,1,169,1591,1422
12422,1,1,464,1293,829
12423,0,0,9,0,-9
12424,1,1,888,1475,587
12425,1,1,535,1617,1082
12426,1,1,474,1481,1007
12427,0,0,11,0,-11
12428,0,0,93,0,-93
12429,1,1,371,1424,1053
12430,1,1,321,1881,1560
12431,0,0,74,0,-74
12432,0,0,43,0,-43
12433,0,0,91,0,-91
12434,1,1,151,1461,1310
12435,1,0,7,0,-7
12436,1,1,334,1294,960
12437,1,0,66,0,-66
12438,0,0,59,0,-59
12439,1,0,50,0,-50
12440,1,0,26,0,-26
12441,1,0,3,0,-3
12442,1,0,11,0,-11
12443,1,1,498,1243,745
12444,0,0,0,0,0
12445,1,1,64,1318,1254
12446,0,0,9,0,-9
12447,1,1,217,1267,1050
12448,1,0,86,0,-86
12449,0,0,22,0,-22
12450,0,0,194,0,-194
12451,0,0,167,0,-167
12452,0,0,21,0,-21
12453,1,0,20,0,-20
12454,0,0,4,0,-4
12455,0,0,11,0,-11
12456,1,1,171,1252,1081
12457,1,1,251,1305,1054
12458,1,0,31,0,-31
12459,0,0,27,0,-27
12460,1,1,154,3907,3753
12461,1,1,1841,1627,-214
12462,0,0,134,0,-134
12463,0,0,48,0,-48
12464,1,0,12,0,-12
12465,0,0,134,0,-134
12466,0,0,69,0,-69
12467,1,0,29,0,-29
12468,0,0,136,0,-136
12469,1,0,55,0,-55
12470,0,0,43,0,-43
12471,0,0,29,0,-29
12472,1,0,73,0,-73
12473,1,0,34,0,-34
12474,1,0,21,0,-21
12475,1,1,331,1536,1205
12476,0,0,51,0,-51
12477,0,0,99,0,-99
12478,1,0,64,0,-64
12479,0,0,32,0,-32
12480,1,1,462,2245,1783
12481,0,0,123,0,-123
12482,1,1,486,1289,803
12483,1,1,188,1638,1450
12484,1,1,407,1263,856
12485,1,0,154,0,-154
12486,1,1,524,1255,731
12487,1,1,126,1470,1344
12488,1,0,3,0,-3
12489,1,1,155,1396,1241
12490,0,0,292,0,-292
12491,0,0,59,0,-59
12492,1,1,744,1819,1075
12493,1,1,71,1402,1331
12494,1,0,31,0,-31
12495,0,0,146,0,-146
12496,0,0,21,0,-21
12497,1,1,1277,2002,725
12498,0,0,27,0,-27
12499,0,0,17,0,-17
12500,1,0,97,0,-97
12501,0,0,35,0,-35
12502,1,0,142,0,-142
12503,1,1,1344,1201,-143
12504,1,1,852,1718,866
12505,1,0,1,0,-1
12506,1,1,1367,1423,56
12507,1,0,27,0,-27
12508,1,1,1037,2325,1288
12509,0,0,5,0,-5
12510,1,0,12,0,-12
12511,0,0,123,0,-123
12512,1,0,66,0,-66
12513,0,0,145,0,-145
12514,1,1,696,1683,987
12515,0,0,61,0,-61
12516,1,1,385,1209,824
12517,1,1,1709,2753,1044
12518,1,0,24,0,-24
12519,1,0,116,0,-116
12520,1,0,39,0,-39
12521,0,0,50,0,-50
12522,0,0,73,0,-73
12523,1,0,104,0,-104
12524,1,1,175,1341,1166
12525,1,1,90,1493,1403
12526,1,0,158,0,-158
12527,0,0,9,0,-9
12528,0,0,105,0,-105
12529,0,0,32,0,-32
12530,1,0,188,0,-188
12531,1,1,163,1777,1614
12532,0,0,26,0,-26
12533,0,0,8,0,-8
12534,0,0,58,0,-58
12535,1,0,0,0,0
12536,1,1,170,1316,1146
12537,0,0,71,0,-71
12538,1,1,625,1920,1295
12539,0,0,77,0,-77
12540,0,0,1,0,-1
12541,1,1,33,1721,1688
12542,1,1,968,1605,637
12543,1,0,52,0,-52
12544,0,0,70,0,-70
12545,0,0,12,0,-12
12546,1,0,127,0,-127
12547,0,0,41,0,-41
12548,1,0,7,0,-7
12549,0,0,2,0,-2
12550,0,0,7,0,-7
12551,0,0,26,0,-26
12552,1,0,10,0,-10
12553,1,0,3,0,-3
12554,1,0,15,0,-15
12555,0,0,131,0,-131
12556,1,1,388,1405,1017
12557,1,1,58,1330,1272
12558,0,0,93,0,-93
12559,0,0,9,0,-9
12560,1,0,3,0,-3
12561,1,1,416,2312,1896
12562,0,0,11,0,-11
12563,1,1,166,1536,1370
12564,1,0,50,0,-50
12565,0,0,58,0,-58
12566,1,0,48,0,-48
12567,0,0,71,0,-71
12568,0,0,44,0,-44
12569,1,0,96,0,-96
12570,1,1,1011,3261,2250
12571,1,1,263,1256,993
12572,1,0,0,0,0
12573,0,0,10,0,-10
12574,0,0,44,0,-44
12575,1,1,588,2514,1926
12576,0,0,11,0,-11
12577,1,1,417,1364,947
12578,1,1,448,1211,763
12579,0,0,258,0,-258
12580,1,1,991,1328,337
12581,0,0,64,0,-64
12582,0,0,27,0,-27
12583,0,0,80,0,-80
12584,1,0,21,0,-21
12585,1,0,21,0,-21
12586,0,0,22,0,-22
12587,0,0,36,0,-36
12588,0,0,12,0,-12
12589,1,0,93,0,-93
12590,0,0,31,0,-31
12591,1,1,129,1219,1090
12592,0,0,74,0,-74
12593,1,0,38,0,-38
12594,0,0,37,0,-37
12595,1,1,412,1839,1427
12596,0,0,107,0,-107
12597,1,1,74,1380,1306
12598,1,0,20,0,-20
12599,1,0,10,0,-10
12600,1,0,11,0,-11
12601,1,0,36,0,-36
12602,0,0,45,0,-45
12603,1,0,11,0,-11
12604,1,0,83,0,-83
12605,1,0,2,0,-2
12606,0,0,7,0,-7
12607,0,0,57,0,-57
12608,0,0,47,0,-47
12609,0,0,59,0,-59
12610,0,0,9,0,-9
12611,1,0,11,0,-11
12612,1,1,635,2060,1425
12613,0,0,54,0,-54
12614,1,0,20,0,-20
12615,0,0,91,0,-91
12616,0,0,17,0,-17
12617,1,1,1191,1381,190
12618,1,0,64,0,-64
12619,1,0,18,0,-18
12620,1,0,80,0,-80
12621,1,0,0,0,0
12622,0,0,170,0,-170
12623,1,1,2530,1865,-665
12624,1,0,71,0,-71
12625,1,1,724,1835,1111
12626,0,0,28,0,-28
12627,0,0,107,0,-107
12628,1,0,31,0,-31
12629,1,1,430,1207,777
12630,1,0,37,0,-37
12631,1,0,92,0,-92
12632,1,0,4,0,-4
12633,1,1,660,1590,930
12634,0,0,39,0,-39
12635,0,0,22,0,-22
12636,1,1,532,1322,790
12637,0,0,33,0,-33
12638,0,0,14,0,-14
12639,0,0,1,0,-1
12640,0,0,127,0,-127
12641,1,1,301,1315,1014
12642,1,1,1753,1410,-343
12643,1,0,21,0,-21
12644,1,1,356,1658,1302
12645,1,0,2,0,-2
12646,1,0,88,0,-88
12647,0,0,90,0,-90
12648,1,1,277,2115,1838
12649,1,0,133,0,-133
12650,1,0,45,0,-45
12651,1,0,4,0,-4
12652,1,0,32,0,-32
12653,1,0,78,0,-78
12654,0,0,56,0,-56
12655,1,0,20,0,-20
12656,1,1,89,1574,1485
12657,1,1,680,1261,581
12658,0,0,32,0,-32
12659,0,0,10,0,-10
12660,0,0,10,0,-10
12661,0,0,9,0,-9
12662,0,0,15,0,-15
12663,1,1,101,1319,1218
12664,1,0,39,0,-39
12665,1,0,49,0,-49
12666,0,0,0,0,0
12667,1,0,33,0,-33
12668,1,0,6,0,-6
12669,1,0,148,0,-148
12670,0,0,18,0,-18
12671,0,0,74,0,-74
12672,0,0,61,0,-61
12673,0,0,10,0,-10
12674,0,0,22,0,-22
12675,0,0,74,0,-74
12676,0,0,34,0,-34
12677,1,0,9,0,-9
12678,0,0,38,0,-38
12679,0,0,68,0,-68
12680,0,0,1,0,-1
12681,0,0,100,0,-100
12682,0,0,2,0,-2
12683,1,0,61,0,-61
12684,1,1,478,1468,990
12685,0,0,25,0,-25
12686,1,0,15,0,-15
12687,1,1,333,1697,1364
12688,1,0,11,0,-11
12689,0,0,112,0,-112
12690,0,0,33,0,-33
12691,0,0,27,0,-27
12692,0,0,131,0,-131
12693,1,0,15,0,-15
12694,0,0,11,0,-11
12695,1,0,1,0,-1
12696,1,0,4,0,-4
12697,1,1,451,1338,887
12698,0,0,9,0,-9
12699,1,1,65,1266,1201
12700,0,0,3,0,-3
12701,0,0,119,0,-119
12702,0,0,179,0,-179
12703,1,0,23,0,-23
12704,0,0,51,0,-51
12705,0,0,33,0,-33
12706,1,0,76,0,-76
12707,0,0,15,0,-15
12708,0,0,235,0,-235
12709,0,0,6,0,-6
12710,0,0,37,0,-37
12711,1,1,69,1288,1219
12712,1,0,148,0,-148
12713,1,0,54,0,-54
12714,1,0,42,0,-42
12715,1,0,28,0,-28
12716,0,0,1,0,-1
12717,1,1,704,2025,1321
12718,1,0,22,0,-22
12719,1,0,25,0,-25
12720,0,0,36,0,-36
12721,0,0,138,0,-138
12722,1,1,557,2402,1845
12723,0,0,26,0,-26
12724,1,0,66,0,-66
12725,1,1,348,1376,1028
12726,1,0,30,0,-30
12727,0,0,65,0,-65
12728,1,0,122,0,-122
12729,1,0,17,0,-17
12730,0,0,3,0,-3
12731,0,0,6,0,-6
12732,0,0,9,0,-9
12733,1,0,42,0,-42
12734,1,1,1946,1293,-653
12735,1,0,24,0,-24
12736,1,0,59,0,-59
12737,1,1,193,1722,1529
12738,1,0,1,0,-1
12739,0,0,96,0,-96
12740,0,0,33,0,-33
12741,1,1,163,2391,2228
12742,1,1,257,1536,1279
12743,1,0,130,0,-130
12744,0,0,62,0,-62
12745,1,1,415,1208,793
12746,1,0,136,0,-136
12747,1,1,182,1345,1163
12748,1,0,22,0,-22
12749,1,0,31,0,-31
12750,0,0,74,0,-74
12751,1,0,168,0,-168
12752,0,0,19,0,-19
12753,1,0,14,0,-14
12754,1,1,539,3093,2554
12755,1,1,262,2086,1824
12756,1,0,18,0,-18
12757,0,0,21,0,-21
12758,0,0,2,0,-2
12759,1,0,179,0,-179
12760,0,0,74,0,-74
12761,1,0,79,0,-79
12762,1,0,8,0,-8
12763,1,0,4,0,-4
12764,1,1,372,2245,1873
12765,1,1,696,1503,807
12766,1,1,216,1486,1270
12767,1,1,116,3046,2930
12768,1,0,22,0,-22
12769,1,1,906,1332,426
12770,1,1,292,1224,932
12771,0,0,32,0,-32
12772,0,0,29,0,-29
12773,1,1,768,1245,477
12774,1,1,1619,1348,-271
12775,1,0,45,0,-45
12776,1,1,1244,1339,95
12777,0,0,27,0,-27
12778,0,0,1,0,-1
12779,0,0,58,0,-58
12780,1,1,506,1631,1125
12781,1,0,13,0,-13
12782,1,1,237,1921,1684
12783,0,0,36,0,-36
12784,0,0,29,0,-29
12785,0,0,17,0,-17
12786,1,0,266,0,-266
12787,1,0,0,0,0
12788,1,0,135,0,-135
12789,0,0,17,0,-17
12790,1,0,16,0,-16
12791,1,1,107,1314,1207
12792,1,1,120,1217,1097
12793,1,0,198,0,-198
12794,1,1,361,1528,1167
12795,1,0,5,0,-5
12796,0,0,5,0,-5
12797,0,0,0,0,0
12798,0,0,148,0,-148
12799,1,0,22,0,-22
12800,1,1,545,1513,968
12801,0,0,16,0,-16
12802,1,1,617,1537,920
12803,1,1,1267,1795,528
12804,0,0,8,0,-8
12805,0,0,3,0,-3
12806,0,0,70,0,-70
12807,0,0,24,0,-24
12808,0,0,16,0,-16
12809,1,0,84,0,-84
12810,0,0,91,0,-91
12811,0,0,157,0,-157
12812,0,0,6,0,-6
12813,1,0,97,0,-97
12814,0,0,74,0,-74
12815,0,0,72,0,-72
12816,1,0,18,0,-18
12817,1,0,57,0,-57
12818,0,0,53,0,-53
12819,1,1,1373,1259,-114
12820,1,1,105,1234,1129
12821,1,0,18,0,-18
12822,0,0,108,0,-108
12823,1,1,825,1357,532
12824,1,0,4,0,-4
12825,0,0,78,0,-78
12826,0,0,5,0,-5
12827,1,1,972,1568,596
12828,0,0,52,0,-52
12829,0,0,123,0,-123
12830,0,0,5,0,-5
12831,1,0,77,0,-77
12832,0,0,0,0,0
12833,1,0,82,0,-82
12834,1,1,634,1538,904
12835,1,0,19,0,-19
12836,1,0,5,0,-5
12837,0,0,42,0,-42
12838,1,0,46,0,-46
12839,1,0,10,0,-10
12840,1,1,41,1437,1396
12841,0,0,189,0,-189
12842,1,0,32,0,-32
12843,1,1,83,1561,1478
12844,1,0,12,0,-12
12845,1,1,296,1551,1255
12846,0,0,28,0,-28
12847,1,1,2028,1560,-468
12848,1,1,91,1782,1691
12849,1,0,72,0,-72
12850,1,1,214,1305,1091
12851,0,0,26,0,-26
12852,1,1,467,1375,908
12853,0,0,31,0,-31
12854,0,0,6,0,-6
12855,1,0,15,0,-15
12856,0,0,14,0,-14
12857,1,0,36,0,-36
12858,1,0,27,0,-27
12859,0,0,2,0,-2
12860,0,0,17,0,-17
12861,1,0,0,0,0
12862,1,1,485,1721,1236
12863,1,0,35,0,-35
12864,1,0,90,0,-90
12865,1,0,5,0,-5
12866,0,0,12,0,-12
12867,0,0,2,0,-2
12868,1,1,77,1411,1334
12869,1,1,1723,1437,-286
12870,0,0,52,0,-52
12871,0,0,53,0,-53
12872,0,0,46,0,-46
12873,1,0,20,0,-20
12874,0,0,29,0,-29
12875,1,1,82,1203,1121
12876,0,0,63,0,-63
12877,1,0,5,0,-5
12878,0,0,1,0,-1
12879,1,1,1474,1525,51
12880,0,0,32,0,-32
12881,1,1,423,1923,1500
12882,0,0,57,0,-57
12883,1,0,71,0,-71
12884,1,1,355,1431,1076
12885,0,0,15,0,-15
12886,1,1,420,1202,782
12887,0,0,19,0,-19
12888,1,0,47,0,-47
12889,1,1,149,2410,2261
12890,1,1,756,2155,1399
12891,1,0,70,0,-70
12892,1,0,147,0,-147
12893,1,0,1,0,-1
12894,1,1,479,3516,3037
12895,1,1,287,1301,1014
12896,1,1,1966,1249,-717
12897,1,1,324,1453,1129
12898,0,0,16,0,-16
12899,1,1,457,1425,968
12900,1,0,80,0,-80
12901,1,1,151,1382,1231
12902,1,0,36,0,-36
12903,0,0,89,0,-89
12904,1,1,964,1263,299
12905,0,0,94,0,-94
12906,1,1,1030,1276,246
12907,1,0,59,0,-59
12908,1,0,26,0,-26
12909,0,0,0,0,0
12910,0,0,98,0,-98
12911,1,1,152,1635,1483
12912,1,1,137,1904,1767
12913,1,1,154,1623,1469
12914,0,0,69,0,-69
12915,0,0,29,0,-29
12916,0,0,2,0,-2
12917,1,1,847,1722,875
12918,1,1,567,1305,738
12919,0,0,3,0,-3
12920,0,0,65,0,-65
12921,0,0,80,0,-80
12922,1,0,31,0,-31
12923,0,0,49,0,-49
12924,1,1,288,1680,1392
12925,1,1,323,1217,894
12926,1,1,1076,1243,167
12927,1,1,94,1652,1558
12928,0,0,41,0,-41
12929,1,1,724,1264,540
12930,0,0,17,0,-17
12931,1,1,147,3481,3334
12932,1,0,54,0,-54
12933,0,0,14,0,-14
12934,1,0,1,0,-1
12935,1,0,67,0,-67
12936,1,1,1645,2036,391
12937,1,1,1013,1610,597
12938,1,1,257,1208,951
12939,0,0,32,0,-32
12940,0,0,45,0,-45
12941,1,1,512,1529,1017
12942,0,0,6,0,-6
12943,0,0,132,0,-132
12944,1,0,43,0,-43
12945,0,0,21,0,-21
12946,1,1,134,6579,6445
12947,1,0,0,0,0
12948,1,0,111,0,-111
12949,1,0,9,0,-9
12950,1,1,198,1231,1033
12951,0,0,5,0,-5
12952,1,0,72,0,-72
12953,0,0,30,0,-30
12954,1,1,393,1463,1070
12955,0,0,6,0,-6
12956,0,0,18,0,-18
12957,1,0,33,0,-33
12958,0,0,15,0,-15
12959,1,0,2,0,-2
12960,1,1,152,1318,1166
12961,1,1,66,1236,1170
12962,1,0,10,0,-10
12963,0,0,7,0,-7
12964,1,1,378,1202,824
12965,0,0,12,0,-12
12966,0,0,194,0,-194
12967,0,0,25,0,-25
12968,1,1,65,1341,1276
12969,0,0,29,0,-29
12970,1,1,209,1716,1507
12971,1,1,277,2776,2499
12972,1,0,118,0,-118
12973,1,1,1159,1200,41
12974,1,0,105,0,-105
12975,1,1,150,2220,2070
12976,0,0,10,0,-10
12977,1,0,55,0,-55
12978,0,0,43,0,-43
12979,1,1,484,1444,960
12980,1,1,90,1739,1649
12981,1,1,717,3471,2754
12982,1,0,127,0,-127
12983,0,0,21,0,-21
12984,1,0,21,0,-21
12985,1,1,159,1344,1185
12986,1,0,39,0,-39
12987,1,0,57,0,-57
12988,1,1,561,2047,1486
12989,0,0,45,0,-45
12990,1,0,106,0,-106
12991,0,0,100,0,-100
12992,1,0,111,0,-111
12993,1,1,589,1343,754
12994,1,1,240,1355,1115
12995,1,0,25,0,-25
12996,1,0,33,0,-33
12997,1,0,20,0,-20
12998,0,0,2,0,-2
12999,0,0,70,0,-70
13000,0,0,69,0,-69
13001,1,1,241,4438,4197
13002,1,0,17,0,-17
13003,1,0,21,0,-21
13004,0,0,29,0,-29
13005,0,0,22,0,-22
13006,1,0,115,0,-115
13007,0,0,79,0,-79
13008,1,1,656,1743,1087
13009,0,0,9,0,-9
13010,1,1,340,1273,933
13011,0,0,7,0,-7
13012,0,0,179,0,-179
13013,1,0,135,0,-135
13014,1,1,198,1489,1291
13015,0,0,163,0,-163
13016,0,0,48,0,-48
13017,0,0,2,0,-2
13018,1,1,399,1592,1193
13019,1,0,38,0,-38
13020,1,1,88,1619,1531
13021,1,1,389,1745,1356
13022,1,1,938,1270,332
13023,1,1,110,1727,1617
13024,0,0,42,0,-42
13025,1,1,165,1370,1205
13026,1,0,49,0,-49
13027,0,0,59,0,-59
13028,1,1,34,1253,1219
13029,0,0,0,0,0
13030,1,1,284,2679,2395
13031,1,0,110,0,-110
13032,0,0,21,0,-21
13033,1,1,244,1252,1008
13034,1,1,263,2140,1877
13035,1,0,0,0,0
13036,0,0,78,0,-78
13037,1,1,831,1560,729
13038,1,0,109,0,-109
13039,1,1,1171,1389,218
13040,0,0,65,0,-65
13041,0,0,40,0,-40
13042,1,1,1140,2190,1050
13043,1,1,917,1940,1023
13044,1,1,477,1443,966
13045,1,1,423,1677,1254
13046,1,0,20,0,-20
13047,1,1,48,1267,1219
13048,0,0,68,0,-68
13049,0,0,51,0,-51
13050,0,0,22,0,-22
13051,1,0,38,0,-38
13052,0,0,2,0,-2
13053,0,0,34,0,-34
13054,0,0,18,0,-18
13055,0,0,102,0,-102
13056,1,1,1129,1255,126
13057,0,0,25,0,-25
13058,1,0,4,0,-4
13059,1,1,439,1576,1137
13060,1,1,865,1270,405
13061,1,1,484,1320,836
13062,0,0,32,0,-32
13063,1,0,26,0,-26
13064,0,0,10,0,-10
13065,0,0,61,0,-61
13066,1,0,98,0,-98
13067,1,0,30,0,-30
13068,0,0,24,0,-24
13069,0,0,25,0,-25
13070,0,0,7,0,-7
13071,0,0,9,0,-9
13072,0,0,60,0,-60
13073,1,0,45,0,-45
13074,0,0,92,0,-92
13075,1,0,51,0,-51
13076,1,0,118,0,-118
13077,1,0,100,0,-100
13078,0,0,21,0,-21
13079,1,0,110,0,-110
13080,1,0,20,0,-20
13081,1,1,1085,1244,159
13082,1,0,2,0,-2
13083,1,0,3,0,-3
13084,1,0,61,0,-61
13085,0,0,24,0,-24
13086,1,0,54,0,-54
13087,1,1,1079,1253,174
13088,1,0,16,0,-16
13089,1,0,52,0,-52
13090,1,0,23,0,-23
13091,1,1,513,1408,895
13092,1,0,69,0,-69
13093,0,0,2,0,-2
13094,0,0,7,0,-7
13095,0,0,3,0,-3
13096,1,0,36,0,-36
13097,0,0,55,0,-55
13098,1,1,225,1835,1610
13099,1,0,61,0,-61
13100,1,0,33,0,-33
13101,1,1,146,1623,1477
13102,1,1,176,1731,1555
13103,1,0,15,0,-15
13104,1,1,233,1959,1726
13105,0,0,135,0,-135
13106,1,0,28,0,-28
13107,1,1,1372,1471,99
13108,0,0,34,0,-34
13109,1,0,8,0,-8
13110,1,1,307,1206,899
13111,1,1,1162,1369,207
13112,0,0,7,0,-7
13113,0,0,13,0,-13
13114,0,0,41,0,-41
13115,1,1,1348,1940,592
13116,1,0,20,0,-20
13117,1,1,116,2008,1892
13118,1,1,588,1220,632
13119,1,1,538,1512,974
13120,0,0,34,0,-34
13121,1,0,20,0,-20
13122,0,0,18,0,-18
13123,1,1,154,1423,1269
13124,1,1,230,3040,2810
13125,1,0,2,0,-2
13126,0,0,75,0,-75
13127,0,0,48,0,-48
13128,0,0,54,0,-54
13129,0,0,17,0,-17
13130,0,0,20,0,-20
13131,1,0,75,0,-75
13132,1,0,8,0,-8
13133,0,0,56,0,-56
13134,0,0,13,0,-13
13135,0,0,171,0,-171
13136,1,0,13,0,-13
13137,0,0,36,0,-36
13138,1,0,137,0,-137
13139,1,1,905,1502,597
13140,0,0,17,0,-17
13141,0,0,45,0,-45
13142,1,0,4,0,-4
13143,0,0,72,0,-72
13144,1,1,539,1254,715
13145,1,0,202,0,-202
13146,1,0,135,0,-135
13147,0,0,82,0,-82
13148,0,0,16,0,-16
13149,1,0,13,0,-13
13150,1,1,771,1450,679
13151,1,0,44,0,-44
13152,1,1,400,1327,927
13153,0,0,6,0,-6
13154,1,1,818,1398,580
13155,1,0,16,0,-16
13156,1,0,53,0,-53
13157,1,1,291,1525,1234
13158,0,0,75,0,-75
13159,1,1,195,1231,1036
13160,1,1,280,1218,938
13161,1,0,43,0,-43
13162,1,0,59,0,-59
13163,1,1,1147,1512,365
13164,0,0,22,0,-22
13165,1,0,117,0,-117
13166,1,1,11,1246,1235
13167,0,0,86,0,-86
13168,1,0,3,0,-3
13169,0,0,5,0,-5
13170,0,0,39,0,-39
13171,1,1,108,1588,1480
13172,0,0,70,0,-70
13173,1,0,7,0,-7
13174,1,0,10,0,-10
13175,0,0,127,0,-127
13176,1,0,28,0,-28
13177,0,0,93,0,-93
13178,0,0,40,0,-40
13179,1,1,278,2132,1854
13180,1,0,123,0,-123
13181,0,0,28,0,-28
13182,1,0,46,0,-46
13183,1,1,254,1457,1203
13184,1,0,2,0,-2
13185,0,0,58,0,-58
13186,0,0,38,0,-38
13187,0,0,149,0,-149
13188,1,1,157,1222,1065
13189,1,0,37,0,-37
13190,1,1,333,1210,877
13191,0,0,17,0,-17
13192,0,0,11,0,-11
13193,0,0,12,0,-12
13194,1,1,579,1211,632
13195,1,1,335,1352,1017
13196,1,0,34,0,-34
13197,1,1,352,1475,1123
13198,1,1,65,1211,1146
13199,1,1,207,1445,1238
13200,1,1,194,1458,1264
13201,1,1,395,4922,4527
13202,0,0,13,0,-13
13203,1,1,667,1348,681
13204,0,0,2,0,-2
13205,0,0,15,0,-15
13206,1,1,495,1439,944
13207,1,1,93,1377,1284
13208,1,0,11,0,-11
13209,1,1,307,1434,1127
13210,0,0,41,0,-41
13211,1,0,143,0,-143
13212,1,0,41,0,-41
13213,1,1,484,1515,1031
13214,0,0,1,0,-1
13215,1,0,13,0,-13
13216,1,1,268,2083,1815
13217,1,1,1631,1519,-112
13218,1,1,649,1490,841
13219,0,0,125,0,-125
13220,1,1,441,1513,1072
13221,0,0,12,0,-12
13222,0,0,140,0,-140
13223,1,0,39,0,-39
13224,1,1,370,1305,935
13225,1,0,39,0,-39
13226,1,0,51,0,-51
13227,0,0,22,0,-22
13228,1,1,606,1565,959
13229,1,0,111,0,-111
13230,1,1,223,1673,1450
13231,1,0,32,0,-32
13232,0,0,15,0,-15
13233,1,1,141,1486,1345
13234,1,1,507,1744,1237
13235,0,0,75,0,-75
13236,0,0,19,0,-19
13237,1,1,325,1469,1144
13238,0,0,57,0,-57
13239,0,0,17,0,-17
13240,1,1,761,2210,1449
13241,1,1,181,1935,1754
13242,0,0,95,0,-95
13243,1,1,314,1262,948
13244,1,1,175,1830,1655
13245,1,1,567,1707,1140
13246,1,1,626,1353,727
13247,1,0,13,0,-13
13248,1,1,276,1783,1507
13249,1,0,47,0,-47
13250,0,0,37,0,-37
13251,0,0,75,0,-75
13252,0,0,7,0,-7
13253,0,0,150,0,-150
13254,1,1,512,2026,1514
13255,1,0,2,0,-2
13256,1,1,594,1915,1321
13257,1,0,26,0,-26
13258,1,1,1008,1305,297
13259,1,0,15,0,-15
13260,0,0,66,0,-66
13261,1,1,662,2104,1442
13262,0,0,42,0,-42
13263,1,0,0,0,0
13264,1,0,294,0,-294
13265,0,0,67,0,-67
13266,1,0,0,0,0
13267,1,1,159,1990,1831
13268,0,0,123,0,-123
13269,1,0,87,0,-87
13270,0,0,90,0,-90
13271,1,0,48,0,-48
13272,1,0,47,0,-47
13273,1,1,364,1670,1306
13274,1,0,12,0,-12
13275,1,1,151,2692,2541
13276,1,0,136,0,-136
13277,1,1,805,1346,541
13278,1,1,724,1323,599
13279,0,0,1,0,-1
13280,1,0,101,0,-101
13281,0,0,44,0,-44
13282,0,0,24,0,-24
13283,0,0,13,0,-13
13284,1,0,17,0,-17
13285,1,1,150,1379,1229
13286,0,0,55,0,-55
13287,0,0,26,0,-26
13288,0,0,96,0,-96
13289,0,0,34,0,-34
13290,1,1,268,1609,1341
13291,0,0,118,0,-118
13292,1,1,558,1460,902
13293,0,0,32,0,-32
13294,0,0,14,0,-14
13295,1,1,225,1421,1196
13296,1,0,19,0,-19
13297,1,1,1893,1681,-212
13298,0,0,21,0,-21
13299,0,0,103,0,-103
13300,1,0,20,0,-20
13301,0,0,202,0,-202
13302,1,1,2582,1212,-1370
13303,0,0,1,0,-1
13304,0,0,23,0,-23
13305,1,1,1413,1302,-111
13306,1,1,393,2116,1723
13307,1,0,17,0,-17
13308,1,0,14,0,-14
13309,1,0,9,0,-9
13310,0,0,75,0,-75
13311,0,0,81,0,-81
13312,1,0,89,0,-89
13313,0,0,19,0,-19
13314,0,0,21,0,-21
13315,0,0,54,0,-54
13316,1,1,511,2412,1901
13317,1,1,133,1777,1644
13318,0,0,49,0,-49
13319,0,0,92,0,-92
13320,1,1,548,1224,676
13321,0,0,40,0,-40
13322,0,0,106,0,-106
13323,1,1,674,1226,552
13324,0,0,108,0,-108
13325,1,1,1138,1256,118
13326,1,0,4,0,-4
13327,1,0,90,0,-90
13328,1,0,103,0,-103
13329,0,0,102,0,-102
13330,1,1,521,1559,1038
13331,0,0,138,0,-138
13332,1,0,91,0,-91
13333,1,1,614,1365,751
13334,1,0,66,0,-66
13335,0,0,15,0,-15
13336,0,0,175,0,-175
13337,1,0,11,0,-11
13338,1,1,21,1615,1594
13339,1,1,433,1335,902
13340,1,0,23,0,-23
13341,1,0,38,0,-38
13342,1,1,590,1822,1232
13343,1,0,174,0,-174
13344,1,0,75,0,-75
13345,0,0,17,0,-17
13346,1,0,47,0,-47
13347,1,0,22,0,-22
13348,1,1,206,1475,1269
13349,1,1,824,1326,502
13350,1,0,81,0,-81
13351,1,0,1,0,-1
13352,0,0,40,0,-40
13353,0,0,67,0,-67
13354,1,0,34,0,-34
13355,1,1,134,1451,1317
13356,0,0,11,0,-11
13357,1,0,10,0,-10
13358,0,0,130,0,-130
13359,0,0,116,0,-116
13360,0,0,25,0,-25
13361,0,0,10,0,-10
13362,1,0,34,0,-34
13363,0,0,13,0,-13
13364,1,0,130,0,-130
13365,1,1,1105,1282,177
13366,1,0,40,0,-40
13367,0,0,100,0,-100
13368,1,0,118,0,-118
13369,1,1,514,2387,1873
13370,1,1,623,1204,581
13371,0,0,17,0,-17
13372,1,0,161,0,-161
13373,0,0,87,0,-87
13374,1,0,2,0,-2
13375,1,0,0,0,0
13376,0,0,25,0,-25
13377,1,0,35,0,-35
13378,0,0,26,0,-26
13379,1,1,292,1415,1123
13380,1,1,73,1222,1149
13381,1,0,50,0,-50
13382,1,0,6,0,-6
13383,0,0,39,0,-39
13384,0,0,3,0,-3
13385,1,0,66,0,-66
13386,0,0,12,0,-12
13387,1,0,32,0,-32
13388,0,0,0,0,0
13389,1,0,10,0,-10
13390,1,1,89,1436,1347
13391,0,0,13,0,-13
13392,0,0,36,0,-36
13393,0,0,8,0,-8
13394,0,0,7,0,-7
13395,0,0,42,0,-42
13396,0,0,8,0,-8
13397,0,0,22,0,-22
13398,0,0,61,0,-61
13399,0,0,139,0,-139
13400,1,0,46,0,-46
13401,1,1,110,1663,1553
13402,0,0,213,0,-213
13403,1,1,420,1716,1296
13404,0,0,170,0,-170
13405,1,0,116,0,-116
13406,0,0,206,0,-206
13407,0,0,0,0,0
13408,1,0,81,0,-81
13409,1,0,68,0,-68
13410,0,0,5,0,-5
13411,1,1,65,1671,1606
13412,0,0,62,0,-62
13413,1,0,131,0,-131
13414,1,1,43,1328,1285
13415,1,0,52,0,-52
13416,1,1,461,1579,1118
13417,1,0,2,0,-2
13418,1,0,26,0,-26
13419,0,0,54,0,-54
13420,0,0,37,0,-37
13421,1,0,51,0,-51
13422,1,1,1,1386,1385
13423,1,1,323,1306,983
13424,1,1,22,1204,1182
13425,1,1,1101,1235,134
13426,1,1,397,1225,828
13427,1,1,122,1366,1244
13428,1,0,95,0,-95
13429,0,0,91,0,-91
13430,1,1,207,1353,1146
13431,1,1,699,1240,541
13432,1,1,53,1533,1480
13433,0,0,203,0,-203
13434,1,1,68,2205,2137
13435,1,0,13,0,-13
13436,1,0,0,0,0
13437,1,1,556,1317,761
13438,1,1,823,1358,535
13439,1,0,53,0,-53
13440,1,0,2,0,-2
13441,1,1,50,1348,1298
13442,1,0,30,0,-30
13443,1,1,94,1694,1600
13444,0,0,67,0,-67
13445,0,0,40,0,-40
13446,1,0,116,0,-116
13447,1,1,1647,1264,-383
13448,1,0,32,0,-32
13449,1,1,717,1672,955
13450,1,1,247,1338,1091
13451,0,0,188,0,-188
13452,1,1,640,1584,944
13453,1,0,14,0,-14
13454,0,0,2,0,-2
13455,1,1,698,1537,839
13456,1,1,208,1742,1534
13457,0,0,5,0,-5
13458,1,0,54,0,-54
13459,0,0,162,0,-162
13460,1,1,95,2215,2120
13461,0,0,52,0,-52
13462,1,1,838,1257,419
13463,1,0,31,0,-31
13464,1,0,52,0,-52
13465,1,0,36,0,-36
13466,1,1,990,1490,500
13467,1,1,379,2532,2153
13468,0,0,25,0,-25
13469,0,0,12,0,-12
13470,0,0,203,0,-203
13471,1,0,17,0,-17
13472,0,0,28,0,-28
13473,1,0,49,0,-49
13474,0,0,30,0,-30
13475,0,0,185,0,-185
13476,0,0,6,0,-6
13477,1,0,16,0,-16
13478,0,0,44,0,-44
13479,1,1,44,1266,1222
13480,1,0,50,0,-50
13481,1,1,81,1882,1801
13482,0,0,12,0,-12
13483,1,0,4,0,-4
13484,1,0,21,0,-21
13485,0,0,31,0,-31
13486,1,0,7,0,-7
13487,0,0,50,0,-50
13488,0,0,94,0,-94
13489,0,0,0,0,0
13490,0,0,43,0,-43
13491,1,1,329,1670,1341
13492,0,0,26,0,-26
13493,0,0,0,0,0
13494,1,1,121,1294,1173
13495,0,0,119,0,-119
13496,1,1,256,1490,1234
13497,1,0,9,0,-9
13498,1,0,117,0,-117
13499,1,0,0,0,0
13500,1,1,415,1478,1063
13501,0,0,1,0,-1
13502,1,1,1248,1317,69
13503,0,0,0,0,0
13504,1,1,515,1466,951
13505,1,1,390,2034,1644
13506,0,0,61,0,-61
13507,1,0,46,0,-46
13508,0,0,31,0,-31
13509,1,1,441,1856,1415
13510,0,0,126,0,-126
13511,0,0,31,0,-31
13512,1,1,559,2449,1890
13513,0,0,98,0,-98
13514,0,0,32,0,-32
13515,1,1,241,1315,1074
13516,1,0,91,0,-91
13517,0,0,70,0,-70
13518,1,0,12,0,-12
13519,1,1,227,1319,1092
13520,1,1,751,1507,756
13521,1,0,49,0,-49
13522,1,0,103,0,-103
13523,0,0,12,0,-12
13524,0,0,23,0,-23
13525,1,1,289,1404,1115
13526,1,1,17,1761,1744
13527,1,1,699,1530,831
13528,0,0,88,0,-88
13529,0,0,77,0,-77
13530,1,1,163,1522,1359
13531,1,0,177,0,-177
13532,0,0,85,0,-85
13533,1,0,21,0,-21
13534,1,1,321,1582,1261
13535,1,0,10,0,-10
13536,1,0,30,0,-30
13537,1,0,14,0,-14
13538,1,1,1900,1583,-317
13539,0,0,71,0,-71
13540,1,0,89,0,-89
13541,1,0,38,0,-38
13542,0,0,2,0,-2
13543,0,0,11,0,-11
13544,1,1,1002,1636,634
13545,0,0,27,0,-27
13546,1,0,79,0,-79
13547,0,0,16,0,-16
13548,0,0,63,0,-63
13549,1,1,709,1311,602
13550,1,0,7,0,-7
13551,1,0,27,0,-27
13552,1,0,14,0,-14
13553,1,1,883,1213,330
13554,0,0,33,0,-33
13555,0,0,130,0,-130
13556,0,0,94,0,-94
13557,1,1,958,1235,277
13558,1,1,556,1338,782
13559,0,0,34,0,-34
13560,1,0,12,0,-12
13561,1,0,2,0,-2
13562,1,1,486,1292,806
13563,1,1,1261,1354,93
13564,0,0,73,0,-73
13565,1,1,631,1655,1024
13566,1,1,149,1323,1174
13567,1,0,48,0,-48
13568,1,1,1383,1240,-143
13569,0,0,16,0,-16
13570,1,1,15,1371,1356
13571,0,0,1,0,-1
13572,1,1,226,1227,1001
13573,1,0,21,0,-21
13574,0,0,27,0,-27
13575,0,0,173,0,-173
13576,1,1,1775,1796,21
13577,0,0,4,0,-4
13578,1,0,70,0,-70
13579,1,0,70,0,-70
13580,1,1,423,1220,797
13581,1,0,70,0,-70
13582,0,0,57,0,-57
13583,0,0,41,0,-41
13584,1,1,3061,1452,-1609
13585,1,1,1256,1424,168
13586,1,1,262,1251,989
13587,1,1,32,1658,1626
13588,0,0,60,0,-60
13589,1,1,358,1393,1035
13590,0,0,23,0,-23
13591,1,0,52,0,-52
13592,1,0,93,0,-93
13593,1,0,214,0,-214
13594,0,0,3,0,-3
13595,0,0,45,0,-45
13596,1,0,49,0,-49
13597,0,0,27,0,-27
13598,1,1,1764,1445,-319
13599,0,0,17,0,-17
13600,1,0,25,0,-25
13601,0,0,56,0,-56
13602,0,0,33,0,-33
13603,0,0,85,0,-85
13604,0,0,47,0,-47
13605,0,0,25,0,-25
13606,1,1,416,1365,949
13607,1,0,30,0,-30
13608,0,0,120,0,-120
13609,1,1,523,1432,909
13610,1,0,79,0,-79
13611,1,0,5,0,-5
13612,0,0,74,0,-74
13613,1,0,13,0,-13
13614,1,0,27,0,-27
13615,1,0,95,0,-95
13616,1,1,845,4476,3631
13617,0,0,9,0,-9
13618,1,0,12,0,-12
13619,0,0,91,0,-91
13620,1,0,68,0,-68
13621,1,1,132,1200,1068
13622,1,1,62,1239,1177
13623,1,1,733,1849,1116
13624,0,0,27,0,-27
13625,1,0,73,0,-73
13626,1,1,695,1361,666
13627,1,0,61,0,-61
13628,0,0,18,0,-18
13629,1,0,41,0,-41
13630,0,0,21,0,-21
13631,1,1,975,1209,234
13632,1,0,32,0,-32
13633,1,1,582,1447,865
13634,0,0,37,0,-37
13635,0,0,130,0,-130
13636,1,1,477,1535,1058
13637,1,1,562,1206,644
13638,0,0,3,0,-3
13639,1,0,74,0,-74
13640,1,1,155,1288,1133
13641,0,0,137,0,-137
13642,1,1,873,1386,513
13643,1,0,49,0,-49
13644,1,0,23,0,-23
13645,1,0,28,0,-28
13646,0,0,8,0,-8
13647,1,0,10,0,-10
13648,0,0,8,0,-8
13649,0,0,4,0,-4
13650,1,0,276,0,-276
13651,1,1,451,1206,755
13652,1,1,157,1203,1046
13653,1,0,39,0,-39
13654,0,0,81,0,-81
13655,1,0,150,0,-150
13656,1,0,48,0,-48
13657,0,0,36,0,-36
13658,1,0,23,0,-23
13659,1,1,534,1329,795
13660,1,1,349,1355,1006
13661,1,0,9,0,-9
13662,1,0,24,0,-24
13663,1,0,51,0,-51
13664,0,0,31,0,-31
13665,1,0,11,0,-11
13666,1,0,16,0,-16
13667,1,0,112,0,-112
13668,0,0,291,0,-291
13669,0,0,14,0,-14
13670,1,0,7,0,-7
13671,0,0,72,0,-72
13672,0,0,6,0,-6
13673,0,0,7,0,-7
13674,1,1,159,1484,1325
13675,0,0,76,0,-76
13676,0,0,10,0,-10
13677,0,0,59,0,-59
13678,1,0,40,0,-40
13679,1,0,50,0,-50
13680,0,0,18,0,-18
13681,0,0,18,0,-18
13682,0,0,4,0,-4
13683,0,0,54,0,-54
13684,1,1,102,1637,1535
13685,1,0,479,0,-479
13686,0,0,77,0,-77
13687,0,0,51,0,-51
13688,0,0,96,0,-96
13689,1,0,24,0,-24
13690,1,1,384,1253,869
13691,1,0,91,0,-91
13692,1,0,16,0,-16
13693,0,0,98,0,-98
13694,1,0,102,0,-102
13695,1,1,236,1584,1348
13696,0,0,34,0,-34
13697,1,0,52,0,-52
13698,0,0,9,0,-9
13699,1,1,274,1405,1131
13700,1,1,360,2556,2196
13701,0,0,6,0,-6
13702,0,0,4,0,-4
13703,1,0,24,0,-24
13704,1,0,29,0,-29
13705,1,0,2,0,-2
13706,0,0,3,0,-3
13707,0,0,21,0,-21
13708,0,0,48,0,-48
13709,1,1,739,1341,602
13710,0,0,16,0,-16
13711,0,0,12,0,-12
13712,0,0,29,0,-29
13713,0,0,67,0,-67
13714,1,0,22,0,-22
13715,0,0,9,0,-9
13716,0,0,1,0,-1
13717,0,0,28,0,-28
13718,1,1,684,1758,1074
13719,0,0,11,0,-11
13720,1,0,222,0,-222
13721,0,0,91,0,-91
13722,1,0,3,0,-3
13723,0,0,9,0,-9
13724,1,0,32,0,-32
13725,1,0,31,0,-31
13726,0,0,72,0,-72
13727,0,0,87,0,-87
13728,1,1,387,1546,1159
13729,1,1,113,1796,1683
13730,1,1,89,1770,1681
13731,1,1,344,1252,908
13732,0,0,38,0,-38
13733,0,0,3,0,-3
13734,0,0,25,0,-25
13735,1,1,124,1544,1420
13736,0,0,27,0,-27
13737,0,0,0,0,0
13738,1,0,71,0,-71
13739,1,1,770,1236,466
13740,0,0,203,0,-203
13741,1,1,55,1607,1552
13742,1,1,71,1259,1188
13743,1,1,353,1464,1111
13744,1,1,693,1218,525
13745,1,0,174,0,-174
13746,1,0,81,0,-81
13747,0,0,110,0,-110
13748,1,1,3,1973,1970
13749,1,1,161,1486,1325
13750,1,0,75,0,-75
13751,1,0,6,0,-6
13752,1,1,315,1715,1400
13753,1,1,221,1346,1125
13754,1,0,31,0,-31
13755,1,1,890,1675,785
13756,1,1,2029,1442,-587
13757,1,1,182,1229,1047
13758,0,0,8,0,-8
13759,0,0,19,0,-19
13760,1,0,15,0,-15
13761,0,0,2,0,-2
13762,1,0,23,0,-23
13763,1,0,121,0,-121
13764,1,0,162,0,-162
13765,1,0,148,0,-148
13766,1,1,37,1307,1270
13767,0,0,11,0,-11
13768,1,1,517,1201,684
13769,0,0,328,0,-328
13770,1,0,42,0,-42
13771,1,1,674,1410,736
13772,1,1,152,1410,1258
13773,0,0,66,0,-66
13774,1,1,127,1776,1649
13775,1,0,234,0,-234
13776,1,0,47,0,-47
13777,1,1,497,1593,1096
13778,1,0,189,0,-189
13779,1,0,13,0,-13
13780,1,1,346,1202,856
13781,1,0,53,0,-53
13782,1,0,11,0,-11
13783,0,0,8,0,-8
13784,1,1,690,1670,980
13785,0,0,6,0,-6
13786,1,1,220,2389,2169
13787,1,0,76,0,-76
13788,1,0,62,0,-62
13789,0,0,17,0,-17
13790,1,1,1025,2708,1683
13791,0,0,27,0,-27
13792,0,0,9,0,-9
13793,0,0,19,0,-19
13794,1,0,80,0,-80
13795,1,1,942,1643,701
13796,1,1,1052,2279,1227
13797,1,1,977,1387,410
13798,1,1,160,1338,1178
13799,0,0,21,0,-21
13800,1,1,544,1813,1269
13801,0,0,111,0,-111
13802,0,0,8,0,-8
13803,1,1,141,1279,1138
13804,0,0,6,0,-6
13805,0,0,19,0,-19
13806,1,0,25,0,-25
13807,1,0,35,0,-35
13808,1,0,192,0,-192
13809,0,0,25,0,-25
13810,0,0,60,0,-60
13811,1,1,88,1264,1176
13812,0,0,77,0,-77
13813,1,0,13,0,-13
13814,0,0,11,0,-11
13815,1,0,35,0,-35
13816,1,1,489,1273,784
13817,1,1,934,1297,363
13818,1,1,967,1349,382
13819,1,0,132,0,-132
13820,0,0,11,0,-11
13821,0,0,14,0,-14
13822,1,0,37,0,-37
13823,1,0,34,0,-34
13824,1,1,467,1915,1448
13825,1,1,225,1238,1013
13826,1,0,163,0,-163
13827,1,0,12,0,-12
13828,0,0,66,0,-66
13829,0,0,35,0,-35
13830,0,0,38,0,-38
13831,0,0,82,0,-82
13832,1,0,56,0,-56
13833,0,0,73,0,-73
13834,1,0,44,0,-44
13835,1,0,62,0,-62
13836,1,1,178,1296,1118
13837,1,1,127,1897,1770
13838,1,0,25,0,-25
13839,1,0,123,0,-123
13840,1,0,59,0,-59
13841,1,0,2,0,-2
13842,0,0,127,0,-127
13843,0,0,65,0,-65
13844,1,0,4,0,-4
13845,0,0,24,0,-24
13846,1,1,450,1913,1463
13847,1,1,249,2187,1938
13848,1,0,86,0,-86
13849,1,0,27,0,-27
13850,1,0,3,0,-3
13851,1,1,1374,1407,33
13852,0,0,11,0,-11
13853,0,0,33,0,-33
13854,1,1,161,1313,1152
13855,0,0,5,0,-5
13856,0,0,10,0,-10
13857,0,0,53,0,-53
13858,0,0,12,0,-12
13859,0,0,58,0,-58
13860,1,0,30,0,-30
13861,0,0,2,0,-2
13862,0,0,69,0,-69
13863,0,0,190,0,-190
13864,1,1,275,2277,2002
13865,1,1,1389,1284,-105
13866,1,1,120,1295,1175
13867,1,0,43,0,-43
13868,1,0,73,0,-73
13869,1,1,163,1626,1463
13870,1,0,67,0,-67
13871,0,0,22,0,-22
13872,0,0,55,0,-55
13873,1,1,223,1321,1098
13874,0,0,9,0,-9
13875,0,0,54,0,-54
13876,1,0,70,0,-70
13877,1,1,234,1568,1334
13878,1,1,378,1243,865
13879,1,1,74,1211,1137
13880,1,1,35,1459,1424
13881,0,0,95,0,-95
13882,1,1,1011,1302,291
13883,1,1,121,1415,1294
13884,0,0,141,0,-141
13885,1,1,720,1276,556
13886,0,0,14,0,-14
13887,0,0,28,0,-28
13888,0,0,95,0,-95
13889,1,0,1,0,-1
13890,1,0,34,0,-34
13891,0,0,4,0,-4
13892,0,0,122,0,-122
13893,1,0,17,0,-17
13894,0,0,45,0,-45
13895,1,0,93,0,-93
13896,1,0,38,0,-38
13897,0,0,39,0,-39
13898,0,0,26,0,-26
13899,1,1,669,1213,544
13900,1,1,580,1416,836
13901,0,0,10,0,-10
13902,1,0,37,0,-37
13903,1,0,6,0,-6
13904,1,0,1,0,-1
13905,1,0,1,0,-1
13906,0,0,51,0,-51
13907,1,0,75,0,-75
13908,0,0,93,0,-93
13909,0,0,262,0,-262
13910,1,0,94,0,-94
13911,0,0,65,0,-65
13912,0,0,36,0,-36
13913,1,1,157,1743,1586
13914,1,1,100,1216,1116
13915,0,0,53,0,-53
13916,1,1,84,1816,1732
13917,0,0,2,0,-2
13918,1,0,16,0,-16
13919,1,1,303,1319,1016
13920,0,0,83,0,-83
13921,1,0,127,0,-127
13922,0,0,36,0,-36
13923,0,0,62,0,-62
13924,0,0,93,0,-93
13925,0,0,21,0,-21
13926,0,0,99,0,-99
13927,1,0,35,0,-35
13928,1,1,3436,1649,-1787
13929,0,0,13,0,-13
13930,0,0,71,0,-71
13931,1,1,419,1303,884
13932,1,1,436,1384,948
13933,1,0,43,0,-43
13934,0,0,68,0,-68
13935,1,0,4,0,-4
13936,0,0,4,0,-4
13937,1,1,800,1344,544
13938,1,1,1159,2174,1015
13939,0,0,41,0,-41
13940,1,0,17,0,-17
13941,1,0,29,0,-29
13942,1,1,203,1608,1405
13943,0,0,0,0,0
13944,0,0,126,0,-126
13945,0,0,74,0,-74
13946,1,1,792,1520,728
13947,0,0,20,0,-20
13948,1,0,3,0,-3
13949,0,0,71,0,-71
13950,0,0,40,0,-40
13951,1,1,1158,1345,187
13952,1,1,1283,1869,586
13953,0,0,1,0,-1
13954,1,1,521,1316,795
13955,1,1,244,1301,1057
13956,1,0,11,0,-11
13957,1,1,1144,1217,73
13958,0,0,91,0,-91
13959,0,0,57,0,-57
13960,0,0,38,0,-38
13961,1,1,486,2436,1950
13962,1,1,61,1456,1395
13963,0,0,26,0,-26
13964,1,1,191,1256,1065
13965,0,0,3,0,-3
13966,1,0,48,0,-48
13967,1,1,1567,1802,235
13968,0,0,226,0,-226
13969,0,0,21,0,-21
13970,0,0,5,0,-5
13971,0,0,22,0,-22
13972,0,0,96,0,-96
13973,1,0,26,0,-26
13974,1,1,834,1320,486
13975,0,0,1,0,-1
13976,1,1,355,1513,1158
13977,1,0,61,0,-61
13978,1,0,13,0,-13
13979,0,0,140,0,-140
13980,1,1,529,1410,881
13981,1,1,311,1271,960
13982,1,1,600,1368,768
13983,1,0,17,0,-17
13984,1,0,19,0,-19
13985,1,1,594,3119,2525
13986,1,1,369,1511,1142
13987,1,0,115,0,-115
13988,0,0,3,0,-3
13989,0,0,46,0,-46
13990,0,0,198,0,-198
13991,0,0,14,0,-14
13992,1,0,2,0,-2
13993,1,1,379,1466,1087
13994,1,1,624,1339,715
13995,1,0,13,0,-13
13996,1,0,2,0,-2
13997,0,0,64,0,-64
13998,0,0,11,0,-11
13999,1,1,272,1317,1045
14000,0,0,66,0,-66
14001,0,0,58,0,-58
14002,1,0,34,0,-34
14003,1,1,973,1422,449
14004,1,1,1910,1722,-188
14005,1,0,39,0,-39
14006,1,1,404,1790,1386
14007,1,1,719,1573,854
14008,1,0,16,0,-16
14009,1,0,73,0,-73
14010,0,0,28,0,-28
14011,0,0,167,0,-167
14012,0,0,23,0,-23
14013,1,0,98,0,-98
14014,1,0,22,0,-22
14015,1,1,426,1458,1032
14016,0,0,15,0,-15
14017,1,0,81,0,-81
14018,0,0,46,0,-46
14019,1,1,430,1578,1148
14020,1,1,462,1207,745
14021,0,0,23,0,-23
14022,1,0,1,0,-1
14023,1,1,265,1257,992
14024,1,0,50,0,-50
14025,0,0,1,0,-1
14026,0,0,0,0,0
14027,0,0,0,0,0
14028,0,0,60,0,-60
14029,1,0,6,0,-6
14030,1,0,36,0,-36
14031,1,1,364,1504,1140
14032,1,0,122,0,-122
14033,1,1,570,1317,747
14034,1,0,199,0,-199
14035,0,0,34,0,-34
14036,1,1,262,1819,1557
14037,0,0,199,0,-199
14038,1,0,4,0,-4
14039,1,1,529,1287,758
14040,0,0,35,0,-35
14041,1,1,502,2267,1765
14042,1,0,28,0,-28
14043,1,0,14,0,-14
14044,0,0,53,0,-53
14045,0,0,28,0,-28
14046,0,0,6,0,-6
14047,1,0,27,0,-27
14048,1,1,55,2173,2118
14049,0,0,3,0,-3
14050,0,0,23,0,-23
14051,1,1,61,1252,1191
14052,1,0,15,0,-15
14053,1,0,69,0,-69
14054,1,1,192,1684,1492
14055,0,0,6,0,-6
14056,1,0,21,0,-21
14057,1,1,401,1746,1345
14058,1,0,57,0,-57
14059,0,0,4,0,-4
14060,1,0,20,0,-20
14061,1,1,613,2506,1893
14062,1,0,27,0,-27
14063,1,0,18,0,-18
14064,0,0,69,0,-69
14065,0,0,0,0,0
14066,1,0,59,0,-59
14067,0,0,23,0,-23
14068,0,0,20,0,-20
14069,0,0,20,0,-20
14070,1,1,1092,1400,308
14071,1,1,511,1558,1047
14072,1,1,163,1262,1099
14073,1,1,273,1298,1025
14074,1,1,57,1278,1221
14075,1,1,501,1581,1080
14076,1,1,556,2170,1614
14077,0,0,9,0,-9
14078,0,0,114,0,-114
14079,0,0,150,0,-150
14080,0,0,115,0,-115
14081,1,0,15,0,-15
14082,1,0,68,0,-68
14083,0,0,26,0,-26
14084,1,1,667,1274,607
14085,1,0,28,0,-28
14086,0,0,104,0,-104
14087,1,0,24,0,-24
14088,1,1,50,1222,1172
14089,1,0,85,0,-85
14090,1,1,677,1242,565
14091,1,0,2,0,-2
14092,0,0,67,0,-67
14093,1,1,364,1215,851
14094,1,1,289,1357,1068
14095,0,0,22,0,-22
14096,1,1,163,1420,1257
14097,1,0,14,0,-14
14098,1,1,68,2256,2188
14099,0,0,69,0,-69
14100,1,1,784,1256,472
14101,1,0,38,0,-38
14102,1,1,140,1273,1133
14103,1,1,414,1278,864
14104,1,0,35,0,-35
14105,0,0,18,0,-18
14106,0,0,86,0,-86
14107,0,0,41,0,-41
14108,1,1,242,1245,1003
14109,1,0,21,0,-21
14110,0,0,9,0,-9
14111,0,0,2,0,-2
14112,1,0,8,0,-8
14113,1,0,1,0,-1
14114,1,1,434,1825,1391
14115,1,1,403,1567,1164
14116,0,0,46,0,-46
14117,0,0,10,0,-10
14118,0,0,84,0,-84
14119,1,0,1,0,-1
14120,1,0,23,0,-23
14121,1,1,131,1406,1275
14122,0,0,20,0,-20
14123,1,1,1095,1791,696
14124,0,0,10,0,-10
14125,1,1,312,1265,953
14126,0,0,48,0,-48
14127,1,0,69,0,-69
14128,1,1,133,1292,1159
14129,1,0,2,0,-2
14130,0,0,7,0,-7
14131,1,0,13,0,-13
14132,1,1,895,1296,401
14133,1,1,117,1509,1392
14134,1,0,153,0,-153
14135,0,0,12,0,-12
14136,1,0,36,0,-36
14137,1,1,2263,1414,-849
14138,0,0,193,0,-193
14139,0,0,83,0,-83
14140,1,0,44,0,-44
14141,1,1,620,1457,837
14142,0,0,144,0,-144
14143,0,0,109,0,-109
14144,0,0,88,0,-88
14145,1,0,167,0,-167
14146,0,0,72,0,-72
14147,1,1,420,1387,967
14148,1,0,22,0,-22
14149,0,0,41,0,-41
14150,1,1,315,1214,899
14151,1,1,855,1405,550
14152,1,0,21,0,-21
14153,0,0,49,0,-49
14154,1,1,300,1309,1009
14155,1,0,78,0,-78
14156,1,0,82,0,-82
14157,0,0,55,0,-55
14158,1,0,147,0,-147
14159,1,0,32,0,-32
14160,1,0,56,0,-56
14161,1,0,12,0,-12
14162,1,1,197,1226,1029
14163,1,1,396,1935,1539
14164,1,0,17,0,-17
14165,0,0,25,0,-25
14166,1,0,53,0,-53
14167,1,1,726,1393,667
14168,1,0,17,0,-17
14169,1,1,824,1400,576
14170,1,1,488,1201,713
14171,0,0,31,0,-31
14172,1,0,22,0,-22
14173,0,0,10,0,-10
14174,1,0,57,0,-57
14175,0,0,18,0,-18
14176,1,1,842,1720,878
14177,1,0,20,0,-20
14178,1,1,279,1247,968
14179,1,0,73,0,-73
14180,0,0,22,0,-22
14181,0,0,73,0,-73
14182,1,1,16,1212,1196
14183,1,1,1552,1609,57
14184,1,1,311,1327,1016
14185,0,0,55,0,-55
14186,1,1,489,1291,802
14187,1,0,76,0,-76
14188,1,0,11,0,-11
14189,0,0,49,0,-49
14190,1,1,763,1719,956
14191,0,0,38,0,-38
14192,0,0,64,0,-64
14193,1,0,49,0,-49
14194,1,0,32,0,-32
14195,1,1,82,1371,1289
14196,0,0,85,0,-85
14197,0,0,41,0,-41
14198,1,1,678,1651,973
14199,1,0,80,0,-80
14200,1,0,28,0,-28
14201,0,0,6,0,-6
14202,0,0,119,0,-119
14203,0,0,15,0,-15
14204,0,0,20,0,-20
14205,1,0,13,0,-13
14206,0,0,6,0,-6
14207,0,0,105,0,-105
14208,1,0,50,0,-50
14209,1,1,774,1731,957
14210,0,0,20,0,-20
14211,0,0,33,0,-33
14212,1,1,746,1486,740
14213,1,1,199,1285,1086
14214,1,0,17,0,-17
14215,1,0,60,0,-60
14216,1,1,188,1310,1122
14217,0,0,74,0,-74
14218,0,0,2,0,-2
14219,1,1,203,1399,1196
14220,0,0,130,0,-130
14221,1,0,89,0,-89
14222,1,1,64,1396,1332
14223,1,1,901,1236,335
14224,1,1,563,2051,1488
14225,0,0,78,0,-78
14226,1,0,28,0,-28
14227,1,0,126,0,-126
14228,0,0,93,0,-93
14229,1,1,554,1577,1023
14230,0,0,28,0,-28
14231,0,0,130,0,-130
14232,1,0,162,0,-162
14233,1,0,0,0,0
14234,1,0,25,0,-25
14235,1,0,59,0,-59
14236,1,1,1610,1391,-219
14237,0,0,6,0,-6
14238,1,0,105,0,-105
14239,0,0,83,0,-83
14240,1,0,5,0,-5
14241,1,0,13,0,-13
14242,1,0,3,0,-3
14243,1,0,83,0,-83
14244,1,0,1,0,-1
14245,1,0,16,0,-16
14246,1,0,67,0,-67
14247,1,0,0,0,0
14248,0,0,17,0,-17
14249,1,0,125,0,-125
14250,1,1,520,1482,962
14251,1,0,246,0,-246
14252,1,1,1882,1541,-341
14253,0,0,14,0,-14
14254,1,0,104,0,-104
14255,1,1,1962,1201,-761
14256,0,0,39,0,-39
14257,1,1,1020,1470,450
14258,1,1,364,1695,1331
14259,0,0,61,0,-61
14260,0,0,0,0,0
14261,1,0,2,0,-2
14262,1,1,61,1266,1205
14263,1,0,31,0,-31
14264,0,0,57,0,-57
14265,0,0,28,0,-28
14266,1,1,444,1952,1508
14267,1,0,107,0,-107
14268,1,1,1234,1348,114
14269,1,0,4,0,-4
14270,1,0,35,0,-35
14271,0,0,1,0,-1
14272,1,1,1030,1611,581
14273,1,1,391,1203,812
14274,1,1,1053,1356,303
14275,1,1,166,1511,1345
14276,1,0,117,0,-117
14277,1,1,559,1596,1037
14278,1,0,57,0,-57
14279,1,1,819,2124,1305
14280,0,0,6,0,-6
14281,0,0,9,0,-9
14282,1,1,545,1391,846
14283,0,0,40,0,-40
14284,0,0,104,0,-104
14285,1,0,219,0,-219
14286,1,1,329,1305,976
14287,1,1,221,1305,1084
14288,1,0,3,0,-3
14289,0,0,20,0,-20
14290,1,1,437,1743,1306
14291,0,0,61,0,-61
14292,0,0,11,0,-11
14293,1,0,36,0,-36
14294,0,0,56,0,-56
14295,1,0,104,0,-104
14296,1,0,9,0,-9
14297,1,1,573,1266,693
14298,0,0,66,0,-66
14299,0,0,138,0,-138
14300,0,0,133,0,-133
14301,1,1,1210,1253,43
14302,0,0,55,0,-55
14303,1,1,108,1996,1888
14304,0,0,22,0,-22
14305,0,0,14,0,-14
14306,1,1,731,1295,564
14307,1,0,64,0,-64
14308,1,1,81,1280,1199
14309,1,0,46,0,-46
14310,0,0,85,0,-85
14311,0,0,10,0,-10
14312,1,0,130,0,-130
14313,1,0,103,0,-103
14314,1,0,9,0,-9
14315,0,0,12,0,-12
14316,1,1,178,1329,1151
14317,1,0,43,0,-43
14318,1,1,200,1706,1506
14319,0,0,44,0,-44
14320,0,0,66,0,-66
14321,0,0,10,0,-10
14322,1,1,102,1816,1714
14323,1,1,1417,1371,-46
14324,0,0,1,0,-1
14325,0,0,1,0,-1
14326,1,1,123,1584,1461
14327,1,1,637,1240,603
14328,1,1,335,1377,1042
14329,1,1,770,1322,552
14330,0,0,17,0,-17
14331,0,0,227,0,-227
14332,1,0,30,0,-30
14333,0,0,5,0,-5
14334,1,0,30,0,-30
14335,0,0,137,0,-137
14336,0,0,56,0,-56
14337,1,0,241,0,-241
14338,1,0,86,0,-86
14339,1,1,156,1289,1133
14340,0,0,59,0,-59
14341,1,0,23,0,-23
14342,1,1,277,2355,2078
14343,1,1,312,1253,941
14344,0,0,3,0,-3
14345,0,0,3,0,-3
14346,1,0,31,0,-31
14347,1,0,86,0,-86
14348,1,0,43,0,-43
14349,1,0,23,0,-23
14350,0,0,75,0,-75
14351,0,0,30,0,-30
14352,1,1,92,1564,1472
14353,0,0,4,0,-4
14354,0,0,55,0,-55
14355,0,0,60,0,-60
14356,0,0,24,0,-24
14357,1,1,574,1951,1377
14358,1,0,27,0,-27
14359,1,1,284,1213,929
14360,0,0,51,0,-51
14361,1,0,131,0,-131
14362,1,0,61,0,-61
14363,1,0,52,0,-52
14364,0,0,39,0,-39
14365,1,1,312,1615,1303
14366,1,1,249,1505,1256
14367,0,0,14,0,-14
14368,1,1,19,1796,1777
14369,0,0,35,0,-35
14370,1,1,109,1202,1093
14371,0,0,62,0,-62
14372,1,1,99,2679,2580
14373,0,0,12,0,-12
14374,1,1,226,1244,1018
14375,0,0,97,0,-97
14376,1,0,0,0,0
14377,0,0,91,0,-91
14378,1,0,91,0,-91
14379,0,0,117,0,-117
14380,1,0,40,0,-40
14381,1,1,234,1468,1234
14382,1,0,87,0,-87
14383,0,0,120,0,-120
14384,0,0,17,0,-17
14385,0,0,106,0,-106
14386,1,0,6,0,-6
14387,1,0,34,0,-34
14388,1,0,6,0,-6
14389,1,0,26,0,-26
14390,1,0,62,0,-62
14391,1,0,28,0,-28
14392,1,1,875,1229,354
14393,0,0,22,0,-22
14394,1,1,721,1368,647
14395,1,1,824,1701,877
14396,1,1,340,1281,941
14397,1,1,1470,1341,-129
14398,1,1,646,1942,1296
14399,1,1,630,1606,976
14400,0,0,21,0,-21
14401,1,0,86,0,-86
14402,1,1,124,1203,1079
14403,0,0,105,0,-105
14404,0,0,28,0,-28
14405,0,0,10,0,-10
14406,1,1,268,1562,1294
14407,1,1,236,1249,1013
14408,0,0,2,0,-2
14409,1,1,590,1504,914
14410,1,1,1330,1446,116
14411,0,0,33,0,-33
14412,1,0,14,0,-14
14413,0,0,108,0,-108
14414,1,1,436,1894,1458
14415,0,0,4,0,-4
14416,0,0,62,0,-62
14417,0,0,23,0,-23
14418,1,1,148,1742,1594
14419,0,0,2,0,-2
14420,0,0,14,0,-14
14421,1,0,53,0,-53
14422,1,0,12,0,-12
14423,0,0,24,0,-24
14424,0,0,37,0,-37
14425,0,0,50,0,-50
14426,0,0,21,0,-21
14427,0,0,15,0,-15
14428,1,1,216,2411,2195
14429,0,0,8,0,-8
14430,1,0,44,0,-44
14431,1,0,7,0,-7
14432,1,1,212,1861,1649
14433,1,1,884,1364,480
14434,0,0,97,0,-97
14435,0,0,98,0,-98
14436,1,0,19,0,-19
14437,1,1,1069,1338,269
14438,1,1,869,1605,736
14439,1,1,1348,3453,2105
14440,0,0,81,0,-81
14441,1,0,180,0,-180
14442,1,1,220,1768,1548
14443,1,0,9,0,-9
14444,0,0,7,0,-7
14445,0,0,160,0,-160
14446,0,0,108,0,-108
14447,1,0,24,0,-24
14448,0,0,50,0,-50
14449,1,1,636,1235,599
14450,1,1,397,1406,1009
14451,0,0,34,0,-34
14452,1,1,1633,1499,-134
14453,1,1,69,1542,1473
14454,1,1,316,1419,1103
14455,1,0,55,0,-55
14456,0,0,4,0,-4
14457,1,1,2096,1508,-588
14458,1,0,61,0,-61
14459,0,0,137,0,-137
14460,1,0,8,0,-8
14461,1,0,19,0,-19
14462,0,0,107,0,-107
14463,1,0,3,0,-3
14464,1,1,521,3388,2867
14465,1,0,11,0,-11
14466,1,0,26,0,-26
14467,1,1,920,1692,772
14468,1,1,278,1288,1010
14469,0,0,0,0,0
14470,1,1,930,2229,1299
14471,1,0,46,0,-46
14472,0,0,5,0,-5
14473,0,0,2,0,-2
14474,1,0,7,0,-7
14475,1,1,823,1256,433
14476,1,0,25,0,-25
14477,0,0,53,0,-53
14478,1,1,428,1207,779
14479,1,1,165,1480,1315
14480,0,0,114,0,-114
14481,0,0,21,0,-21
14482,1,1,73,1255,1182
14483,0,0,112,0,-112
14484,0,0,21,0,-21
14485,1,1,60,1345,1285
14486,0,0,120,0,-120
14487,0,0,52,0,-52
14488,1,0,50,0,-50
14489,1,1,101,1839,1738
14490,0,0,69,0,-69
14491,1,0,132,0,-132
14492,0,0,8,0,-8
14493,1,1,542,1309,767
14494,0,0,3,0,-3
14495,1,0,3,0,-3
14496,0,0,93,0,-93
14497,1,1,821,1537,716
14498,0,0,26,0,-26
14499,1,1,693,1352,659
14500,0,0,29,0,-29
14501,1,1,579,1646,1067
14502,1,1,204,1271,1067
14503,1,1,146,1556,1410
14504,1,0,3,0,-3
14505,1,1,559,2674,2115
14506,1,1,1740,1372,-368
14507,1,0,223,0,-223
14508,1,0,55,0,-55
14509,0,0,71,0,-71
14510,0,0,66,0,-66
14511,1,0,72,0,-72
14512,0,0,9,0,-9
14513,1,1,326,3016,2690
14514,1,1,30,4494,4464
14515,0,0,23,0,-23
14516,1,0,27,0,-27
14517,1,1,613,1383,770
14518,1,0,48,0,-48
14519,1,1,208,1415,1207
14520,0,0,12,0,-12
14521,1,1,357,1309,952
14522,0,0,39,0,-39
14523,0,0,66,0,-66
14524,1,0,103,0,-103
14525,1,0,19,0,-19
14526,0,0,10,0,-10
14527,1,1,298,1265,967
14528,1,0,105,0,-105
14529,1,0,120,0,-120
14530,1,0,124,0,-124
14531,0,0,18,0,-18
14532,1,1,155,1522,1367
14533,1,0,113,0,-113
14534,0,0,63,0,-63
14535,1,1,10,1355,1345
14536,1,1,157,1323,1166
14537,1,0,73,0,-73
14538,1,1,246,1676,1430
14539,1,0,23,0,-23
14540,1,1,1212,2496,1284
14541,0,0,33,0,-33
14542,1,0,26,0,-26
14543,0,0,36,0,-36
14544,0,0,97,0,-97
14545,1,1,421,1223,802
14546,1,0,20,0,-20
14547,1,0,35,0,-35
14548,1,1,298,1201,903
14549,1,1,85,1674,1589
14550,0,0,98,0,-98
14551,1,1,80,2077,1997
14552,1,1,1312,1709,397
14553,0,0,66,0,-66
14554,0,0,105,0,-105
14555,1,1,378,1256,878
14556,1,0,67,0,-67
14557,1,0,19,0,-19
14558,1,1,579,1632,1053
14559,1,1,1249,1591,342
14560,0,0,66,0,-66
14561,0,0,52,0,-52
14562,1,0,17,0,-17
14563,0,0,23,0,-23
14564,0,0,12,0,-12
14565,1,0,13,0,-13
14566,1,0,17,0,-17
14567,0,0,25,0,-25
14568,0,0,77,0,-77
14569,0,0,2,0,-2
14570,0,0,24,0,-24
14571,1,0,22,0,-22
14572,1,0,57,0,-57
14573,1,1,576,1861,1285
14574,0,0,166,0,-166
14575,0,0,45,0,-45
14576,1,1,24,1445,1421
14577,1,0,88,0,-88
14578,0,0,13,0,-13
14579,1,1,110,1383,1273
14580,0,0,6,0,-6
14581,0,0,124,0,-124
14582,0,0,28,0,-28
14583,0,0,29,0,-29
14584,0,0,6,0,-6
14585,1,0,59,0,-59
14586,1,1,1413,1348,-65
14587,1,1,350,1299,949
14588,0,0,28,0,-28
14589,0,0,37,0,-37
14590,1,1,1173,1274,101
14591,0,0,113,0,-113
14592,1,0,36,0,-36
14593,1,0,31,0,-31
14594,1,1,728,1263,535
14595,0,0,118,0,-118
14596,0,0,34,0,-34
14597,1,0,62,0,-62
14598,0,0,26,0,-26
14599,1,0,96,0,-96
14600,1,0,76,0,-76
14601,0,0,36,0,-36
14602,1,0,167,0,-167
14603,0,0,42,0,-42
14604,1,0,65,0,-65
14605,0,0,27,0,-27
14606,1,1,244,1375,1131
14607,0,0,6,0,-6
14608,1,0,52,0,-52
14609,1,1,606,1718,1112
14610,1,1,1389,1625,236
14611,0,0,19,0,-19
14612,0,0,32,0,-32
14613,1,0,23,0,-23
14614,1,0,120,0,-120
14615,0,0,12,0,-12
14616,1,0,10,0,-10
14617,1,1,642,1250,608
14618,1,1,204,2579,2375
14619,0,0,72,0,-72
14620,0,0,42,0,-42
14621,1,1,95,1796,1701
14622,1,1,167,1539,1372
14623,0,0,34,0,-34
14624,1,1,644,1401,757
14625,1,0,5,0,-5
14626,1,1,469,1868,1399
14627,1,0,39,0,-39
14628,0,0,111,0,-111
14629,0,0,5,0,-5
14630,0,0,18,0,-18
14631,0,0,2,0,-2
14632,0,0,35,0,-35
14633,1,0,102,0,-102
14634,1,0,193,0,-193
14635,1,0,67,0,-67
14636,0,0,29,0,-29
14637,1,0,40,0,-40
14638,0,0,29,0,-29
14639,1,1,1023,1233,210
14640,0,0,28,0,-28
14641,0,0,31,0,-31
14642,0,0,46,0,-46
14643,1,1,794,1212,418
14644,0,0,26,0,-26
14645,0,0,67,0,-67
14646,1,1,210,1519,1309
14647,1,1,404,1364,960
14648,1,0,3,0,-3
14649,1,1,1168,1227,59
14650,1,1,245,1457,1212
14651,0,0,24,0,-24
14652,1,1,181,1370,1189
14653,1,0,175,0,-175
14654,0,0,63,0,-63
14655,1,1,1278,1346,68
14656,1,1,519,1784,1265
14657,0,0,56,0,-56
14658,0,0,2,0,-2
14659,1,0,69,0,-69
14660,1,0,2,0,-2
14661,1,1,336,1789,1453
14662,0,0,19,0,-19
14663,1,1,23,2317,2294
14664,0,0,26,0,-26
14665,1,0,48,0,-48
14666,0,0,65,0,-65
14667,1,1,1915,1229,-686
14668,0,0,2,0,-2
14669,1,1,34,1226,1192
14670,0,0,32,0,-32
14671,1,0,19,0,-19
14672,1,1,4093,1697,-2396
14673,0,0,45,0,-45
14674,1,1,285,1442,1157
14675,1,0,75,0,-75
14676,1,0,16,0,-16
14677,1,1,323,1932,1609
14678,1,0,109,0,-109
14679,0,0,85,0,-85
14680,0,0,23,0,-23
14681,0,0,101,0,-101
14682,0,0,17,0,-17
14683,0,0,1,0,-1
14684,1,1,391,1210,819
14685,0,0,2,0,-2
14686,1,0,108,0,-108
14687,0,0,34,0,-34
14688,1,0,8,0,-8
14689,1,1,627,1235,608
14690,0,0,14,0,-14
14691,0,0,5,0,-5
14692,1,1,76,1849,1773
14693,0,0,50,0,-50
14694,0,0,15,0,-15
14695,1,0,171,0,-171
14696,0,0,100,0,-100
14697,1,1,69,1838,1769
14698,0,0,17,0,-17
14699,1,1,117,1639,1522
14700,0,0,23,0,-23
14701,1,0,83,0,-83
14702,1,0,27,0,-27
14703,1,1,472,1643,1171
14704,0,0,11,0,-11
14705,0,0,6,0,-6
14706,1,0,33,0,-33
14707,1,1,762,1564,802
14708,0,0,22,0,-22
14709,1,1,214,1876,1662
14710,1,1,179,1812,1633
14711,0,0,45,0,-45
14712,1,1,328,1276,948
14713,0,0,129,0,-129
14714,1,0,35,0,-35
14715,0,0,6,0,-6
14716,1,1,319,1233,914
14717,1,0,95,0,-95
14718,1,1,222,1204,982
14719,0,0,22,0,-22
14720,1,0,46,0,-46
14721,1,0,12,0,-12
14722,1,0,9,0,-9
14723,0,0,46,0,-46
14724,0,0,185,0,-185
14725,1,0,87,0,-87
14726,1,1,94,1435,1341
14727,1,1,281,2637,2356
14728,1,0,6,0,-6
14729,1,0,156,0,-156
14730,0,0,24,0,-24
14731,1,1,538,1291,753
14732,1,1,1087,1493,406
14733,1,0,35,0,-35
14734,0,0,41,0,-41
14735,0,0,35,0,-35
14736,1,1,30,1805,1775
14737,1,1,877,1416,539
14738,1,0,61,0,-61
14739,0,0,80,0,-80
14740,0,0,0,0,0
14741,1,1,782,1328,546
14742,0,0,12,0,-12
14743,1,1,1103,1221,118
14744,1,0,106,0,-106
14745,0,0,85,0,-85
14746,1,0,13,0,-13
14747,0,0,4,0,-4
14748,1,0,19,0,-19
14749,0,0,58,0,-58
14750,1,1,1323,1750,427
14751,0,0,65,0,-65
14752,1,1,510,1879,1369
14753,1,0,12,0,-12
14754,0,0,45,0,-45
14755,1,0,40,0,-40
14756,1,0,68,0,-68
14757,1,1,1494,1365,-129
14758,0,0,1,0,-1
14759,0,0,7,0,-7
14760,1,1,563,1326,763
14761,0,0,1,0,-1
14762,1,0,86,0,-86
14763,1,1,170,3174,3004
14764,1,1,61,1407,1346
14765,1,0,28,0,-28
14766,0,0,66,0,-66
14767,0,0,18,0,-18
14768,1,0,100,0,-100
14769,0,0,89,0,-89
14770,1,0,107,0,-107
14771,0,0,103,0,-103
14772,1,0,28,0,-28
14773,0,0,99,0,-99
14774,1,0,6,0,-6
14775,1,0,42,0,-42
14776,0,0,43,0,-43
14777,1,0,110,0,-110
14778,1,1,1205,1426,221
14779,1,1,425,1736,1311
14780,0,0,14,0,-14
14781,0,0,28,0,-28
14782,0,0,53,0,-53
14783,0,0,95,0,-95
14784,1,1,167,2006,1839
14785,0,0,80,0,-80
14786,1,0,49,0,-49
14787,0,0,42,0,-42
14788,1,1,118,1314,1196
14789,1,1,410,1282,872
14790,1,0,45,0,-45
14791,1,0,3,0,-3
14792,0,0,13,0,-13
14793,1,0,48,0,-48
14794,1,0,7,0,-7
14795,1,0,138,0,-138
14796,1,1,973,1404,431
14797,1,1,112,1210,1098
14798,0,0,257,0,-257
14799,1,0,3,0,-3
14800,1,0,14,0,-14
14801,1,0,6,0,-6
14802,1,0,39,0,-39
14803,1,1,130,1238,1108
14804,1,0,3,0,-3
14805,1,1,283,1235,952
14806,0,0,5,0,-5
14807,1,1,207,1254,1047
14808,1,0,0,0,0
14809,0,0,83,0,-83
14810,1,0,97,0,-97
14811,1,1,131,1531,1400
14812,1,0,72,0,-72
14813,0,0,24,0,-24
14814,1,0,73,0,-73
14815,1,0,153,0,-153
14816,1,1,735,4208,3473
14817,1,0,56,0,-56
14818,1,1,231,1871,1640
14819,1,1,357,1539,1182
14820,0,0,32,0,-32
14821,0,0,19,0,-19
14822,0,0,77,0,-77
14823,1,1,27,1381,1354
14824,0,0,46,0,-46
14825,1,1,12,1541,1529
14826,0,0,10,0,-10
14827,0,0,4,0,-4
14828,1,0,124,0,-124
14829,1,0,94,0,-94
14830,0,0,20,0,-20
14831,1,0,0,0,0
14832,0,0,91,0,-91
14833,0,0,99,0,-99
14834,0,0,129,0,-129
14835,1,1,939,1382,443
14836,1,1,129,1267,1138
14837,1,1,325,1322,997
14838,0,0,0,0,0
14839,1,0,11,0,-11
14840,0,0,2,0,-2
14841,0,0,5,0,-5
14842,0,0,27,0,-27
14843,1,0,169,0,-169
14844,0,0,70,0,-70
14845,1,1,388,2592,2204
14846,0,0,3,0,-3
14847,0,0,28,0,-28
14848,0,0,10,0,-10
14849,0,0,191,0,-191
14850,1,0,73,0,-73
14851,1,1,770,1497,727
14852,1,0,38,0,-38
14853,0,0,33,0,-33
14854,0,0,26,0,-26
14855,0,0,42,0,-42
14856,1,1,302,1954,1652
14857,0,0,207,0,-207
14858,1,1,614,1323,709
14859,1,1,1351,1322,-29
14860,0,0,60,0,-60
14861,0,0,30,0,-30
14862,0,0,35,0,-35
14863,1,1,93,1487,1394
14864,1,0,28,0,-28
14865,1,1,515,1414,899
14866,0,0,23,0,-23
14867,0,0,8,0,-8
14868,0,0,226,0,-226
14869,1,0,9,0,-9
14870,1,1,120,1698,1578
14871,1,1,599,1255,656
14872,1,0,88,0,-88
14873,1,0,56,0,-56
14874,0,0,23,0,-23
14875,1,1,234,1225,991
14876,1,1,175,1637,1462
14877,0,0,24,0,-24
14878,1,1,1050,2258,1208
14879,1,0,188,0,-188
14880,0,0,81,0,-81
14881,1,1,223,1824,1601
14882,1,0,12,0,-12
14883,0,0,117,0,-117
14884,1,1,152,1472,1320
14885,1,1,1802,1226,-576
14886,1,0,218,0,-218
14887,1,1,527,1470,943
14888,1,0,30,0,-30
14889,1,1,648,1227,579
14890,1,1,254,1253,999
14891,1,1,1187,1205,18
14892,1,0,16,0,-16
14893,1,1,1216,1263,47
14894,0,0,99,0,-99
14895,0,0,38,0,-38
14896,0,0,37,0,-37
14897,1,0,40,0,-40
14898,0,0,28,0,-28
14899,0,0,9,0,-9
14900,1,1,28,2419,2391
14901,0,0,29,0,-29
14902,0,0,8,0,-8
14903,0,0,31,0,-31
14904,0,0,91,0,-91
14905,0,0,35,0,-35
14906,0,0,253,0,-253
14907,1,1,584,1282,698
14908,1,1,423,1692,1269
14909,1,0,24,0,-24
14910,0,0,4,0,-4
14911,1,1,8,1609,1601
14912,0,0,132,0,-132
14913,0,0,29,0,-29
14914,0,0,83,0,-83
14915,0,0,80,0,-80
14916,0,0,36,0,-36
14917,1,0,84,0,-84
14918,1,0,14,0,-14
14919,1,1,1296,1318,22
14920,1,0,86,0,-86
14921,1,1,139,1484,1345
14922,0,0,98,0,-98
14923,0,0,133,0,-133
14924,1,0,7,0,-7
14925,1,0,31,0,-31
14926,0,0,34,0,-34
14927,1,1,328,2156,1828
14928,0,0,103,0,-103
14929,1,1,1330,2504,1174
14930,1,0,12,0,-12
14931,1,1,411,1904,1493
14932,0,0,10,0,-10
14933,1,1,143,1228,1085
14934,0,0,15,0,-15
14935,1,1,1308,1669,361
14936,1,0,52,0,-52
14937,1,0,2,0,-2
14938,0,0,30,0,-30
14939,1,0,35,0,-35
14940,0,0,5,0,-5
14941,0,0,45,0,-45
14942,1,0,143,0,-143
14943,0,0,9,0,-9
14944,1,1,575,1210,635
14945,1,0,7,0,-7
14946,1,1,375,2108,1733
14947,1,1,1061,1659,598
14948,1,1,1309,2170,861
14949,1,1,1627,1274,-353
14950,1,0,3,0,-3
14951,0,0,144,0,-144
14952,0,0,6,0,-6
14953,1,0,85,0,-85
14954,0,0,95,0,-95
14955,1,1,145,1575,1430
14956,1,1,281,1467,1186
14957,1,0,26,0,-26
14958,1,1,174,1635,1461
14959,1,1,756,2472,1716
14960,1,0,17,0,-17
14961,1,0,150,0,-150
14962,1,0,4,0,-4
14963,1,1,432,1733,1301
14964,0,0,122,0,-122
14965,1,0,14,0,-14
14966,1,0,18,0,-18
14967,0,0,76,0,-76
14968,0,0,20,0,-20
14969,1,1,32,1433,1401
14970,0,0,23,0,-23
14971,1,1,304,1287,983
14972,0,0,20,0,-20
14973,0,0,37,0,-37
14974,1,0,25,0,-25
14975,1,1,58,1227,1169
14976,1,1,888,1447,559
14977,1,0,52,0,-52
14978,0,0,1,0,-1
14979,1,1,926,1528,602
14980,1,0,134,0,-134
14981,1,1,1048,1478,430
14982,0,0,4,0,-4
14983,0,0,13,0,-13
14984,0,0,194,0,-194
14985,0,0,26,0,-26
14986,0,0,8,0,-8
14987,1,0,64,0,-64
14988,1,0,39,0,-39
14989,0,0,2,0,-2
14990,0,0,36,0,-36
14991,1,1,543,1310,767
14992,1,1,91,2029,1938
14993,1,0,57,0,-57
14994,1,1,217,1789,1572
14995,0,0,42,0,-42
14996,1,1,287,1287,1000
14997,1,0,24,0,-24
14998,0,0,50,0,-50
14999,1,0,117,0,-117
15000,1,0,23,0,-23
15001,1,0,74,0,-74
15002,0,0,6,0,-6
15003,1,0,17,0,-17
15004,1,1,282,1342,1060
15005,1,1,35,2642,2607
15006,1,1,453,1420,967
15007,1,1,1104,1744,640
15008,0,0,101,0,-101
15009,1,0,26,0,-26
15010,1,0,29,0,-29
15011,1,0,16,0,-16
15012,1,0,118,0,-118
15013,0,0,113,0,-113
15014,1,0,22,0,-22
15015,1,0,37,0,-37
15016,0,0,14,0,-14
15017,1,0,1,0,-1
15018,0,0,75,0,-75
15019,0,0,38,0,-38
15020,1,1,251,1301,1050
15021,0,0,85,0,-85
15022,1,0,68,0,-68
15023,1,1,503,1429,926
15024,1,1,414,1235,821
15025,0,0,37,0,-37
15026,0,0,22,0,-22
15027,1,1,352,1290,938
15028,0,0,47,0,-47
15029,1,0,2,0,-2
15030,1,1,444,1256,812
15031,0,0,2,0,-2
15032,0,0,37,0,-37
15033,0,0,78,0,-78
15034,0,0,79,0,-79
15035,0,0,62,0,-62
15036,0,0,24,0,-24
15037,0,0,52,0,-52
15038,1,1,630,2185,1555
15039,1,1,295,1534,1239
15040,1,1,1221,2162,941
15041,1,1,835,1788,953
15042,1,0,34,0,-34
15043,1,0,51,0,-51
15044,1,1,128,1291,1163
15045,1,1,487,2249,1762
15046,0,0,37,0,-37
15047,0,0,22,0,-22
15048,1,1,20,5729,5709
15049,1,1,61,1472,1411
15050,0,0,9,0,-9
15051,1,1,347,1503,1156
15052,0,0,32,0,-32
15053,1,0,7,0,-7
15054,0,0,21,0,-21
15055,1,1,131,1600,1469
15056,1,0,28,0,-28
15057,1,0,169,0,-169
15058,1,0,10,0,-10
15059,1,0,1,0,-1
15060,1,0,106,0,-106
15061,0,0,23,0,-23
15062,1,0,37,0,-37
15063,1,0,240,0,-240
15064,1,1,261,1290,1029
15065,0,0,19,0,-19
15066,0,0,18,0,-18
15067,1,1,110,2005,1895
15068,1,0,3,0,-3
15069,0,0,34,0,-34
15070,1,1,299,1514,1215
15071,0,0,28,0,-28
15072,1,1,331,1439,1108
15073,0,0,17,0,-17
15074,0,0,124,0,-124
15075,1,1,247,1362,1115
15076,0,0,69,0,-69
15077,1,0,15,0,-15
15078,1,0,35,0,-35
15079,1,1,753,1298,545
15080,1,0,160,0,-160
15081,0,0,76,0,-76
15082,1,0,61,0,-61
15083,1,1,517,1695,1178
15084,1,0,39,0,-39
15085,1,0,94,0,-94
15086,1,1,307,1676,1369
15087,1,0,83,0,-83
15088,0,0,68,0,-68
15089,0,0,99,0,-99
15090,1,0,26,0,-26
15091,0,0,98,0,-98
15092,1,1,421,1285,864
15093,1,0,31,0,-31
15094,1,1,790,1252,462
15095,0,0,70,0,-70
15096,0,0,38,0,-38
15097,0,0,12,0,-12
15098,1,1,797,1573,776
15099,0,0,49,0,-49
15100,1,0,19,0,-19
15101,1,0,28,0,-28
15102,1,1,236,1286,1050
15103,1,0,29,0,-29
15104,0,0,17,0,-17
15105,1,1,65,1460,1395
15106,1,0,4,0,-4
15107,1,0,137,0,-137
15108,0,0,4,0,-4
15109,0,0,16,0,-16
15110,0,0,34,0,-34
15111,0,0,297,0,-297
15112,1,1,256,1200,944
15113,1,1,610,2654,2044
15114,1,1,531,1277,746
15115,1,1,102,1353,1251
15116,1,0,25,0,-25
15117,1,0,54,0,-54
15118,0,0,38,0,-38
15119,1,1,399,1681,1282
15120,0,0,42,0,-42
15121,0,0,38,0,-38
15122,1,0,10,0,-10
15123,1,0,111,0,-111
15124,0,0,51,0,-51
15125,0,0,20,0,-20
15126,1,0,13,0,-13
15127,1,0,17,0,-17
15128,0,0,4,0,-4
15129,0,0,23,0,-23
15130,1,0,288,0,-288
15131,1,0,13,0,-13
15132,0,0,26,0,-26
15133,0,0,9,0,-9
15134,1,0,91,0,-91
15135,1,1,286,1672,1386
15136,0,0,0,0,0
15137,0,0,36,0,-36
15138,0,0,24,0,-24
15139,1,0,7,0,-7
15140,0,0,50,0,-50
15141,0,0,2,0,-2
15142,1,1,1360,2812,1452
15143,0,0,60,0,-60
15144,1,0,49,0,-49
15145,1,0,61,0,-61
15146,1,1,690,1248,558
15147,1,0,42,0,-42
15148,1,1,134,1484,1350
15149,0,0,111,0,-111
15150,0,0,235,0,-235
15151,0,0,65,0,-65
15152,1,1,649,1368,719
15153,1,1,377,1420,1043
15154,0,0,70,0,-70
15155,0,0,46,0,-46
15156,0,0,51,0,-51
15157,0,0,5,0,-5
15158,0,0,84,0,-84
15159,0,0,139,0,-139
15160,0,0,20,0,-20
15161,1,0,57,0,-57
15162,1,1,98,1251,1153
15163,1,0,45,0,-45
15164,1,1,632,1271,639
15165,0,0,134,0,-134
15166,1,0,18,0,-18
15167,0,0,23,0,-23
15168,1,0,17,0,-17
15169,1,1,210,1338,1128
15170,1,0,1,0,-1
15171,0,0,170,0,-170
15172,0,0,22,0,-22
15173,1,1,137,1289,1152
15174,1,0,66,0,-66
15175,0,0,27,0,-27
15176,0,0,27,0,-27
15177,1,0,125,0,-125
15178,0,0,114,0,-114
15179,1,0,3,0,-3
15180,1,0,112,0,-112
15181,0,0,39,0,-39
15182,1,0,7,0,-7
15183,0,0,1,0,-1
15184,1,0,116,0,-116
15185,1,0,74,0,-74
15186,0,0,94,0,-94
15187,1,1,1064,1366,302
15188,0,0,62,0,-62
15189,1,0,36,0,-36
15190,0,0,43,0,-43
15191,0,0,28,0,-28
15192,0,0,45,0,-45
15193,0,0,69,0,-69
15194,1,0,135,0,-135
15195,0,0,4,0,-4
15196,0,0,29,0,-29
15197,1,1,2492,1411,-1081
15198,0,0,9,0,-9
15199,0,0,75,0,-75
15200,1,1,933,1857,924
15201,1,1,746,1491,745
15202,1,0,103,0,-103
15203,1,0,52,0,-52
15204,0,0,4,0,-4
15205,0,0,45,0,-45
15206,0,0,62,0,-62
15207,1,0,20,0,-20
15208,1,1,202,1265,1063
15209,1,1,159,1216,1057
15210,1,0,0,0,0
15211,1,0,51,0,-51
15212,1,0,149,0,-149
15213,0,0,16,0,-16
15214,1,1,312,1346,1034
15215,1,1,1108,1365,257
15216,0,0,35,0,-35
15217,1,1,74,1465,1391
15218,1,0,7,0,-7
15219,0,0,14,0,-14
15220,0,0,99,0,-99
15221,0,0,59,0,-59
15222,1,1,1044,1291,247
15223,1,1,440,1304,864
15224,1,0,8,0,-8
15225,1,0,97,0,-97
15226,1,0,12,0,-12
15227,1,1,597,1266,669
15228,1,0,53,0,-53
15229,0,0,85,0,-85
15230,0,0,56,0,-56
15231,1,1,176,1468,1292
15232,0,0,168,0,-168
15233,0,0,41,0,-41
15234,0,0,55,0,-55
15235,0,0,28,0,-28
15236,1,0,162,0,-162
15237,1,0,137,0,-137
15238,0,0,21,0,-21
15239,0,0,24,0,-24
15240,1,0,28,0,-28
15241,1,0,20,0,-20
15242,1,1,508,1727,1219
15243,0,0,32,0,-32
15244,1,1,600,1408,808
15245,0,0,75,0,-75
15246,1,0,40,0,-40
15247,1,0,73,0,-73
15248,1,1,204,2097,1893
15249,1,1,318,2117,1799
15250,1,0,93,0,-93
15251,0,0,11,0,-11
15252,0,0,30,0,-30
15253,1,1,1744,1234,-510
15254,1,1,78,1453,1375
15255,1,0,29,0,-29
15256,1,0,10,0,-10
15257,1,1,452,1309,857
15258,1,1,137,1244,1107
15259,0,0,144,0,-144
15260,1,0,6,0,-6
15261,1,0,78,0,-78
15262,1,1,650,1552,902
15263,0,0,28,0,-28
15264,1,1,571,1601,1030
15265,0,0,25,0,-25
15266,0,0,131,0,-131
15267,1,1,345,1967,1622
15268,1,0,39,0,-39
15269,0,0,73,0,-73
15270,1,0,1,0,-1
15271,0,0,85,0,-85
15272,1,0,59,0,-59
15273,1,1,71,1354,1283
15274,1,0,11,0,-11
15275,0,0,9,0,-9
15276,1,1,615,1316,701
15277,1,1,256,1235,979
15278,1,0,42,0,-42
15279,0,0,17,0,-17
15280,0,0,31,0,-31
15281,1,1,566,1297,731
15282,1,1,144,1203,1059
15283,1,0,47,0,-47
15284,0,0,21,0,-21
15285,0,0,76,0,-76
15286,1,1,911,1437,526
15287,0,0,178,0,-178
15288,1,1,148,1291,1143
15289,1,0,67,0,-67
15290,1,0,5,0,-5
15291,0,0,28,0,-28
15292,1,1,1131,1449,318
15293,0,0,18,0,-18
15294,0,0,83,0,-83
15295,1,0,28,0,-28
15296,1,0,2,0,-2
15297,1,1,881,1275,394
15298,1,1,1527,1840,313
15299,1,0,107,0,-107
15300,0,0,3,0,-3
15301,1,1,525,1257,732
15302,1,0,24,0,-24
15303,0,0,17,0,-17
15304,0,0,87,0,-87
15305,1,1,194,1225,1031
15306,0,0,8,0,-8
15307,1,1,797,1356,559
15308,1,1,1082,1222,140
15309,0,0,9,0,-9
15310,0,0,39,0,-39
15311,1,0,57,0,-57
15312,1,1,588,1447,859
15313,0,0,18,0,-18
15314,0,0,31,0,-31
15315,0,0,71,0,-71
15316,0,0,58,0,-58
15317,0,0,11,0,-11
15318,0,0,33,0,-33
15319,0,0,143,0,-143
15320,1,0,30,0,-30
15321,0,0,54,0,-54
15322,1,0,105,0,-105
15323,0,0,48,0,-48
15324,0,0,57,0,-57
15325,0,0,1,0,-1
15326,1,0,34,0,-34
15327,1,0,67,0,-67
15328,0,0,27,0,-27
15329,1,1,607,1334,727
15330,1,0,23,0,-23
15331,0,0,33,0,-33
15332,1,1,689,1619,930
15333,1,1,963,1245,282
15334,0,0,64,0,-64
15335,1,0,65,0,-65
15336,0,0,67,0,-67
15337,1,0,10,0,-10
15338,0,0,34,0,-34
15339,1,1,144,1231,1087
15340,0,0,121,0,-121
15341,0,0,23,0,-23
15342,1,1,1281,1303,22
15343,0,0,14,0,-14
15344,1,0,50,0,-50
15345,0,0,31,0,-31
15346,1,0,19,0,-19
15347,0,0,7,0,-7
15348,0,0,23,0,-23
15349,1,1,397,1205,808
15350,1,0,96,0,-96
15351,0,0,13,0,-13
15352,0,0,2,0,-2
15353,1,1,169,1574,1405
15354,1,1,257,2170,1913
15355,0,0,22,0,-22
15356,1,0,10,0,-10
15357,1,1,322,1283,961
15358,1,0,58,0,-58
15359,1,1,152,1256,1104
15360,0,0,33,0,-33
15361,1,0,41,0,-41
15362,0,0,155,0,-155
15363,1,1,42,1441,1399
15364,0,0,50,0,-50
15365,1,1,252,1837,1585
15366,0,0,28,0,-28
15367,0,0,38,0,-38
15368,0,0,0,0,0
15369,0,0,38,0,-38
15370,1,1,604,1293,689
15371,0,0,29,0,-29
15372,0,0,140,0,-140
15373,1,0,80,0,-80
15374,1,0,26,0,-26
15375,0,0,1,0,-1
15376,1,1,88,1768,1680
15377,0,0,4,0,-4
15378,1,0,5,0,-5
15379,1,0,27,0,-27
15380,1,1,397,1210,813
15381,0,0,28,0,-28
15382,1,1,832,1413,581
15383,1,1,246,1605,1359
15384,1,1,1198,1717,519
15385,0,0,3,0,-3
15386,1,0,51,0,-51
15387,1,0,76,0,-76
15388,1,1,121,1759,1638
15389,1,1,1119,1235,116
15390,0,0,83,0,-83
15391,1,0,9,0,-9
15392,0,0,26,0,-26
15393,1,1,546,1258,712
15394,0,0,56,0,-56
15395,0,0,40,0,-40
15396,0,0,0,0,0
15397,1,0,7,0,-7
15398,1,0,14,0,-14
15399,1,1,1948,1251,-697
15400,1,0,4,0,-4
15401,0,0,22,0,-22
15402,0,0,24,0,-24
15403,1,1,17,1210,1193
15404,1,0,79,0,-79
15405,0,0,14,0,-14
15406,1,0,9,0,-9
15407,1,0,61,0,-61
15408,0,0,174,0,-174
15409,1,0,124,0,-124
15410,1,1,361,1403,1042
15411,0,0,34,0,-34
15412,1,0,36,0,-36
15413,1,0,28,0,-28
15414,1,0,29,0,-29
15415,1,0,12,0,-12
15416,0,0,27,0,-27
15417,1,1,1685,1662,-23
15418,1,0,151,0,-151
15419,1,1,866,1232,366
15420,0,0,2,0,-2
15421,1,0,33,0,-33
15422,1,0,10,0,-10
15423,1,1,50,1267,1217
15424,0,0,142,0,-142
15425,1,0,14,0,-14
15426,1,0,24,0,-24
15427,1,1,580,1399,819
15428,1,0,44,0,-44
15429,1,0,159,0,-159
15430,1,1,345,1298,953
15431,0,0,4,0,-4
15432,0,0,92,0,-92
15433,1,0,29,0,-29
15434,1,1,460,1361,901
15435,1,0,1,0,-1
15436,1,0,23,0,-23
15437,1,1,190,1355,1165
15438,1,0,72,0,-72
15439,0,0,21,0,-21
15440,1,1,451,1437,986
15441,1,1,214,1262,1048
15442,1,0,32,0,-32
15443,0,0,39,0,-39
15444,1,0,43,0,-43
15445,0,0,33,0,-33
15446,1,0,34,0,-34
15447,0,0,70,0,-70
15448,0,0,62,0,-62
15449,0,0,21,0,-21
15450,1,1,682,1213,531
15451,0,0,4,0,-4
15452,1,1,1020,2140,1120
15453,0,0,163,0,-163
15454,0,0,27,0,-27
15455,1,0,23,0,-23
15456,1,1,618,1324,706
15457,0,0,57,0,-57
15458,0,0,3,0,-3
15459,1,1,1571,1318,-253
15460,0,0,84,0,-84
15461,0,0,10,0,-10
15462,1,1,438,2432,1994
15463,1,1,313,1304,991
15464,0,0,116,0,-116
15465,1,0,7,0,-7
15466,1,1,144,1437,1293
15467,0,0,9,0,-9
15468,0,0,60,0,-60
15469,1,0,12,0,-12
15470,1,0,33,0,-33
15471,0,0,92,0,-92
15472,0,0,14,0,-14
15473,1,0,111,0,-111
15474,0,0,204,0,-204
15475,0,0,0,0,0
15476,1,1,394,1332,938
15477,1,1,789,1741,952
15478,1,1,1041,1440,399
15479,1,1,2462,1291,-1171
15480,0,0,0,0,0
15481,0,0,8,0,-8
15482,1,1,555,1531,976
15483,1,0,116,0,-116
15484,1,0,21,0,-21
15485,0,0,26,0,-26
15486,0,0,8,0,-8
15487,1,1,153,1269,1116
15488,0,0,78,0,-78
15489,1,1,644,1474,830
15490,1,1,56,1347,1291
15491,0,0,88,0,-88
15492,1,1,364,2083,1719
15493,0,0,16,0,-16
15494,0,0,81,0,-81
15495,0,0,46,0,-46
15496,1,1,1040,1233,193
15497,0,0,8,0,-8
15498,1,1,1569,1661,92
15499,1,0,62,0,-62
15500,1,1,237,1629,1392
15501,0,0,136,0,-136
15502,0,0,54,0,-54
15503,0,0,2,0,-2
15504,1,0,27,0,-27
15505,0,0,69,0,-69
15506,0,0,92,0,-92
15507,1,1,154,1240,1086
15508,0,0,16,0,-16
15509,1,1,149,1491,1342
15510,0,0,16,0,-16
15511,1,0,127,0,-127
15512,1,1,51,1252,1201
15513,1,1,383,1273,890
15514,1,1,680,1266,586
15515,0,0,67,0,-67
15516,1,0,39,0,-39
15517,0,0,35,0,-35
15518,1,0,3,0,-3
15519,1,0,61,0,-61
15520,1,1,479,2829,2350
15521,0,0,33,0,-33
15522,0,0,22,0,-22
15523,1,1,411,1235,824
15524,1,0,115,0,-115
15525,1,0,24,0,-24
15526,1,0,7,0,-7
15527,0,0,6,0,-6
15528,1,1,1636,1371,-265
15529,0,0,67,0,-67
15530,0,0,18,0,-18
15531,1,1,1674,1298,-376
15532,0,0,12,0,-12
15533,1,0,137,0,-137
15534,1,1,118,1360,1242
15535,0,0,68,0,-68
15536,1,1,120,2007,1887
15537,1,1,212,1675,1463
15538,1,0,96,0,-96
15539,0,0,60,0,-60
15540,1,0,63,0,-63
15541,1,1,808,1453,645
15542,1,1,403,1423,1020
15543,1,0,11,0,-11
15544,0,0,31,0,-31
15545,0,0,29,0,-29
15546,0,0,10,0,-10
15547,1,1,252,2771,2519
15548,0,0,2,0,-2
15549,0,0,14,0,-14
15550,1,0,4,0,-4
15551,1,0,19,0,-19
15552,1,0,42,0,-42
15553,0,0,63,0,-63
15554,0,0,6,0,-6
15555,1,0,89,0,-89
15556,1,0,75,0,-75
15557,0,0,48,0,-48
15558,0,0,121,0,-121
15559,0,0,47,0,-47
15560,1,0,93,0,-93
15561,0,0,12,0,-12
15562,1,0,84,0,-84
15563,0,0,215,0,-215
15564,1,0,44,0,-44
15565,1,0,26,0,-26
15566,1,0,98,0,-98
15567,0,0,49,0,-49
15568,1,1,378,1244,866
15569,1,1,230,1280,1050
15570,0,0,53,0,-53
15571,1,0,218,0,-218
15572,0,0,13,0,-13
15573,0,0,29,0,-29
15574,1,1,804,1291,487
15575,1,0,20,0,-20
15576,0,0,26,0,-26
15577,1,0,305,0,-305
15578,1,1,142,5443,5301
15579,1,1,169,1270,1101
15580,1,1,176,1516,1340
15581,1,0,83,0,-83
15582,1,1,479,1217,738
15583,0,0,21,0,-21
15584,1,0,72,0,-72
15585,1,1,28,1754,1726
15586,0,0,133,0,-133
15587,1,1,130,1622,1492
15588,1,1,536,1245,709
15589,1,0,105,0,-105
15590,1,0,40,0,-40
15591,1,0,9,0,-9
15592,0,0,12,0,-12
15593,0,0,0,0,0
15594,1,0,80,0,-80
15595,1,1,783,2141,1358
15596,0,0,90,0,-90
15597,0,0,27,0,-27
15598,1,1,1861,1783,-78
15599,1,1,720,1344,624
15600,0,0,76,0,-76
15601,0,0,88,0,-88
15602,1,0,4,0,-4
15603,1,1,88,1984,1896
15604,1,1,430,1334,904
15605,1,1,385,1600,1215
15606,0,0,0,0,0
15607,1,1,500,1318,818
15608,0,0,48,0,-48
15609,1,0,50,0,-50
15610,1,0,6,0,-6
15611,1,1,770,1323,553
15612,1,0,76,0,-76
15613,1,1,108,1679,1571
15614,1,1,1311,1948,637
15615,1,1,153,1381,1228
15616,1,0,68,0,-68
15617,0,0,106,0,-106
15618,0,0,101,0,-101
15619,1,1,311,1446,1135
15620,1,0,55,0,-55
15621,0,0,36,0,-36
15622,1,0,29,0,-29
15623,0,0,62,0,-62
15624,1,1,1415,1280,-135
15625,0,0,45,0,-45
15626,1,0,9,0,-9
15627,1,1,684,1274,590
15628,1,0,64,0,-64
15629,1,0,29,0,-29
15630,0,0,53,0,-53
15631,0,0,125,0,-125
15632,1,0,74,0,-74
15633,1,1,521,1279,758
15634,1,1,224,1276,1052
15635,1,0,4,0,-4
15636,1,0,40,0,-40
15637,0,0,63,0,-63
15638,1,1,701,1457,756
15639,1,1,227,1430,1203
15640,1,0,78,0,-78
15641,0,0,166,0,-166
15642,0,0,3,0,-3
15643,1,0,118,0,-118
15644,1,0,206,0,-206
15645,0,0,26,0,-26
15646,1,1,301,1465,1164
15647,1,0,6,0,-6
15648,0,0,26,0,-26
15649,1,1,1112,4864,3752
15650,0,0,23,0,-23
15651,1,1,1706,1281,-425
15652,0,0,10,0,-10
15653,0,0,69,0,-69
15654,1,1,651,1962,1311
15655,1,0,75,0,-75
15656,1,1,139,1668,1529
15657,1,0,41,0,-41
15658,0,0,11,0,-11
15659,1,1,431,1860,1429
15660,1,1,917,1352,435
15661,1,0,71,0,-71
15662,0,0,21,0,-21
15663,1,0,118,0,-118
15664,1,1,71,1480,1409
15665,1,0,102,0,-102
15666,0,0,29,0,-29
15667,0,0,34,0,-34
15668,0,0,46,0,-46
15669,0,0,40,0,-40
15670,1,0,144,0,-144
15671,1,0,28,0,-28
15672,0,0,55,0,-55
15673,0,0,158,0,-158
15674,0,0,11,0,-11
15675,0,0,25,0,-25
15676,1,1,329,1207,878
15677,1,1,375,1716,1341
15678,1,0,34,0,-34
15679,0,0,172,0,-172
15680,1,1,1087,1250,163
15681,0,0,1,0,-1
15682,1,1,200,1736,1536
15683,0,0,96,0,-96
15684,0,0,19,0,-19
15685,1,1,106,1364,1258
15686,1,0,39,0,-39
15687,0,0,31,0,-31
15688,1,0,23,0,-23
15689,0,0,60,0,-60
15690,1,0,93,0,-93
15691,0,0,16,0,-16
15692,0,0,19,0,-19
15693,1,0,60,0,-60
15694,0,0,10,0,-10
15695,1,0,17,0,-17
15696,1,1,277,5167,4890
15697,1,0,15,0,-15
15698,1,0,4,0,-4
15699,1,1,163,1400,1237
15700,1,1,439,1873,1434
15701,1,1,562,1289,727
15702,1,1,765,1274,509
15703,1,0,80,0,-80
15704,1,0,14,0,-14
15705,1,1,504,3847,3343
15706,1,1,233,1506,1273
15707,1,1,105,2347,2242
15708,1,1,484,1287,803
15709,1,1,771,1670,899
15710,1,0,36,0,-36
15711,1,1,92,2671,2579
15712,0,0,12,0,-12
15713,0,0,47,0,-47
15714,1,1,391,1503,1112
15715,1,1,126,1895,1769
15716,1,1,699,1509,810
15717,1,1,34,2678,2644
15718,0,0,3,0,-3
15719,0,0,46,0,-46
15720,1,0,44,0,-44
15721,0,0,11,0,-11
15722,0,0,127,0,-127
15723,0,0,148,0,-148
15724,0,0,31,0,-31
15725,1,0,39,0,-39
15726,1,1,289,1544,1255
15727,0,0,33,0,-33
15728,1,1,660,1460,800
15729,0,0,110,0,-110
15730,1,1,241,2009,1768
15731,1,0,35,0,-35
15732,1,1,1597,1207,-390
15733,1,1,18,1579,1561
15734,1,1,1559,1660,101
15735,1,0,62,0,-62
15736,1,1,182,1313,1131
15737,0,0,4,0,-4
15738,1,1,363,1892,1529
15739,0,0,1,0,-1
15740,1,1,44,1903,1859
15741,1,1,2373,1264,-1109
15742,1,1,108,1967,1859
15743,0,0,97,0,-97
15744,1,0,40,0,-40
15745,0,0,5,0,-5
15746,1,0,15,0,-15
15747,1,0,2,0,-2
15748,0,0,55,0,-55
15749,1,1,1485,1756,271
15750,1,1,508,1402,894
15751,1,0,0,0,0
15752,1,0,15,0,-15
15753,1,0,11,0,-11
15754,1,0,83,0,-83
15755,0,0,149,0,-149
15756,0,0,24,0,-24
15757,1,0,14,0,-14
15758,0,0,49,0,-49
15759,0,0,14,0,-14
15760,1,1,287,1264,977
15761,1,1,2793,1606,-1187
15762,1,0,4,0,-4
15763,0,0,78,0,-78
15764,0,0,202,0,-202
15765,1,1,162,1294,1132
15766,0,0,141,0,-141
15767,1,1,566,1653,1087
15768,1,1,131,1715,1584
15769,1,0,13,0,-13
15770,1,0,46,0,-46
15771,1,0,23,0,-23
15772,0,0,24,0,-24
15773,0,0,37,0,-37
15774,1,0,122,0,-122
15775,1,1,1074,1521,447
15776,1,0,18,0,-18
15777,0,0,75,0,-75
15778,1,0,25,0,-25
15779,1,0,195,0,-195
15780,1,1,256,1409,1153
15781,0,0,19,0,-19
15782,0,0,26,0,-26
15783,0,0,28,0,-28
15784,0,0,10,0,-10
15785,0,0,64,0,-64
15786,1,1,1197,1490,293
15787,1,0,33,0,-33
15788,1,0,270,0,-270
15789,1,1,154,1326,1172
15790,1,1,528,1481,953
15791,0,0,17,0,-17
15792,1,1,737,1284,547
15793,1,0,166,0,-166
15794,1,1,901,1312,411
15795,0,0,35,0,-35
15796,0,0,144,0,-144
15797,1,1,293,1246,953
15798,1,0,36,0,-36
15799,1,0,10,0,-10
15800,0,0,80,0,-80
15801,0,0,72,0,-72
15802,1,0,28,0,-28
15803,0,0,54,0,-54
15804,0,0,0,0,0
15805,0,0,27,0,-27
15806,0,0,45,0,-45
15807,1,0,45,0,-45
15808,1,1,231,1445,1214
15809,1,0,44,0,-44
15810,1,0,30,0,-30
15811,1,1,1235,1387,152
15812,1,1,268,1369,1101
15813,1,1,34,1200,1166
15814,1,0,14,0,-14
15815,1,0,48,0,-48
15816,1,1,55,1945,1890
15817,1,1,21,1581,1560
15818,0,0,19,0,-19
15819,0,0,29,0,-29
15820,1,1,345,1381,1036
15821,0,0,93,0,-93
15822,1,0,13,0,-13
15823,0,0,6,0,-6
15824,1,0,46,0,-46
15825,1,0,5,0,-5
15826,1,0,18,0,-18
15827,0,0,25,0,-25
15828,1,0,4,0,-4
15829,0,0,31,0,-31
15830,0,0,63,0,-63
15831,1,0,108,0,-108
15832,1,0,62,0,-62
15833,1,0,19,0,-19
15834,1,1,1441,1450,9
15835,0,0,78,0,-78
15836,0,0,32,0,-32
15837,0,0,20,0,-20
15838,0,0,63,0,-63
15839,1,1,829,1362,533
15840,1,1,1111,1215,104
15841,1,0,16,0,-16
15842,1,0,34,0,-34
15843,1,0,2,0,-2
15844,0,0,3,0,-3
15845,1,0,77,0,-77
15846,0,0,80,0,-80
15847,1,1,618,1203,585
15848,1,0,70,0,-70
15849,1,1,174,1678,1504
15850,1,0,9,0,-9
15851,1,0,24,0,-24
15852,1,0,25,0,-25
15853,1,0,7,0,-7
15854,1,0,16,0,-16
15855,1,1,1198,1215,17
15856,0,0,18,0,-18
15857,0,0,109,0,-109
15858,1,0,39,0,-39
15859,1,1,80,1259,1179
15860,1,0,114,0,-114
15861,0,0,74,0,-74
15862,1,1,277,1481,1204
15863,0,0,214,0,-214
15864,1,1,122,1324,1202
15865,1,1,327,1325,998
15866,1,0,90,0,-90
15867,0,0,13,0,-13
15868,0,0,24,0,-24
15869,1,0,159,0,-159
15870,0,0,4,0,-4
15871,0,0,16,0,-16
15872,1,1,172,1885,1713
15873,1,0,60,0,-60
15874,1,0,16,0,-16
15875,1,1,889,1204,315
15876,1,1,267,1403,1136
15877,1,0,1,0,-1
15878,1,0,44,0,-44
15879,1,0,56,0,-56
15880,1,1,139,1212,1073
15881,0,0,22,0,-22
15882,0,0,11,0,-11
15883,0,0,3,0,-3
15884,0,0,25,0,-25
15885,1,1,1539,1515,-24
15886,1,1,47,1337,1290
15887,1,0,23,0,-23
15888,1,0,37,0,-37
15889,1,0,75,0,-75
15890,0,0,18,0,-18
15891,1,1,112,1297,1185
15892,1,0,32,0,-32
15893,1,1,816,1949,1133
15894,0,0,52,0,-52
15895,1,1,78,1203,1125
15896,1,0,25,0,-25
15897,1,0,30,0,-30
15898,0,0,96,0,-96
15899,0,0,7,0,-7
15900,0,0,5,0,-5
15901,0,0,64,0,-64
15902,0,0,11,0,-11
15903,1,1,719,1359,640
15904,1,1,939,1724,785
15905,0,0,28,0,-28
15906,1,0,59,0,-59
15907,0,0,173,0,-173
15908,1,1,1533,1306,-227
15909,0,0,39,0,-39
15910,0,0,62,0,-62
15911,1,0,26,0,-26
15912,0,0,61,0,-61
15913,1,0,97,0,-97
15914,1,1,1371,1322,-49
15915,1,0,5,0,-5
15916,0,0,2,0,-2
15917,1,1,153,1329,1176
15918,1,1,98,1907,1809
15919,0,0,17,0,-17
15920,1,1,377,1284,907
15921,1,0,1,0,-1
15922,0,0,40,0,-40
15923,1,0,44,0,-44
15924,1,0,3,0,-3
15925,0,0,10,0,-10
15926,0,0,41,0,-41
15927,0,0,0,0,0
15928,1,1,227,1943,1716
15929,0,0,7,0,-7
15930,1,0,11,0,-11
15931,0,0,54,0,-54
15932,0,0,163,0,-163
15933,1,0,6,0,-6
15934,0,0,42,0,-42
15935,1,1,486,1298,812
15936,0,0,9,0,-9
15937,0,0,55,0,-55
15938,1,1,72,1601,1529
15939,0,0,76,0,-76
15940,0,0,65,0,-65
15941,0,0,259,0,-259
15942,0,0,31,0,-31
15943,0,0,107,0,-107
15944,0,0,0,0,0
15945,1,0,26,0,-26
15946,1,1,966,1306,340
15947,0,0,20,0,-20
15948,1,1,881,1594,713
15949,1,1,1276,2512,1236
15950,1,1,1236,2610,1374
15951,0,0,73,0,-73
15952,0,0,5,0,-5
15953,1,0,26,0,-26
15954,1,1,657,1332,675
15955,0,0,45,0,-45
15956,1,1,397,1412,1015
15957,1,1,1329,1237,-92
15958,1,0,27,0,-27
15959,0,0,7,0,-7
15960,1,0,42,0,-42
15961,1,0,87,0,-87
15962,0,0,2,0,-2
15963,1,1,313,1509,1196
15964,0,0,163,0,-163
15965,1,0,58,0,-58
15966,0,0,33,0,-33
15967,1,0,75,0,-75
15968,0,0,31,0,-31
15969,1,0,4,0,-4
15970,1,0,186,0,-186
15971,1,1,216,1807,1591
15972,1,1,41,1316,1275
15973,0,0,32,0,-32
15974,0,0,29,0,-29
15975,1,1,123,1293,1170
15976,0,0,48,0,-48
15977,1,0,46,0,-46
15978,1,0,18,0,-18
15979,1,0,109,0,-109
15980,1,1,230,1203,973
15981,1,0,16,0,-16
15982,1,1,281,1272,991
15983,1,0,8,0,-8
15984,1,0,19,0,-19
15985,0,0,95,0,-95
15986,0,0,245,0,-245
15987,1,1,43,1728,1685
15988,0,0,117,0,-117
15989,0,0,5,0,-5
15990,1,1,2815,1227,-1588
15991,1,1,408,1223,815
15992,1,0,15,0,-15
15993,1,1,450,2219,1769
15994,1,0,23,0,-23
15995,1,1,366,1435,1069
15996,1,0,208,0,-208
15997,1,1,1369,1434,65
15998,1,1,48,1429,1381
15999,0,0,4,0,-4
16000,1,1,201,1720,1519
16001,0,0,0,0,0
16002,0,0,22,0,-22
16003,1,0,27,0,-27
16004,0,0,21,0,-21
16005,1,0,33,0,-33
16006,0,0,43,0,-43
16007,1,0,89,0,-89
16008,1,0,9,0,-9
16009,1,1,931,1446,515
16010,1,1,68,4554,4486
16011,1,1,190,1220,1030
16012,1,0,22,0,-22
16013,1,0,5,0,-5
16014,0,0,18,0,-18
16015,1,1,629,1214,585
16016,1,0,18,0,-18
16017,1,1,483,1356,873
16018,1,1,544,1503,959
16019,1,0,31,0,-31
16020,0,0,23,0,-23
16021,1,1,465,2127,1662
16022,0,0,33,0,-33
16023,1,1,240,1417,1177
16024,0,0,14,0,-14
16025,0,0,17,0,-17
16026,1,1,445,1557,1112
16027,1,0,54,0,-54
16028,1,0,15,0,-15
16029,0,0,32,0,-32
16030,0,0,30,0,-30
16031,1,0,17,0,-17
16032,1,1,116,1384,1268
16033,0,0,29,0,-29
16034,1,1,618,1202,584
16035,0,0,37,0,-37
16036,1,1,926,1224,298
16037,0,0,26,0,-26
16038,1,0,39,0,-39
16039,1,0,108,0,-108
16040,1,0,92,0,-92
16041,1,1,363,2971,2608
16042,1,0,13,0,-13
16043,0,0,13,0,-13
16044,1,0,18,0,-18
16045,0,0,0,0,0
16046,1,1,703,2080,1377
16047,1,1,322,1216,894
16048,0,0,5,0,-5
16049,0,0,27,0,-27
16050,1,1,417,1223,806
16051,1,1,488,1751,1263
16052,1,1,103,1449,1346
16053,1,1,137,1250,1113
16054,1,0,97,0,-97
16055,0,0,5,0,-5
16056,1,1,604,1468,864
16057,1,0,29,0,-29
16058,0,0,28,0,-28
16059,1,0,121,0,-121
16060,1,1,1129,1331,202
16061,1,0,3,0,-3
16062,1,0,58,0,-58
16063,0,0,6,0,-6
16064,1,1,981,1530,549
16065,1,1,189,1834,1645
16066,1,0,1,0,-1
16067,0,0,21,0,-21
16068,1,0,21,0,-21
16069,1,1,355,1613,1258
16070,1,0,34,0,-34
16071,1,1,59,1508,1449
16072,0,0,45,0,-45
16073,1,0,60,0,-60
16074,1,0,3,0,-3
16075,0,0,119,0,-119
16076,1,1,87,1561,1474
16077,0,0,111,0,-111
16078,1,1,42,1444,1402
16079,0,0,1,0,-1
16080,1,0,20,0,-20
16081,0,0,121,0,-121
16082,0,0,68,0,-68
16083,0,0,13,0,-13
16084,1,1,756,1860,1104
16085,1,0,18,0,-18
16086,0,0,100,0,-100
16087,1,1,489,2326,1837
16088,1,0,63,0,-63
16089,1,0,3,0,-3
16090,0,0,145,0,-145
16091,0,0,3,0,-3
16092,1,1,2114,2311,197
16093,1,1,661,1203,542
16094,0,0,15,0,-15
16095,1,1,573,1584,1011
16096,1,0,8,0,-8
16097,1,1,1081,1672,591
16098,0,0,14,0,-14
16099,0,0,64,0,-64
16100,0,0,43,0,-43
16101,0,0,78,0,-78
16102,1,1,436,1517,1081
16103,0,0,45,0,-45
16104,0,0,3,0,-3
16105,1,0,64,0,-64
16106,1,0,7,0,-7
16107,1,1,755,1216,461
16108,1,1,1943,1489,-454
16109,0,0,79,0,-79
16110,1,0,46,0,-46
16111,1,1,607,1401,794
16112,0,0,124,0,-124
16113,0,0,20,0,-20
16114,0,0,199,0,-199
16115,0,0,56,0,-56
16116,1,0,258,0,-258
16117,1,1,171,1448,1277
16118,1,1,285,1392,1107
16119,0,0,36,0,-36
16120,1,0,34,0,-34
16121,0,0,4,0,-4
16122,1,0,37,0,-37
16123,1,0,16,0,-16
16124,0,0,14,0,-14
16125,1,1,333,1728,1395
16126,1,0,6,0,-6
16127,0,0,16,0,-16
16128,1,0,19,0,-19
16129,0,0,64,0,-64
16130,0,0,3,0,-3
16131,0,0,3,0,-3
16132,0,0,32,0,-32
16133,0,0,24,0,-24
16134,1,1,233,1289,1056
16135,1,1,92,1276,1184
16136,0,0,119,0,-119
16137,1,0,16,0,-16
16138,1,0,35,0,-35
16139,0,0,69,0,-69
16140,1,1,551,1321,770
16141,0,0,15,0,-15
16142,1,1,424,1267,843
16143,1,0,70,0,-70
16144,1,1,443,1452,1009
16145,1,1,194,1220,1026
16146,1,0,27,0,-27
16147,0,0,199,0,-199
16148,0,0,27,0,-27
16149,0,0,56,0,-56
16150,1,1,1009,2384,1375
16151,1,0,0,0,0
16152,1,0,28,0,-28
16153,0,0,1,0,-1
16154,0,0,21,0,-21
16155,1,1,647,1257,610
16156,0,0,197,0,-197
16157,1,1,199,1362,1163
16158,0,0,52,0,-52
16159,0,0,52,0,-52
16160,0,0,71,0,-71
16161,0,0,201,0,-201
16162,0,0,105,0,-105
16163,0,0,9,0,-9
16164,0,0,75,0,-75
16165,1,0,47,0,-47
16166,1,1,2254,1308,-946
16167,1,0,140,0,-140
16168,0,0,24,0,-24
16169,0,0,85,0,-85
16170,0,0,26,0,-26
16171,0,0,32,0,-32
16172,0,0,12,0,-12
16173,1,0,14,0,-14
16174,1,1,323,1300,977
16175,1,1,346,2161,1815
16176,0,0,100,0,-100
16177,0,0,66,0,-66
16178,0,0,33,0,-33
16179,1,0,41,0,-41
16180,1,0,25,0,-25
16181,1,1,1787,1996,209
16182,0,0,48,0,-48
16183,0,0,130,0,-130
16184,1,0,14,0,-14
16185,1,0,16,0,-16
16186,0,0,8,0,-8
16187,1,0,31,0,-31
16188,0,0,5,0,-5
16189,1,1,501,1420,919
16190,1,1,362,1210,848
16191,1,1,637,1837,1200
16192,1,1,268,3040,2772
16193,0,0,17,0,-17
16194,1,1,779,1662,883
16195,1,1,270,1698,1428
16196,1,1,983,1352,369
16197,1,1,347,1455,1108
16198,0,0,139,0,-139
16199,0,0,1,0,-1
16200,1,1,277,1246,969
16201,0,0,46,0,-46
16202,0,0,0,0,0
16203,1,1,137,2488,2351
16204,1,1,361,1527,1166
16205,0,0,47,0,-47
16206,1,0,42,0,-42
16207,0,0,40,0,-40
16208,1,1,131,1297,1166
16209,0,0,32,0,-32
16210,1,1,3713,1207,-2506
16211,1,0,69,0,-69
16212,1,1,1265,4653,3388
16213,1,0,18,0,-18
16214,1,1,160,1613,1453
16215,1,0,94,0,-94
16216,1,1,37,1362,1325
16217,1,1,557,1458,901
16218,1,0,8,0,-8
16219,1,0,4,0,-4
16220,1,0,41,0,-41
16221,0,0,12,0,-12
16222,1,1,193,2773,2580
16223,0,0,30,0,-30
16224,0,0,41,0,-41
16225,1,0,21,0,-21
16226,0,0,208,0,-208
16227,0,0,80,0,-80
16228,1,0,18,0,-18
16229,0,0,6,0,-6
16230,1,0,83,0,-83
16231,0,0,68,0,-68
16232,1,0,181,0,-181
16233,1,1,171,1218,1047
16234,0,0,76,0,-76
16235,0,0,90,0,-90
16236,1,1,985,1391,406
16237,1,1,51,1489,1438
16238,0,0,27,0,-27
16239,1,0,162,0,-162
16240,1,1,967,1227,260
16241,1,1,3283,1475,-1808
16242,0,0,7,0,-7
16243,1,0,166,0,-166
16244,0,0,33,0,-33
16245,1,1,320,1301,981
16246,0,0,11,0,-11
16247,1,1,362,1412,1050
16248,1,0,24,0,-24
16249,1,1,247,1277,1030
16250,0,0,23,0,-23
16251,1,0,51,0,-51
16252,1,1,822,1211,389
16253,1,0,0,0,0
16254,0,0,3,0,-3
16255,0,0,46,0,-46
16256,1,0,67,0,-67
16257,1,1,511,2335,1824
16258,0,0,26,0,-26
16259,1,0,17,0,-17
16260,1,0,37,0,-37
16261,1,1,342,1287,945
16262,1,1,202,1348,1146
16263,1,0,24,0,-24
16264,1,1,396,1287,891
16265,0,0,32,0,-32
16266,1,1,886,1624,738
16267,0,0,30,0,-30
16268,0,0,13,0,-13
16269,1,1,849,1289,440
16270,0,0,18,0,-18
16271,1,1,128,1326,1198
16272,1,1,1819,1214,-605
16273,1,1,1447,1251,-196
16274,1,1,308,1319,1011
16275,0,0,5,0,-5
16276,1,1,646,1660,1014
16277,1,1,462,1661,1199
16278,1,1,110,1236,1126
16279,0,0,75,0,-75
16280,0,0,2,0,-2
16281,0,0,20,0,-20
16282,1,0,60,0,-60
16283,0,0,107,0,-107
16284,1,0,82,0,-82
16285,1,1,598,1304,706
16286,1,0,20,0,-20
16287,1,0,31,0,-31
16288,1,1,980,1338,358
16289,1,0,53,0,-53
16290,1,1,280,1425,1145
16291,0,0,17,0,-17
16292,0,0,23,0,-23
16293,0,0,50,0,-50
16294,1,0,14,0,-14
16295,0,0,4,0,-4
16296,0,0,154,0,-154
16297,1,0,117,0,-117
16298,1,0,9,0,-9
16299,1,1,1173,1624,451
16300,1,0,32,0,-32
16301,1,0,49,0,-49
16302,1,0,13,0,-13
16303,1,0,17,0,-17
16304,0,0,10,0,-10
16305,0,0,12,0,-12
16306,0,0,7,0,-7
16307,0,0,36,0,-36
16308,0,0,16,0,-16
16309,0,0,27,0,-27
16310,1,0,38,0,-38
16311,0,0,208,0,-208
16312,1,1,250,1311,1061
16313,0,0,91,0,-91
16314,1,1,105,1748,1643
16315,1,0,11,0,-11
16316,1,0,106,0,-106
16317,1,1,134,1840,1706
16318,1,1,1436,1316,-120
16319,0,0,50,0,-50
16320,0,0,15,0,-15
16321,0,0,29,0,-29
16322,1,0,16,0,-16
16323,0,0,84,0,-84
16324,1,1,152,1894,1742
16325,1,0,0,0,0
16326,0,0,1,0,-1
16327,0,0,30,0,-30
16328,1,1,1166,1907,741
16329,1,0,73,0,-73
16330,0,0,81,0,-81
16331,0,0,51,0,-51
16332,1,0,25,0,-25
16333,1,0,23,0,-23
16334,0,0,31,0,-31
16335,1,0,22,0,-22
16336,1,0,25,0,-25
16337,1,1,192,1325,1133
16338,0,0,67,0,-67
16339,0,0,36,0,-36
16340,0,0,13,0,-13
16341,1,0,0,0,0
16342,1,1,53,1733,1680
16343,1,1,1080,3045,1965
16344,1,0,147,0,-147
16345,1,0,39,0,-39
16346,0,0,20,0,-20
16347,0,0,131,0,-131
16348,1,0,52,0,-52
16349,1,0,3,0,-3
16350,0,0,69,0,-69
16351,1,0,3,0,-3
16352,1,0,7,0,-7
16353,1,0,7,0,-7
16354,1,0,8,0,-8
16355,1,1,914,2297,1383
16356,1,1,119,1267,1148
16357,1,1,348,2127,1779
16358,1,0,82,0,-82
16359,0,0,63,0,-63
16360,1,1,414,1259,845
16361,1,1,289,1769,1480
16362,1,1,372,1563,1191
16363,1,0,105,0,-105
16364,1,1,327,1211,884
16365,0,0,41,0,-41
16366,0,0,78,0,-78
16367,0,0,16,0,-16
16368,0,0,44,0,-44
16369,1,1,374,1369,995
16370,1,0,59,0,-59
16371,1,0,93,0,-93
16372,0,0,15,0,-15
16373,1,0,16,0,-16
16374,1,0,24,0,-24
16375,1,0,57,0,-57
16376,1,0,77,0,-77
16377,1,1,220,1500,1280
16378,1,1,325,1806,1481
16379,0,0,1,0,-1
16380,0,0,91,0,-91
16381,0,0,51,0,-51
16382,1,0,5,0,-5
16383,1,0,26,0,-26
16384,1,0,10,0,-10
16385,1,0,28,0,-28
16386,0,0,205,0,-205
16387,0,0,133,0,-133
16388,1,1,871,1233,362
16389,1,0,11,0,-11
16390,1,1,199,2308,2109
16391,1,1,394,2518,2124
16392,1,1,1612,3250,1638
16393,1,0,27,0,-27
16394,1,0,84,0,-84
16395,1,0,9,0,-9
16396,1,1,1282,1232,-50
16397,1,1,116,1467,1351
16398,1,0,123,0,-123
16399,0,0,0,0,0
16400,1,0,7,0,-7
16401,0,0,33,0,-33
16402,0,0,25,0,-25
16403,1,0,32,0,-32
16404,0,0,51,0,-51
16405,1,1,191,1402,1211
16406,1,0,15,0,-15
16407,1,1,606,1559,953
16408,1,0,116,0,-116
16409,1,1,96,1413,1317
16410,1,0,40,0,-40
16411,1,0,64,0,-64
16412,1,0,22,0,-22
16413,1,0,98,0,-98
16414,1,0,15,0,-15
16415,1,1,330,1271,941
16416,0,0,66,0,-66
16417,1,1,816,1771,955
16418,0,0,68,0,-68
16419,1,1,686,1219,533
16420,1,1,209,1406,1197
16421,0,0,45,0,-45
16422,0,0,51,0,-51
16423,1,1,364,1222,858
16424,0,0,19,0,-19
16425,1,1,295,1465,1170
16426,1,0,25,0,-25
16427,0,0,158,0,-158
16428,1,1,607,1576,969
16429,1,0,39,0,-39
16430,1,0,25,0,-25
16431,1,1,1175,1431,256
16432,1,1,138,1211,1073
16433,1,0,57,0,-57
16434,0,0,110,0,-110
16435,1,0,9,0,-9
16436,1,0,26,0,-26
16437,0,0,27,0,-27
16438,0,0,3,0,-3
16439,1,0,42,0,-42
16440,1,1,198,1717,1519
16441,1,1,104,2279,2175
16442,0,0,40,0,-40
16443,1,0,54,0,-54
16444,0,0,26,0,-26
16445,0,0,2,0,-2
16446,1,0,87,0,-87
16447,1,0,169,0,-169
16448,1,0,3,0,-3
16449,1,0,197,0,-197
16450,1,0,1,0,-1
16451,1,0,69,0,-69
16452,0,0,15,0,-15
16453,1,1,1107,1291,184
16454,1,0,91,0,-91
16455,0,0,98,0,-98
16456,0,0,82,0,-82
16457,1,1,653,1678,1025
16458,1,1,34,1710,1676
16459,1,1,241,1340,1099
16460,1,1,116,1994,1878
16461,0,0,2,0,-2
16462,1,0,57,0,-57
16463,0,0,11,0,-11
16464,1,1,558,2632,2074
16465,1,1,130,1630,1500
16466,0,0,66,0,-66
16467,1,1,1025,1405,380
16468,1,0,169,0,-169
16469,1,1,333,1302,969
16470,1,1,181,1460,1279
16471,1,1,70,1496,1426
16472,0,0,22,0,-22
16473,1,0,25,0,-25
16474,0,0,83,0,-83
16475,1,1,457,1457,1000
16476,1,0,9,0,-9
16477,0,0,9,0,-9
16478,1,1,290,1593,1303
16479,1,0,57,0,-57
16480,0,0,16,0,-16
16481,1,0,39,0,-39
16482,1,1,391,2278,1887
16483,0,0,21,0,-21
16484,1,0,46,0,-46
16485,0,0,39,0,-39
16486,1,1,183,1262,1079
16487,1,0,76,0,-76
16488,1,0,156,0,-156
16489,1,1,58,1691,1633
16490,0,0,246,0,-246
16491,1,1,106,1329,1223
16492,1,0,37,0,-37
16493,1,0,281,0,-281
16494,1,1,89,1347,1258
16495,1,1,235,6671,6436
16496,1,1,311,1379,1068
16497,1,1,132,1448,1316
16498,0,0,7,0,-7
16499,0,0,3,0,-3
16500,1,1,1848,2918,1070
16501,1,1,364,1417,1053
16502,0,0,178,0,-178
16503,0,0,41,0,-41
16504,1,1,66,1307,1241
16505,1,0,21,0,-21
16506,1,1,29,1623,1594
16507,0,0,26,0,-26
16508,1,1,597,1535,938
16509,0,0,104,0,-104
16510,1,1,540,1231,691
16511,1,0,29,0,-29
16512,0,0,35,0,-35
16513,0,0,29,0,-29
16514,0,0,132,0,-132
16515,1,1,920,1313,393
16516,0,0,160,0,-160
16517,1,1,206,1264,1058
16518,1,1,68,1248,1180
16519,1,1,449,2049,1600
16520,0,0,28,0,-28
16521,1,0,104,0,-104
16522,1,0,44,0,-44
16523,0,0,100,0,-100
16524,1,1,564,1282,718
16525,1,1,779,1367,588
16526,0,0,116,0,-116
16527,0,0,9,0,-9
16528,1,1,240,1325,1085
16529,0,0,13,0,-13
16530,0,0,16,0,-16
16531,1,1,130,1390,1260
16532,0,0,102,0,-102
16533,1,1,150,1356,1206
16534,0,0,33,0,-33
16535,1,0,49,0,-49
16536,1,0,33,0,-33
16537,1,0,38,0,-38
16538,0,0,34,0,-34
16539,1,1,615,1975,1360
16540,1,1,246,2280,2034
16541,0,0,0,0,0
16542,1,1,241,1425,1184
16543,1,1,83,2610,2527
16544,0,0,177,0,-177
16545,1,0,32,0,-32
16546,0,0,286,0,-286
16547,1,1,801,1851,1050
16548,0,0,2,0,-2
16549,1,0,5,0,-5
16550,0,0,18,0,-18
16551,1,1,2253,1404,-849
16552,1,0,20,0,-20
16553,0,0,273,0,-273
16554,1,0,28,0,-28
16555,1,1,302,2960,2658
16556,1,0,65,0,-65
16557,1,1,1403,1311,-92
16558,1,0,355,0,-355
16559,1,1,286,1753,1467
16560,0,0,14,0,-14
16561,1,1,414,1767,1353
16562,0,0,97,0,-97
16563,1,0,8,0,-8
16564,1,1,126,2914,2788
16565,1,1,48,1381,1333
16566,0,0,49,0,-49
16567,1,1,172,1371,1199
16568,1,0,43,0,-43
16569,1,1,237,2375,2138
16570,0,0,9,0,-9
16571,1,0,88,0,-88
16572,0,0,65,0,-65
16573,0,0,74,0,-74
16574,1,0,27,0,-27
16575,1,1,291,1429,1138
16576,1,0,19,0,-19
16577,1,1,239,1453,1214
16578,0,0,40,0,-40
16579,1,1,460,1431,971
16580,0,0,158,0,-158
16581,1,1,346,1434,1088
16582,1,1,1908,1461,-447
16583,1,1,250,1435,1185
16584,1,0,46,0,-46
16585,0,0,30,0,-30
16586,1,1,84,1802,1718
16587,0,0,74,0,-74
16588,1,0,22,0,-22
16589,1,1,1686,1350,-336
16590,1,0,47,0,-47
16591,0,0,2,0,-2
16592,1,1,574,2462,1888
16593,1,0,69,0,-69
16594,0,0,65,0,-65
16595,0,0,27,0,-27
16596,1,1,493,1204,711
16597,0,0,29,0,-29
16598,1,1,83,1356,1273
16599,1,0,195,0,-195
16600,1,0,17,0,-17
16601,1,1,126,1284,1158
16602,0,0,121,0,-121
16603,0,0,6,0,-6
16604,1,1,501,2012,1511
16605,0,0,1,0,-1
16606,0,0,4,0,-4
16607,1,0,1,0,-1
16608,1,1,684,2272,1588
16609,1,1,710,1950,1240
16610,1,1,756,1611,855
16611,1,0,4,0,-4
16612,0,0,77,0,-77
16613,0,0,0,0,0
16614,0,0,39,0,-39
16615,1,1,1346,1718,372
16616,0,0,46,0,-46
16617,1,0,42,0,-42
16618,1,1,460,2180,1720
16619,1,0,87,0,-87
16620,0,0,8,0,-8
16621,1,1,1658,3869,2211
16622,1,0,17,0,-17
16623,0,0,134,0,-134
16624,1,1,293,1274,981
16625,0,0,15,0,-15
16626,0,0,119,0,-119
16627,1,1,920,1475,555
16628,1,0,5,0,-5
16629,0,0,216,0,-216
16630,1,1,521,1368,847
16631,1,0,23,0,-23
16632,0,0,11,0,-11
16633,1,0,35,0,-35
16634,0,0,46,0,-46
16635,1,0,52,0,-52
16636,1,0,6,0,-6
16637,0,0,107,0,-107
16638,1,0,5,0,-5
16639,1,0,50,0,-50
16640,0,0,10,0,-10
16641,0,0,12,0,-12
16642,1,1,267,1525,1258
16643,0,0,217,0,-217
16644,1,1,184,2934,2750
16645,0,0,118,0,-118
16646,1,0,12,0,-12
16647,0,0,101,0,-101
16648,1,0,145,0,-145
16649,1,0,29,0,-29
16650,1,0,7,0,-7
16651,0,0,17,0,-17
16652,0,0,48,0,-48
16653,0,0,79,0,-79
16654,1,1,825,1361,536
16655,0,0,28,0,-28
16656,1,0,55,0,-55
16657,1,0,141,0,-141
16658,0,0,41,0,-41
16659,1,0,156,0,-156
16660,0,0,84,0,-84
16661,1,1,35,1473,1438
16662,1,0,38,0,-38
16663,1,1,58,1431,1373
16664,1,1,402,2552,2150
16665,0,0,107,0,-107
16666,1,0,25,0,-25
16667,0,0,13,0,-13
16668,0,0,47,0,-47
16669,1,1,245,1292,1047
16670,1,0,7,0,-7
16671,1,0,5,0,-5
16672,0,0,98,0,-98
16673,1,1,264,1536,1272
16674,0,0,1,0,-1
16675,0,0,80,0,-80
16676,0,0,6,0,-6
16677,0,0,19,0,-19
16678,0,0,20,0,-20
16679,0,0,57,0,-57
16680,1,0,78,0,-78
16681,1,0,29,0,-29
16682,0,0,44,0,-44
16683,0,0,69,0,-69
16684,0,0,287,0,-287
16685,0,0,14,0,-14
16686,0,0,5,0,-5
16687,1,1,224,1329,1105
16688,0,0,30,0,-30
16689,1,0,97,0,-97
16690,1,0,55,0,-55
16691,0,0,53,0,-53
16692,0,0,40,0,-40
16693,0,0,345,0,-345
16694,1,1,205,1567,1362
16695,0,0,19,0,-19
16696,0,0,84,0,-84
16697,1,0,6,0,-6
16698,1,1,1000,1289,289
16699,1,1,261,1548,1287
16700,0,0,7,0,-7
16701,1,1,74,1345,1271
16702,0,0,45,0,-45
16703,1,0,124,0,-124
16704,0,0,37,0,-37
16705,0,0,15,0,-15
16706,1,0,39,0,-39
16707,0,0,10,0,-10
16708,0,0,1,0,-1
16709,1,0,177,0,-177
16710,0,0,37,0,-37
16711,1,1,757,1990,1233
16712,0,0,37,0,-37
16713,1,0,16,0,-16
16714,1,1,689,1347,658
16715,1,1,158,1365,1207
16716,0,0,38,0,-38
16717,1,0,60,0,-60
16718,1,1,223,1273,1050
16719,0,0,113,0,-113
16720,1,0,8,0,-8
16721,0,0,39,0,-39
16722,0,0,6,0,-6
16723,0,0,41,0,-41
16724,0,0,29,0,-29
16725,1,0,86,0,-86
16726,0,0,5,0,-5
16727,0,0,47,0,-47
16728,0,0,6,0,-6
16729,1,1,588,1597,1009
16730,0,0,66,0,-66
16731,1,0,23,0,-23
16732,0,0,120,0,-120
16733,0,0,23,0,-23
16734,1,0,14,0,-14
16735,1,0,20,0,-20
16736,1,0,12,0,-12
16737,1,0,5,0,-5
16738,1,0,24,0,-24
16739,0,0,79,0,-79
16740,1,1,301,1245,944
16741,0,0,17,0,-17
16742,1,1,824,1504,680
16743,1,1,430,1527,1097
16744,1,1,185,1762,1577
16745,1,0,27,0,-27
16746,0,0,22,0,-22
16747,0,0,51,0,-51
16748,1,1,508,1215,707
16749,1,0,22,0,-22
16750,1,0,1,0,-1
16751,1,0,6,0,-6
16752,0,0,118,0,-118
16753,1,1,1851,1304,-547
16754,1,0,82,0,-82
16755,0,0,21,0,-21
16756,1,1,211,1418,1207
16757,1,0,0,0,0
16758,1,0,7,0,-7
16759,1,1,497,1688,1191
16760,0,0,97,0,-97
16761,1,1,677,1297,620
16762,1,1,1825,1307,-518
16763,1,1,392,2304,1912
16764,1,1,556,1350,794
16765,1,0,40,0,-40
16766,0,0,18,0,-18
16767,0,0,53,0,-53
16768,1,1,147,1957,1810
16769,0,0,68,0,-68
16770,1,1,403,2266,1863
16771,1,1,400,1990,1590
16772,1,0,8,0,-8
16773,1,1,363,2193,1830
16774,0,0,13,0,-13
16775,1,0,24,0,-24
16776,1,0,29,0,-29
16777,0,0,1,0,-1
16778,1,1,385,1598,1213
16779,0,0,78,0,-78
16780,0,0,75,0,-75
16781,1,0,82,0,-82
16782,1,1,279,2256,1977
16783,1,1,61,1612,1551
16784,1,1,1349,1635,286
16785,1,1,851,1405,554
16786,1,1,1194,1232,38
16787,1,0,26,0,-26
16788,0,0,0,0,0
16789,1,0,4,0,-4
16790,0,0,59,0,-59
16791,0,0,192,0,-192
16792,0,0,161,0,-161
16793,1,0,159,0,-159
16794,1,1,158,2075,1917
16795,0,0,55,0,-55
16796,1,1,248,1965,1717
16797,0,0,17,0,-17
16798,0,0,0,0,0
16799,1,1,244,1277,1033
16800,1,0,16,0,-16
16801,0,0,134,0,-134
16802,1,0,65,0,-65
16803,1,0,67,0,-67
16804,1,1,549,1418,869
16805,0,0,60,0,-60
16806,0,0,170,0,-170
16807,1,1,110,1319,1209
16808,1,1,883,2505,1622
16809,1,0,0,0,0
16810,0,0,10,0,-10
16811,0,0,43,0,-43
16812,1,0,58,0,-58
16813,0,0,56,0,-56
16814,1,0,3,0,-3
16815,1,0,30,0,-30
16816,1,1,152,1428,1276
16817,1,1,293,1278,985
16818,0,0,29,0,-29
16819,1,1,429,1567,1138
16820,1,1,457,1415,958
16821,0,0,75,0,-75
16822,1,0,32,0,-32
16823,1,0,48,0,-48
16824,1,1,193,1257,1064
16825,0,0,99,0,-99
16826,1,1,17,1768,1751
16827,1,0,139,0,-139
16828,1,1,487,2160,1673
16829,1,1,399,1564,1165
16830,0,0,47,0,-47
16831,1,1,678,1279,601
16832,0,0,104,0,-104
16833,1,1,990,1292,302
16834,0,0,168,0,-168
16835,0,0,19,0,-19
16836,0,0,33,0,-33
16837,1,0,39,0,-39
16838,1,1,835,1220,385
16839,1,1,1061,1800,739
16840,1,0,11,0,-11
16841,0,0,17,0,-17
16842,1,1,228,1334,1106
16843,0,0,121,0,-121
16844,0,0,6,0,-6
16845,0,0,36,0,-36
16846,1,0,65,0,-65
16847,1,0,34,0,-34
16848,1,1,309,1420,1111
16849,1,0,35,0,-35
16850,1,0,43,0,-43
16851,0,0,1,0,-1
16852,1,0,30,0,-30
16853,1,0,173,0,-173
16854,0,0,176,0,-176
16855,1,1,693,1253,560
16856,0,0,25,0,-25
16857,1,0,62,0,-62
16858,1,0,19,0,-19
16859,0,0,37,0,-37
16860,1,1,834,1781,947
16861,1,1,375,1269,894
16862,1,0,208,0,-208
16863,1,1,34,2097,2063
16864,0,0,38,0,-38
16865,1,1,1271,1301,30
16866,0,0,4,0,-4
16867,0,0,1,0,-1
16868,1,1,93,1299,1206
16869,1,1,118,1310,1192
16870,1,0,34,0,-34
16871,0,0,7,0,-7
16872,1,0,14,0,-14
16873,1,1,456,2303,1847
16874,0,0,25,0,-25
16875,0,0,125,0,-125
16876,0,0,28,0,-28
16877,1,0,107,0,-107
16878,0,0,31,0,-31
16879,0,0,19,0,-19
16880,1,0,58,0,-58
16881,1,0,101,0,-101
16882,1,1,394,1358,964
16883,0,0,22,0,-22
16884,0,0,28,0,-28
16885,0,0,22,0,-22
16886,1,0,98,0,-98
16887,0,0,56,0,-56
16888,1,0,75,0,-75
16889,0,0,5,0,-5
16890,0,0,27,0,-27
16891,1,1,117,1213,1096
16892,1,1,103,1235,1132
16893,0,0,114,0,-114
16894,0,0,66,0,-66
16895,1,1,149,2044,1895
16896,0,0,3,0,-3
16897,1,0,150,0,-150
16898,0,0,86,0,-86
16899,1,0,19,0,-19
16900,0,0,43,0,-43
16901,0,0,101,0,-101
16902,0,0,42,0,-42
16903,1,1,21,1822,1801
16904,0,0,24,0,-24
16905,0,0,34,0,-34
16906,1,1,329,1226,897
16907,0,0,47,0,-47
16908,1,0,100,0,-100
16909,1,0,95,0,-95
16910,0,0,25,0,-25
16911,0,0,32,0,-32
16912,0,0,54,0,-54
16913,1,1,58,2053,1995
16914,0,0,138,0,-138
16915,0,0,25,0,-25
16916,1,1,1060,1329,269
16917,1,0,10,0,-10
16918,0,0,54,0,-54
16919,0,0,7,0,-7
16920,0,0,11,0,-11
16921,1,1,141,1468,1327
16922,0,0,14,0,-14
16923,1,1,574,1457,883
16924,1,0,59,0,-59
16925,1,0,2,0,-2
16926,0,0,5,0,-5
16927,0,0,113,0,-113
16928,0,0,118,0,-118
16929,0,0,43,0,-43
16930,0,0,13,0,-13
16931,0,0,6,0,-6
16932,1,0,5,0,-5
16933,1,1,162,1782,1620
16934,1,1,202,1417,1215
16935,1,1,433,1308,875
16936,1,0,11,0,-11
16937,1,1,219,1209,990
16938,0,0,69,0,-69
16939,1,0,45,0,-45
16940,0,0,82,0,-82
16941,1,0,77,0,-77
16942,1,0,77,0,-77
16943,0,0,42,0,-42
16944,1,1,853,1404,551
16945,1,0,0,0,0
16946,1,1,705,1220,515
16947,1,0,1,0,-1
16948,1,0,119,0,-119
16949,0,0,9,0,-9
16950,1,0,23,0,-23
16951,1,0,20,0,-20
16952,1,0,64,0,-64
16953,0,0,74,0,-74
16954,1,1,65,1277,1212
16955,0,0,14,0,-14
16956,0,0,1,0,-1
16957,1,1,38,1395,1357
16958,1,0,0,0,0
16959,1,0,40,0,-40
16960,1,1,472,2650,2178
16961,1,0,39,0,-39
16962,1,1,1336,1275,-61
16963,0,0,67,0,-67
16964,0,0,4,0,-4
16965,1,0,7,0,-7
16966,1,0,44,0,-44
16967,1,1,2143,1518,-625
16968,0,0,14,0,-14
16969,0,0,30,0,-30
16970,0,0,37,0,-37
16971,0,0,44,0,-44
16972,0,0,14,0,-14
16973,1,0,104,0,-104
16974,1,0,6,0,-6
16975,0,0,18,0,-18
16976,1,0,8,0,-8
16977,1,1,1362,1431,69
16978,1,0,22,0,-22
16979,0,0,34,0,-34
16980,1,1,308,1310,1002
16981,0,0,22,0,-22
16982,0,0,32,0,-32
16983,0,0,55,0,-55
16984,1,1,779,1921,1142
16985,0,0,16,0,-16
16986,1,0,7,0,-7
16987,1,0,24,0,-24
16988,0,0,24,0,-24
16989,1,0,5,0,-5
16990,1,1,107,2412,2305
16991,0,0,3,0,-3
16992,1,0,46,0,-46
16993,0,0,5,0,-5
16994,1,0,116,0,-116
16995,1,0,2,0,-2
16996,0,0,43,0,-43
16997,0,0,37,0,-37
16998,1,0,16,0,-16
16999,1,0,32,0,-32
17000,1,1,452,1237,785
17001,1,0,13,0,-13
17002,1,1,168,1341,1173
17003,0,0,46,0,-46
17004,1,1,266,1593,1327
17005,0,0,24,0,-24
17006,1,0,24,0,-24
17007,1,1,1008,1201,193
17008,1,0,84,0,-84
17009,0,0,103,0,-103
17010,1,1,1484,1468,-16
17011,1,1,850,2808,1958
17012,1,0,10,0,-10
17013,1,1,280,2472,2192
17014,1,1,16,1812,1796
17015,0,0,17,0,-17
17016,1,1,138,1599,1461
17017,1,0,4,0,-4
17018,1,0,12,0,-12
17019,0,0,232,0,-232
17020,1,1,469,1224,755
17021,1,1,1509,1528,19
17022,1,0,0,0,0
17023,1,0,74,0,-74
17024,0,0,24,0,-24
17025,1,1,240,1264,1024
17026,0,0,41,0,-41
17027,0,0,22,0,-22
17028,0,0,50,0,-50
17029,1,0,59,0,-59
17030,0,0,25,0,-25
17031,0,0,108,0,-108
17032,1,1,78,2223,2145
17033,1,1,984,1497,513
17034,1,0,22,0,-22
17035,1,1,1327,1549,222
17036,1,0,86,0,-86
17037,0,0,67,0,-67
17038,0,0,5,0,-5
17039,1,1,105,1245,1140
17040,1,1,306,1598,1292
17041,1,0,124,0,-124
17042,1,1,1170,1576,406
17043,0,0,23,0,-23
17044,0,0,32,0,-32
17045,0,0,10,0,-10
17046,0,0,155,0,-155
17047,1,0,15,0,-15
17048,0,0,9,0,-9
17049,1,1,159,1520,1361
17050,0,0,27,0,-27
17051,1,0,14,0,-14
17052,0,0,0,0,0
17053,0,0,184,0,-184
17054,1,1,1296,1339,43
17055,0,0,32,0,-32
17056,1,1,600,1562,962
17057,0,0,138,0,-138
17058,1,0,52,0,-52
17059,1,1,187,1332,1145
17060,0,0,19,0,-19
17061,1,1,1406,1265,-141
17062,1,1,298,1335,1037
17063,0,0,30,0,-30
17064,0,0,71,0,-71
17065,0,0,3,0,-3
17066,1,1,510,2410,1900
17067,0,0,6,0,-6
17068,1,1,209,1477,1268
17069,1,1,189,1750,1561
17070,0,0,1,0,-1
17071,0,0,54,0,-54
17072,1,0,45,0,-45
17073,1,1,466,1360,894
17074,1,0,69,0,-69
17075,1,1,121,1897,1776
17076,1,1,968,1380,412
17077,0,0,7,0,-7
17078,0,0,12,0,-12
17079,1,0,8,0,-8
17080,1,0,63,0,-63
17081,1,1,179,1997,1818
17082,0,0,5,0,-5
17083,1,1,444,1644,1200
17084,0,0,7,0,-7
17085,0,0,8,0,-8
17086,0,0,39,0,-39
17087,0,0,163,0,-163
17088,1,1,20,1289,1269
17089,1,0,66,0,-66
17090,0,0,20,0,-20
17091,0,0,2,0,-2
17092,1,1,758,1254,496
17093,1,0,40,0,-40
17094,1,1,961,1490,529
17095,1,1,331,3542,3211
17096,1,1,155,1338,1183
17097,0,0,195,0,-195
17098,1,0,22,0,-22
17099,0,0,7,0,-7
17100,1,0,50,0,-50
17101,1,1,255,1479,1224
17102,0,0,114,0,-114
17103,0,0,0,0,0
17104,1,1,828,1240,412
17105,0,0,40,0,-40
17106,1,1,242,1244,1002
17107,1,1,4586,1361,-3225
17108,1,1,685,1661,976
17109,1,1,662,1366,704
17110,0,0,52,0,-52
17111,0,0,41,0,-41
17112,1,0,41,0,-41
17113,1,1,208,1268,1060
17114,1,0,17,0,-17
17115,1,1,127,1272,1145
17116,1,0,3,0,-3
17117,0,0,48,0,-48
17118,1,0,35,0,-35
17119,1,1,471,1279,808
17120,0,0,74,0,-74
17121,0,0,117,0,-117
17122,0,0,19,0,-19
17123,1,1,612,1501,889
17124,0,0,126,0,-126
17125,1,1,61,1496,1435
17126,1,0,100,0,-100
17127,1,0,51,0,-51
17128,0,0,47,0,-47
17129,1,1,110,1432,1322
17130,0,0,49,0,-49
17131,0,0,16,0,-16
17132,1,0,93,0,-93
17133,1,1,697,1205,508
17134,1,0,70,0,-70
17135,1,1,80,1300,1220
17136,1,0,175,0,-175
17137,0,0,0,0,0
17138,1,0,103,0,-103
17139,0,0,52,0,-52
17140,1,1,1199,1361,162
17141,1,1,1554,1296,-258
17142,0,0,31,0,-31
17143,0,0,15,0,-15
17144,0,0,22,0,-22
17145,1,0,78,0,-78
17146,0,0,140,0,-140
17147,0,0,6,0,-6
17148,1,0,147,0,-147
17149,1,1,139,1522,1383
17150,0,0,40,0,-40
17151,0,0,22,0,-22
17152,1,0,15,0,-15
17153,0,0,67,0,-67
17154,1,0,81,0,-81
17155,1,1,931,1219,288
17156,0,0,46,0,-46
17157,0,0,16,0,-16
17158,0,0,19,0,-19
17159,0,0,107,0,-107
17160,1,1,742,1682,940
17161,1,0,24,0,-24
17162,1,0,104,0,-104
17163,1,0,99,0,-99
17164,1,1,964,1313,349
17165,1,1,447,1225,778
17166,0,0,22,0,-22
17167,0,0,63,0,-63
17168,1,1,60,1527,1467
17169,1,0,19,0,-19
17170,0,0,14,0,-14
17171,1,1,101,1262,1161
17172,1,0,84,0,-84
17173,1,1,455,2601,2146
17174,0,0,27,0,-27
17175,0,0,4,0,-4
17176,1,0,8,0,-8
17177,1,0,114,0,-114
17178,0,0,74,0,-74
17179,0,0,65,0,-65
17180,0,0,35,0,-35
17181,1,0,9,0,-9
17182,0,0,22,0,-22
17183,0,0,16,0,-16
17184,0,0,15,0,-15
17185,0,0,23,0,-23
17186,1,1,145,1646,1501
17187,0,0,30,0,-30
17188,1,0,13,0,-13
17189,1,0,31,0,-31
17190,1,0,76,0,-76
17191,0,0,22,0,-22
17192,1,0,20,0,-20
17193,1,1,110,1297,1187
17194,0,0,110,0,-110
17195,1,0,6,0,-6
17196,1,0,85,0,-85
17197,1,1,279,1316,1037
17198,0,0,86,0,-86
17199,1,1,345,1280,935
17200,1,1,244,2602,2358
17201,0,0,5,0,-5
17202,1,0,22,0,-22
17203,1,0,30,0,-30
17204,0,0,14,0,-14
17205,1,1,672,1310,638
17206,0,0,48,0,-48
17207,1,0,59,0,-59
17208,1,1,313,1432,1119
17209,1,0,27,0,-27
17210,1,1,24,1356,1332
17211,1,1,483,1876,1393
17212,1,1,440,1314,874
17213,1,0,68,0,-68
17214,1,1,202,2102,1900
17215,1,1,1936,1730,-206
17216,1,1,471,1234,763
17217,0,0,343,0,-343
17218,1,0,93,0,-93
17219,1,0,31,0,-31
17220,1,1,916,1358,442
17221,1,1,526,1281,755
17222,0,0,75,0,-75
17223,1,0,113,0,-113
17224,1,0,32,0,-32
17225,1,1,947,1561,614
17226,0,0,22,0,-22
17227,1,0,79,0,-79
17228,1,0,132,0,-132
17229,1,0,68,0,-68
17230,1,1,776,3604,2828
17231,1,1,187,1989,1802
17232,0,0,17,0,-17
17233,0,0,16,0,-16
17234,1,1,136,1671,1535
17235,1,0,29,0,-29
17236,1,1,207,1367,1160
17237,1,0,12,0,-12
17238,0,0,51,0,-51
17239,1,1,69,2174,2105
17240,1,0,8,0,-8
17241,1,0,19,0,-19
17242,0,0,65,0,-65
17243,0,0,13,0,-13
17244,1,0,33,0,-33
17245,0,0,50,0,-50
17246,1,0,44,0,-44
17247,0,0,16,0,-16
17248,1,0,2,0,-2
17249,0,0,251,0,-251
17250,1,0,36,0,-36
17251,0,0,9,0,-9
17252,1,1,216,1493,1277
17253,0,0,55,0,-55
17254,1,0,82,0,-82
17255,1,1,316,1338,1022
17256,1,0,90,0,-90
17257,1,0,46,0,-46
17258,1,1,1267,1368,101
17259,1,0,55,0,-55
17260,1,1,219,1329,1110
17261,1,0,15,0,-15
17262,0,0,15,0,-15
17263,1,0,46,0,-46
17264,1,1,117,1252,1135
17265,0,0,39,0,-39
17266,1,1,1006,1993,987
17267,1,0,2,0,-2
17268,1,0,20,0,-20
17269,1,1,71,1879,1808
17270,0,0,36,0,-36
17271,0,0,43,0,-43
17272,1,0,41,0,-41
17273,1,0,80,0,-80
17274,0,0,0,0,0
17275,1,1,171,1212,1041
17276,1,0,51,0,-51
17277,0,0,72,0,-72
17278,1,1,1315,1343,28
17279,1,1,326,2008,1682
17280,1,1,503,1923,1420
17281,1,1,726,1294,568
17282,0,0,0,0,0
17283,0,0,21,0,-21
17284,0,0,46,0,-46
17285,1,0,123,0,-123
17286,1,1,839,3106,2267
17287,1,0,29,0,-29
17288,1,1,231,1299,1068
17289,1,1,222,1331,1109
17290,1,0,212,0,-212
17291,0,0,21,0,-21
17292,0,0,87,0,-87
17293,0,0,19,0,-19
17294,1,1,142,1200,1058
17295,0,0,143,0,-143
17296,0,0,111,0,-111
17297,0,0,60,0,-60
17298,1,0,9,0,-9
17299,1,0,3,0,-3
17300,0,0,2,0,-2
17301,1,0,23,0,-23
17302,0,0,63,0,-63
17303,1,1,111,1240,1129
17304,1,0,42,0,-42
17305,0,0,36,0,-36
17306,1,1,2049,1501,-548
17307,0,0,55,0,-55
17308,1,1,987,1484,497
17309,0,0,10,0,-10
17310,1,1,60,1439,1379
17311,1,1,123,1740,1617
17312,0,0,65,0,-65
17313,1,1,474,1705,1231
17314,1,1,401,1348,947
17315,1,1,44,1294,1250
17316,1,0,24,0,-24
17317,1,1,400,1632,1232
17318,0,0,146,0,-146
17319,1,0,71,0,-71
17320,1,0,134,0,-134
17321,1,1,481,1405,924
17322,1,0,46,0,-46
17323,0,0,26,0,-26
17324,1,0,39,0,-39
17325,1,0,21,0,-21
17326,1,1,704,1947,1243
17327,1,0,139,0,-139
17328,0,0,84,0,-84
17329,1,0,81,0,-81
17330,0,0,106,0,-106
17331,1,0,7,0,-7
17332,1,1,169,1580,1411
17333,1,0,15,0,-15
17334,1,1,64,1456,1392
17335,0,0,58,0,-58
17336,1,1,243,1249,1006
17337,1,1,334,1277,943
17338,1,1,640,3638,2998
17339,1,0,24,0,-24
17340,0,0,31,0,-31
17341,1,0,89,0,-89
17342,1,0,89,0,-89
17343,1,0,12,0,-12
17344,1,0,51,0,-51
17345,1,0,35,0,-35
17346,0,0,138,0,-138
17347,0,0,0,0,0
17348,1,0,74,0,-74
17349,1,0,22,0,-22
17350,0,0,5,0,-5
17351,1,0,15,0,-15
17352,1,0,44,0,-44
17353,1,0,85,0,-85
17354,0,0,12,0,-12
17355,0,0,210,0,-210
17356,0,0,170,0,-170
17357,0,0,56,0,-56
17358,1,0,37,0,-37
17359,0,0,87,0,-87
17360,1,1,510,1254,744
17361,0,0,155,0,-155
17362,0,0,57,0,-57
17363,0,0,37,0,-37
17364,1,1,186,1380,1194
17365,1,1,85,1497,1412
17366,1,1,571,1306,735
17367,1,1,1806,1720,-86
17368,0,0,14,0,-14
17369,1,0,1,0,-1
17370,1,1,375,1418,1043
17371,0,0,35,0,-35
17372,0,0,93,0,-93
17373,0,0,50,0,-50
17374,1,1,195,1545,1350
17375,1,0,19,0,-19
17376,1,0,14,0,-14
17377,1,0,18,0,-18
17378,0,0,46,0,-46
17379,0,0,13,0,-13
17380,1,0,96,0,-96
17381,1,1,579,1233,654
17382,0,0,68,0,-68
17383,0,0,8,0,-8
17384,1,0,3,0,-3
17385,0,0,64,0,-64
17386,0,0,50,0,-50
17387,0,0,72,0,-72
17388,0,0,165,0,-165
17389,0,0,52,0,-52
17390,1,0,13,0,-13
17391,1,1,560,1684,1124
17392,1,1,624,3241,2617
17393,1,0,24,0,-24
17394,1,1,547,1620,1073
17395,0,0,82,0,-82
17396,0,0,16,0,-16
17397,1,1,36,1679,1643
17398,1,0,19,0,-19
17399,1,1,1539,1959,420
17400,0,0,74,0,-74
17401,1,0,32,0,-32
17402,0,0,184,0,-184
17403,1,1,521,1434,913
17404,1,1,108,1251,1143
17405,1,1,524,1606,1082
17406,1,0,30,0,-30
17407,0,0,15,0,-15
17408,0,0,118,0,-118
17409,0,0,175,0,-175
17410,0,0,12,0,-12
17411,1,1,180,1561,1381
17412,0,0,28,0,-28
17413,1,1,348,1708,1360
17414,0,0,84,0,-84
17415,1,1,1071,1504,433
17416,1,1,691,1368,677
17417,1,0,3,0,-3
17418,1,1,301,1869,1568
17419,1,1,927,1599,672
17420,0,0,45,0,-45
17421,1,0,0,0,0
17422,1,1,54,1990,1936
17423,0,0,19,0,-19
17424,0,0,28,0,-28
17425,0,0,70,0,-70
17426,1,0,76,0,-76
17427,1,1,308,1896,1588
17428,1,1,102,1334,1232
17429,0,0,23,0,-23
17430,0,0,17,0,-17
17431,0,0,53,0,-53
17432,1,1,591,1290,699
17433,0,0,3,0,-3
17434,1,1,1164,1685,521
17435,1,0,61,0,-61
17436,1,1,527,1364,837
17437,1,1,1872,1658,-214
17438,1,1,1062,1267,205
17439,1,1,91,1929,1838
17440,1,0,30,0,-30
17441,1,1,41,1279,1238
17442,1,0,2,0,-2
17443,1,1,39,1792,1753
17444,1,1,187,3831,3644
17445,0,0,21,0,-21
17446,1,0,47,0,-47
17447,1,0,59,0,-59
17448,1,1,168,1293,1125
17449,0,0,105,0,-105
17450,0,0,3,0,-3
17451,1,1,193,1537,1344
17452,1,0,221,0,-221
17453,0,0,8,0,-8
17454,0,0,180,0,-180
17455,0,0,26,0,-26
17456,1,1,62,1299,1237
17457,0,0,0,0,0
17458,0,0,5,0,-5
17459,1,0,33,0,-33
17460,0,0,14,0,-14
17461,0,0,57,0,-57
17462,1,1,152,1664,1512
17463,1,1,413,1507,1094
17464,1,0,54,0,-54
17465,1,0,163,0,-163
17466,0,0,83,0,-83
17467,1,1,594,1286,692
17468,1,0,120,0,-120
17469,0,0,24,0,-24
17470,1,0,26,0,-26
17471,1,1,15,1206,1191
17472,0,0,19,0,-19
17473,0,0,0,0,0
17474,1,1,1115,1806,691
17475,1,1,139,1250,1111
17476,1,1,280,2725,2445
17477,0,0,24,0,-24
17478,0,0,68,0,-68
17479,0,0,0,0,0
17480,1,1,36,1686,1650
17481,1,0,21,0,-21
17482,1,0,42,0,-42
17483,1,1,80,1218,1138
17484,1,1,1036,1794,758
17485,1,1,98,1267,1169
17486,0,0,14,0,-14
17487,0,0,21,0,-21
17488,1,0,26,0,-26
17489,0,0,69,0,-69
17490,1,0,5,0,-5
17491,0,0,0,0,0
17492,1,1,1437,1742,305
17493,0,0,34,0,-34
17494,1,0,31,0,-31
17495,1,0,101,0,-101
17496,1,1,543,1726,1183
17497,1,1,538,1254,716
17498,1,0,37,0,-37
17499,1,0,45,0,-45
17500,0,0,16,0,-16
17501,0,0,136,0,-136
17502,0,0,57,0,-57
17503,1,0,9,0,-9
17504,1,1,130,1377,1247
17505,1,1,463,1403,940
17506,0,0,50,0,-50
17507,0,0,36,0,-36
17508,0,0,45,0,-45
17509,1,1,789,1348,559
17510,1,0,16,0,-16
17511,1,0,79,0,-79
17512,1,0,101,0,-101
17513,1,0,78,0,-78
17514,1,1,878,3265,2387
17515,1,1,470,2216,1746
17516,0,0,5,0,-5
17517,0,0,15,0,-15
17518,0,0,7,0,-7
17519,1,1,1416,1946,530
17520,1,1,376,1220,844
17521,1,1,600,1460,860
17522,0,0,6,0,-6
17523,1,1,605,2234,1629
17524,0,0,212,0,-212
17525,0,0,38,0,-38
17526,1,1,515,1797,1282
17527,1,0,49,0,-49
17528,0,0,70,0,-70
17529,1,0,35,0,-35
17530,0,0,50,0,-50
17531,1,1,172,1752,1580
17532,1,0,38,0,-38
17533,0,0,33,0,-33
17534,1,1,337,1583,1246
17535,1,0,18,0,-18
17536,0,0,79,0,-79
17537,1,1,269,1254,985
17538,0,0,4,0,-4
17539,0,0,46,0,-46
17540,1,0,4,0,-4
17541,1,0,34,0,-34
17542,1,0,16,0,-16
17543,1,0,108,0,-108
17544,0,0,51,0,-51
17545,1,0,13,0,-13
17546,1,1,18,29278,29260
17547,1,1,639,1340,701
17548,1,0,28,0,-28
17549,1,1,151,2091,1940
17550,1,1,444,2738,2294
17551,1,0,140,0,-140
17552,1,1,138,1368,1230
17553,0,0,55,0,-55
17554,0,0,153,0,-153
17555,0,0,128,0,-128
17556,1,0,5,0,-5
17557,0,0,16,0,-16
17558,1,1,402,1330,928
17559,1,0,20,0,-20
17560,1,0,20,0,-20
17561,0,0,117,0,-117
17562,1,1,278,1265,987
17563,1,0,195,0,-195
17564,1,1,427,1369,942
17565,1,0,36,0,-36
17566,1,0,143,0,-143
17567,1,1,622,1336,714
17568,1,1,801,2387,1586
17569,0,0,39,0,-39
17570,0,0,31,0,-31
17571,0,0,3,0,-3
17572,0,0,16,0,-16
17573,1,1,280,1423,1143
17574,1,1,226,1322,1096
17575,0,0,19,0,-19
17576,1,0,28,0,-28
17577,1,0,165,0,-165
17578,1,0,94,0,-94
17579,0,0,4,0,-4
17580,1,0,30,0,-30
17581,0,0,71,0,-71
17582,1,0,162,0,-162
17583,1,1,264,2031,1767
17584,0,0,107,0,-107
17585,0,0,15,0,-15
17586,0,0,106,0,-106
17587,1,1,77,1444,1367
17588,1,0,98,0,-98
17589,1,0,4,0,-4
17590,1,0,69,0,-69
17591,0,0,0,0,0
17592,1,0,11,0,-11
17593,1,1,776,1397,621
17594,0,0,20,0,-20
17595,1,1,231,1627,1396
17596,1,1,664,1398,734
17597,0,0,64,0,-64
17598,1,1,222,1265,1043
17599,0,0,10,0,-10
17600,1,0,4,0,-4
17601,0,0,3,0,-3
17602,1,0,72,0,-72
17603,1,0,27,0,-27
17604,0,0,21,0,-21
17605,1,1,825,2202,1377
17606,1,1,1804,1412,-392
17607,0,0,103,0,-103
17608,1,1,374,1491,1117
17609,1,0,31,0,-31
17610,0,0,100,0,-100
17611,1,0,39,0,-39
17612,1,0,7,0,-7
17613,0,0,22,0,-22
17614,1,1,73,1455,1382
17615,1,1,158,1266,1108
17616,1,1,79,2331,2252
17617,1,1,128,1541,1413
17618,1,1,315,1230,915
17619,1,0,5,0,-5
17620,1,1,1281,1218,-63
17621,0,0,111,0,-111
17622,1,0,47,0,-47
17623,0,0,42,0,-42
17624,0,0,6,0,-6
17625,0,0,6,0,-6
17626,1,1,372,1338,966
17627,1,1,126,2046,1920
17628,0,0,49,0,-49
17629,1,1,283,1385,1102
17630,1,0,62,0,-62
17631,1,0,30,0,-30
17632,0,0,39,0,-39
17633,0,0,1,0,-1
17634,0,0,40,0,-40
17635,0,0,370,0,-370
17636,0,0,107,0,-107
17637,1,1,571,1413,842
17638,1,1,581,1278,697
17639,0,0,28,0,-28
17640,0,0,15,0,-15
17641,0,0,37,0,-37
17642,0,0,53,0,-53
17643,1,1,394,1516,1122
17644,1,1,1502,1353,-149
17645,1,0,126,0,-126
17646,0,0,76,0,-76
17647,0,0,14,0,-14
17648,1,1,484,1501,1017
17649,1,1,114,2237,2123
17650,1,0,41,0,-41
17651,1,0,37,0,-37
17652,0,0,36,0,-36
17653,1,1,153,1262,1109
17654,1,0,80,0,-80
17655,0,0,6,0,-6
17656,1,1,541,1705,1164
17657,1,1,81,2035,1954
17658,1,0,13,0,-13
17659,1,0,36,0,-36
17660,1,0,81,0,-81
17661,1,1,1393,1542,149
17662,1,1,241,1590,1349
17663,0,0,19,0,-19
17664,0,0,66,0,-66
17665,0,0,13,0,-13
17666,0,0,76,0,-76
17667,0,0,60,0,-60
17668,1,0,54,0,-54
17669,1,0,21,0,-21
17670,0,0,4,0,-4
17671,0,0,148,0,-148
17672,1,0,36,0,-36
17673,0,0,2,0,-2
17674,0,0,11,0,-11
17675,1,1,531,1365,834
17676,0,0,29,0,-29
17677,1,1,94,1219,1125
17678,1,0,164,0,-164
17679,0,0,25,0,-25
17680,0,0,5,0,-5
17681,1,1,313,1252,939
17682,1,1,798,1470,672
17683,1,1,28,1342,1314
17684,1,0,13,0,-13
17685,0,0,112,0,-112
17686,1,0,113,0,-113
17687,0,0,140,0,-140
17688,1,0,52,0,-52
17689,0,0,47,0,-47
17690,0,0,23,0,-23
17691,0,0,52,0,-52
17692,0,0,106,0,-106
17693,1,0,3,0,-3
17694,1,1,124,1450,1326
17695,1,0,88,0,-88
17696,1,0,58,0,-58
17697,0,0,63,0,-63
17698,0,0,58,0,-58
17699,0,0,15,0,-15
17700,1,0,22,0,-22
17701,1,0,36,0,-36
17702,1,0,42,0,-42
17703,1,0,53,0,-53
17704,0,0,86,0,-86
17705,1,0,9,0,-9
17706,0,0,96,0,-96
17707,0,0,22,0,-22
17708,1,1,174,1697,1523
17709,0,0,24,0,-24
17710,0,0,12,0,-12
17711,1,1,1155,1735,580
17712,0,0,35,0,-35
17713,0,0,14,0,-14
17714,1,1,405,1576,1171
17715,1,0,23,0,-23
17716,1,1,642,1630,988
17717,1,1,608,1784,1176
17718,1,1,122,1252,1130
17719,1,1,910,1230,320
17720,0,0,100,0,-100
17721,1,0,153,0,-153
17722,1,0,22,0,-22
17723,0,0,98,0,-98
17724,1,1,996,1204,208
17725,0,0,8,0,-8
17726,1,1,2158,1584,-574
17727,1,0,114,0,-114
17728,1,0,70,0,-70
17729,1,0,107,0,-107
17730,1,1,122,1462,1340
17731,1,1,336,1775,1439
17732,1,0,26,0,-26
17733,0,0,118,0,-118
17734,1,0,5,0,-5
17735,0,0,84,0,-84
17736,1,1,691,1601,910
17737,0,0,4,0,-4
17738,1,0,4,0,-4
17739,0,0,12,0,-12
17740,0,0,60,0,-60
17741,1,1,727,1294,567
17742,1,0,101,0,-101
17743,0,0,10,0,-10
17744,0,0,19,0,-19
17745,1,1,204,1224,1020
17746,0,0,1,0,-1
17747,0,0,12,0,-12
17748,0,0,40,0,-40
17749,1,0,32,0,-32
17750,1,1,191,1292,1101
17751,0,0,31,0,-31
17752,1,0,95,0,-95
17753,0,0,32,0,-32
17754,1,0,114,0,-114
17755,1,1,169,2080,1911
17756,1,1,694,1317,623
17757,1,1,450,3367,2917
17758,0,0,20,0,-20
17759,1,0,5,0,-5
17760,1,1,381,1647,1266
17761,1,0,55,0,-55
17762,1,1,283,1835,1552
17763,1,0,49,0,-49
17764,0,0,18,0,-18
17765,0,0,0,0,0
17766,0,0,85,0,-85
17767,1,1,1731,1851,120
17768,0,0,72,0,-72
17769,1,1,164,1401,1237
17770,0,0,8,0,-8
17771,0,0,51,0,-51
17772,1,0,58,0,-58
17773,0,0,69,0,-69
17774,0,0,108,0,-108
17775,1,1,40,1662,1622
17776,0,0,12,0,-12
17777,0,0,79,0,-79
17778,0,0,129,0,-129
17779,1,1,804,1309,505
17780,1,0,22,0,-22
17781,0,0,1,0,-1
17782,1,0,35,0,-35
17783,1,0,168,0,-168
17784,0,0,43,0,-43
17785,1,0,106,0,-106
17786,1,0,33,0,-33
17787,0,0,20,0,-20
17788,0,0,43,0,-43
17789,0,0,48,0,-48
17790,0,0,30,0,-30
17791,1,1,236,1395,1159
17792,0,0,44,0,-44
17793,1,0,35,0,-35
17794,0,0,22,0,-22
17795,1,1,361,1387,1026
17796,1,0,91,0,-91
17797,1,0,77,0,-77
17798,1,0,76,0,-76
17799,1,0,82,0,-82
17800,1,0,108,0,-108
17801,0,0,37,0,-37
17802,0,0,10,0,-10
17803,1,0,9,0,-9
17804,1,0,67,0,-67
17805,0,0,78,0,-78
17806,1,1,286,1333,1047
17807,0,0,130,0,-130
17808,1,0,68,0,-68
17809,0,0,91,0,-91
17810,1,1,1014,1645,631
17811,1,1,483,1831,1348
17812,1,1,37,3109,3072
17813,1,1,545,1266,721
17814,0,0,2,0,-2
17815,0,0,67,0,-67
17816,1,0,17,0,-17
17817,1,1,164,1326,1162
17818,0,0,126,0,-126
17819,1,1,727,1389,662
17820,1,0,25,0,-25
17821,1,0,133,0,-133
17822,1,0,50,0,-50
17823,1,1,677,2016,1339
17824,0,0,72,0,-72
17825,0,0,37,0,-37
17826,0,0,8,0,-8
17827,0,0,35,0,-35
17828,1,1,411,1482,1071
17829,1,1,1161,3350,2189
17830,0,0,22,0,-22
17831,1,1,995,1206,211
17832,1,0,65,0,-65
17833,1,0,72,0,-72
17834,1,0,170,0,-170
17835,0,0,53,0,-53
17836,1,0,51,0,-51
17837,0,0,33,0,-33
17838,1,1,133,1327,1194
17839,1,1,297,1212,915
17840,1,0,14,0,-14
17841,1,1,454,1344,890
17842,1,1,987,3489,2502
17843,0,0,35,0,-35
17844,1,0,74,0,-74
17845,1,0,49,0,-49
17846,0,0,87,0,-87
17847,0,0,9,0,-9
17848,1,0,95,0,-95
17849,1,0,45,0,-45
17850,1,1,715,2084,1369
17851,1,0,24,0,-24
17852,0,0,13,0,-13
17853,0,0,18,0,-18
17854,1,0,55,0,-55
17855,0,0,11,0,-11
17856,0,0,247,0,-247
17857,0,0,29,0,-29
17858,1,0,68,0,-68
17859,0,0,1,0,-1
17860,0,0,21,0,-21
17861,0,0,23,0,-23
17862,0,0,27,0,-27
17863,1,0,34,0,-34
17864,1,1,667,1748,1081
17865,0,0,56,0,-56
17866,1,0,21,0,-21
17867,1,1,73,1318,1245
17868,0,0,27,0,-27
17869,0,0,16,0,-16
17870,0,0,12,0,-12
17871,0,0,55,0,-55
17872,1,1,686,1340,654
17873,1,1,166,1654,1488
17874,1,0,26,0,-26
17875,0,0,27,0,-27
17876,0,0,67,0,-67
17877,1,1,158,1593,1435
17878,0,0,114,0,-114
17879,1,0,22,0,-22
17880,1,1,79,1288,1209
17881,1,0,8,0,-8
17882,0,0,38,0,-38
17883,1,1,171,1231,1060
17884,0,0,18,0,-18
17885,0,0,33,0,-33
17886,1,0,36,0,-36
17887,1,1,615,1416,801
17888,1,1,393,1212,819
17889,0,0,15,0,-15
17890,0,0,59,0,-59
17891,0,0,15,0,-15
17892,1,1,211,1589,1378
17893,1,0,63,0,-63
17894,1,1,557,1695,1138
17895,1,0,61,0,-61
17896,0,0,0,0,0
17897,0,0,40,0,-40
17898,1,0,120,0,-120
17899,1,0,90,0,-90
17900,1,1,131,1355,1224
17901,1,1,404,1631,1227
17902,0,0,94,0,-94
17903,1,0,50,0,-50
17904,1,1,1493,1292,-201
17905,0,0,110,0,-110
17906,1,0,1,0,-1
17907,1,0,3,0,-3
17908,1,1,163,2064,1901
17909,1,0,88,0,-88
17910,0,0,64,0,-64
17911,1,1,203,1266,1063
17912,1,0,54,0,-54
17913,1,0,172,0,-172
17914,1,0,19,0,-19
17915,1,0,7,0,-7
17916,0,0,93,0,-93
17917,1,1,928,5675,4747
17918,0,0,13,0,-13
17919,1,0,152,0,-152
17920,0,0,16,0,-16
17921,0,0,13,0,-13
17922,1,1,484,1586,1102
17923,1,1,15,1402,1387
17924,1,0,0,0,0
17925,1,1,147,1246,1099
17926,0,0,31,0,-31
17927,1,0,22,0,-22
17928,1,0,60,0,-60
17929,1,1,894,1803,909
17930,1,0,107,0,-107
17931,1,0,98,0,-98
17932,0,0,30,0,-30
17933,1,0,136,0,-136
17934,0,0,97,0,-97
17935,1,1,18,1259,1241
17936,1,0,56,0,-56
17937,1,1,376,1547,1171
17938,1,0,147,0,-147
17939,1,1,360,1255,895
17940,1,0,82,0,-82
17941,1,1,86,1795,1709
17942,0,0,87,0,-87
17943,1,0,8,0,-8
17944,1,0,6,0,-6
17945,1,1,896,1226,330
17946,1,0,5,0,-5
17947,0,0,1,0,-1
17948,1,1,942,1603,661
17949,0,0,17,0,-17
17950,1,0,35,0,-35
17951,0,0,25,0,-25
17952,0,0,28,0,-28
17953,0,0,15,0,-15
17954,0,0,53,0,-53
17955,1,0,32,0,-32
17956,0,0,12,0,-12
17957,0,0,34,0,-34
17958,1,1,1032,1244,212
17959,0,0,66,0,-66
17960,1,1,189,1244,1055
17961,1,1,179,1470,1291
17962,1,0,72,0,-72
17963,1,0,50,0,-50
17964,1,0,5,0,-5
17965,0,0,23,0,-23
17966,1,1,247,1201,954
17967,1,0,13,0,-13
17968,0,0,13,0,-13
17969,0,0,7,0,-7
17970,0,0,15,0,-15
17971,1,0,58,0,-58
17972,1,0,134,0,-134
17973,1,0,37,0,-37
17974,0,0,135,0,-135
17975,0,0,170,0,-170
17976,1,1,105,1529,1424
17977,0,0,38,0,-38
17978,0,0,7,0,-7
17979,0,0,13,0,-13
17980,1,1,902,1355,453
17981,1,0,55,0,-55
17982,1,0,108,0,-108
17983,0,0,56,0,-56
17984,1,0,33,0,-33
17985,1,1,267,1392,1125
17986,1,0,50,0,-50
17987,1,0,4,0,-4
17988,1,1,888,3246,2358
17989,1,0,22,0,-22
17990,0,0,24,0,-24
17991,0,0,47,0,-47
17992,1,1,1038,3770,2732
17993,1,0,46,0,-46
17994,0,0,6,0,-6
17995,1,0,188,0,-188
17996,1,1,268,1368,1100
17997,1,1,92,1403,1311
17998,0,0,25,0,-25
17999,1,0,35,0,-35
18000,0,0,3,0,-3
18001,0,0,2,0,-2
18002,0,0,122,0,-122
18003,0,0,59,0,-59
18004,1,0,22,0,-22
18005,0,0,19,0,-19
18006,1,0,107,0,-107
18007,1,0,45,0,-45
18008,1,0,13,0,-13
18009,1,0,14,0,-14
18010,1,0,0,0,0
18011,1,1,513,1212,699
18012,1,0,65,0,-65
18013,0,0,0,0,0
18014,1,0,92,0,-92
18015,0,0,50,0,-50
18016,1,1,95,1235,1140
18017,0,0,25,0,-25
18018,0,0,205,0,-205
18019,1,1,282,1515,1233
18020,1,0,148,0,-148
18021,0,0,102,0,-102
18022,0,0,18,0,-18
18023,1,1,1148,2044,896
18024,0,0,1,0,-1
18025,1,0,18,0,-18
18026,0,0,109,0,-109
18027,0,0,48,0,-48
18028,0,0,32,0,-32
18029,0,0,7,0,-7
18030,0,0,56,0,-56
18031,1,1,98,1252,1154
18032,0,0,21,0,-21
18033,1,0,162,0,-162
18034,0,0,166,0,-166
18035,0,0,7,0,-7
18036,1,0,60,0,-60
18037,0,0,15,0,-15
18038,0,0,10,0,-10
18039,0,0,81,0,-81
18040,0,0,3,0,-3
18041,1,1,188,1370,1182
18042,1,0,4,0,-4
18043,1,0,16,0,-16
18044,1,1,1930,1623,-307
18045,1,0,15,0,-15
18046,1,1,811,1201,390
18047,1,0,1,0,-1
18048,0,0,14,0,-14
18049,1,0,133,0,-133
18050,1,1,96,1303,1207
18051,0,0,55,0,-55
18052,1,1,1662,1813,151
18053,1,0,16,0,-16
18054,1,1,38,1654,1616
18055,0,0,12,0,-12
18056,0,0,14,0,-14
18057,1,0,244,0,-244
18058,1,1,240,2063,1823
18059,1,1,924,1207,283
18060,0,0,1,0,-1
18061,0,0,37,0,-37
18062,1,0,43,0,-43
18063,0,0,4,0,-4
18064,0,0,4,0,-4
18065,1,0,51,0,-51
18066,1,0,52,0,-52
18067,1,1,152,2065,1913
18068,1,1,92,1324,1232
18069,1,1,695,1316,621
18070,0,0,37,0,-37
18071,1,0,46,0,-46
18072,0,0,5,0,-5
18073,0,0,22,0,-22
18074,1,1,156,2054,1898
18075,0,0,36,0,-36
18076,0,0,19,0,-19
18077,0,0,68,0,-68
18078,0,0,11,0,-11
18079,0,0,42,0,-42
18080,0,0,55,0,-55
18081,0,0,6,0,-6
18082,1,1,36,1821,1785
18083,1,0,44,0,-44
18084,1,0,9,0,-9
18085,1,0,201,0,-201
18086,1,1,780,1250,470
18087,0,0,21,0,-21
18088,1,0,48,0,-48
18089,1,0,79,0,-79
18090,0,0,87,0,-87
18091,0,0,58,0,-58
18092,0,0,3,0,-3
18093,1,0,107,0,-107
18094,1,1,129,1396,1267
18095,0,0,18,0,-18
18096,1,1,880,1230,350
18097,0,0,26,0,-26
18098,1,1,207,1352,1145
18099,1,0,8,0,-8
18100,1,0,30,0,-30
18101,1,0,107,0,-107
18102,1,0,0,0,0
18103,1,0,88,0,-88
18104,0,0,98,0,-98
18105,1,0,5,0,-5
18106,1,0,14,0,-14
18107,0,0,64,0,-64
18108,1,0,67,0,-67
18109,0,0,0,0,0
18110,0,0,19,0,-19
18111,1,1,282,3000,2718
18112,0,0,56,0,-56
18113,1,1,931,2089,1158
18114,0,0,0,0,0
18115,0,0,18,0,-18
18116,0,0,11,0,-11
18117,0,0,37,0,-37
18118,0,0,14,0,-14
18119,0,0,8,0,-8
18120,0,0,35,0,-35
18121,1,1,76,1447,1371
18122,0,0,77,0,-77
18123,0,0,91,0,-91
18124,0,0,75,0,-75
18125,1,1,123,1438,1315
18126,0,0,6,0,-6
18127,0,0,46,0,-46
18128,0,0,6,0,-6
18129,1,0,0,0,0
18130,0,0,216,0,-216
18131,0,0,45,0,-45
18132,1,0,22,0,-22
18133,0,0,76,0,-76
18134,0,0,78,0,-78
18135,1,0,1,0,-1
18136,1,1,356,1265,909
18137,0,0,24,0,-24
18138,1,0,43,0,-43
18139,1,0,195,0,-195
18140,1,0,56,0,-56
18141,1,1,742,1448,706
18142,1,0,42,0,-42
18143,0,0,28,0,-28
18144,0,0,45,0,-45
18145,0,0,13,0,-13
18146,1,1,1038,1282,244
18147,1,1,139,1251,1112
18148,1,0,3,0,-3
18149,1,0,31,0,-31
18150,1,1,995,1209,214
18151,1,0,16,0,-16
18152,0,0,5,0,-5
18153,1,1,55,1802,1747
18154,0,0,12,0,-12
18155,1,0,211,0,-211
18156,1,0,0,0,0
18157,1,1,60,1555,1495
18158,0,0,21,0,-21
18159,1,1,553,1351,798
18160,0,0,78,0,-78
18161,1,1,650,1358,708
18162,1,0,133,0,-133
18163,0,0,66,0,-66
18164,1,1,247,1258,1011
18165,1,1,69,1242,1173
18166,1,0,2,0,-2
18167,1,1,319,1217,898
18168,1,1,587,1552,965
18169,0,0,86,0,-86
18170,1,0,6,0,-6
18171,1,0,206,0,-206
18172,1,0,13,0,-13
18173,1,0,88,0,-88
18174,1,0,18,0,-18
18175,1,0,2,0,-2
18176,1,1,711,1343,632
18177,0,0,23,0,-23
18178,1,0,22,0,-22
18179,1,0,50,0,-50
18180,1,1,444,1348,904
18181,1,0,100,0,-100
18182,0,0,13,0,-13
18183,1,0,21,0,-21
18184,1,0,58,0,-58
18185,1,0,23,0,-23
18186,1,0,119,0,-119
18187,0,0,90,0,-90
18188,1,0,9,0,-9
18189,1,1,212,1231,1019
18190,1,1,160,2591,2431
18191,1,0,30,0,-30
18192,0,0,123,0,-123
18193,0,0,225,0,-225
18194,0,0,67,0,-67
18195,1,1,228,1495,1267
18196,1,0,15,0,-15
18197,1,1,1527,1400,-127
18198,1,1,786,1492,706
18199,0,0,9,0,-9
18200,1,1,378,1430,1052
18201,1,1,723,1475,752
18202,0,0,17,0,-17
18203,1,1,936,1409,473
18204,0,0,35,0,-35
18205,1,1,433,1210,777
18206,0,0,134,0,-134
18207,1,0,47,0,-47
18208,0,0,8,0,-8
18209,0,0,24,0,-24
18210,1,0,8,0,-8
18211,1,1,370,1568,1198
18212,0,0,90,0,-90
18213,1,0,1,0,-1
18214,1,0,112,0,-112
18215,1,0,4,0,-4
18216,0,0,18,0,-18
18217,1,1,331,1223,892
18218,1,1,709,1984,1275
18219,1,1,294,2120,1826
18220,1,1,179,1391,1212
18221,1,0,38,0,-38
18222,0,0,51,0,-51
18223,1,0,5,0,-5
18224,0,0,6,0,-6
18225,0,0,164,0,-164
18226,0,0,81,0,-81
18227,1,0,121,0,-121
18228,1,1,524,1217,693
18229,1,0,74,0,-74
18230,0,0,118,0,-118
18231,1,0,101,0,-101
18232,1,0,35,0,-35
18233,1,0,6,0,-6
18234,1,0,86,0,-86
18235,1,0,18,0,-18
18236,1,1,171,1389,1218
18237,0,0,1,0,-1
18238,0,0,213,0,-213
18239,0,0,64,0,-64
18240,1,1,370,1295,925
18241,0,0,48,0,-48
18242,1,1,274,1607,1333
18243,1,0,8,0,-8
18244,0,0,132,0,-132
18245,1,0,23,0,-23
18246,1,0,11,0,-11
18247,1,0,76,0,-76
18248,1,0,6,0,-6
18249,0,0,13,0,-13
18250,0,0,42,0,-42
18251,1,1,577,1232,655
18252,0,0,68,0,-68
18253,0,0,39,0,-39
18254,1,1,319,1417,1098
18255,1,0,2,0,-2
18256,0,0,73,0,-73
18257,1,0,20,0,-20
18258,1,0,66,0,-66
18259,1,0,21,0,-21
18260,1,1,472,1273,801
18261,0,0,54,0,-54
18262,0,0,167,0,-167
18263,0,0,68,0,-68
18264,1,0,79,0,-79
18265,1,0,7,0,-7
18266,0,0,19,0,-19
18267,0,0,53,0,-53
18268,1,0,19,0,-19
18269,1,0,11,0,-11
18270,0,0,10,0,-10
18271,1,1,548,1466,918
18272,1,0,29,0,-29
18273,1,0,64,0,-64
18274,1,1,44,1359,1315
18275,0,0,11,0,-11
18276,0,0,135,0,-135
18277,1,0,37,0,-37
18278,0,0,30,0,-30
18279,1,0,62,0,-62
18280,1,1,278,1338,1060
18281,1,1,211,1672,1461
18282,1,0,37,0,-37
18283,1,0,91,0,-91
18284,1,0,60,0,-60
18285,1,1,474,1891,1417
18286,0,0,56,0,-56
18287,1,1,1747,2261,514
18288,1,0,59,0,-59
18289,0,0,1,0,-1
18290,1,1,402,1451,1049
18291,1,0,48,0,-48
18292,1,0,16,0,-16
18293,1,1,161,2729,2568
18294,1,1,306,1466,1160
18295,1,1,427,1572,1145
18296,1,1,200,1212,1012
18297,0,0,112,0,-112
18298,1,0,173,0,-173
18299,1,1,455,1511,1056
18300,0,0,14,0,-14
18301,0,0,27,0,-27
18302,1,0,28,0,-28
18303,1,1,927,1292,365
18304,1,0,94,0,-94
18305,1,1,155,1412,1257
18306,1,1,1289,1261,-28
18307,0,0,106,0,-106
18308,0,0,59,0,-59
18309,0,0,46,0,-46
18310,1,0,32,0,-32
18311,1,0,74,0,-74
18312,1,0,69,0,-69
18313,1,0,150,0,-150
18314,0,0,142,0,-142
18315,1,0,38,0,-38
18316,1,1,1262,1299,37
18317,0,0,16,0,-16
18318,1,1,281,1324,1043
18319,0,0,1,0,-1
18320,0,0,14,0,-14
18321,1,0,75,0,-75
18322,0,0,28,0,-28
18323,0,0,61,0,-61
18324,0,0,104,0,-104
18325,0,0,0,0,0
18326,1,1,398,1434,1036
18327,1,1,471,1209,738
18328,1,1,9,1245,1236
18329,1,0,29,0,-29
18330,0,0,100,0,-100
18331,0,0,136,0,-136
18332,0,0,6,0,-6
18333,1,0,25,0,-25
18334,1,1,78,1598,1520
18335,1,0,31,0,-31
18336,1,1,941,3077,2136
18337,1,0,19,0,-19
18338,1,1,666,1326,660
18339,1,1,875,1622,747
18340,0,0,20,0,-20
18341,1,1,261,1218,957
18342,1,0,22,0,-22
18343,0,0,10,0,-10
18344,0,0,18,0,-18
18345,0,0,8,0,-8
18346,0,0,12,0,-12
18347,0,0,2,0,-2
18348,0,0,0,0,0
18349,1,0,75,0,-75
18350,1,1,154,1348,1194
18351,0,0,122,0,-122
18352,0,0,25,0,-25
18353,0,0,15,0,-15
18354,1,1,430,1315,885
18355,0,0,27,0,-27
18356,1,1,562,1481,919
18357,0,0,91,0,-91
18358,1,0,12,0,-12
18359,1,1,825,1672,847
18360,1,0,14,0,-14
18361,1,0,19,0,-19
18362,1,0,174,0,-174
18363,1,0,9,0,-9
18364,1,0,9,0,-9
18365,0,0,1,0,-1
18366,1,1,276,1611,1335
18367,1,1,878,1675,797
18368,0,0,72,0,-72
18369,0,0,23,0,-23
18370,1,1,103,1441,1338
18371,0,0,5,0,-5
18372,1,0,17,0,-17
18373,1,0,3,0,-3
18374,0,0,13,0,-13
18375,0,0,9,0,-9
18376,1,0,24,0,-24
18377,1,0,106,0,-106
18378,1,1,528,2896,2368
18379,1,0,21,0,-21
18380,1,1,405,1627,1222
18381,0,0,114,0,-114
18382,1,1,213,1222,1009
18383,1,1,694,1233,539
18384,1,1,1449,1889,440
18385,0,0,79,0,-79
18386,0,0,47,0,-47
18387,1,1,45,1939,1894
18388,1,1,955,1293,338
18389,0,0,5,0,-5
18390,1,1,816,1215,399
18391,1,0,28,0,-28
18392,1,0,92,0,-92
18393,0,0,18,0,-18
18394,1,1,128,2151,2023
18395,1,0,2,0,-2
18396,0,0,1,0,-1
18397,0,0,145,0,-145
18398,0,0,148,0,-148
18399,0,0,70,0,-70
18400,0,0,174,0,-174
18401,0,0,94,0,-94
18402,1,1,1183,1468,285
18403,1,0,41,0,-41
18404,0,0,22,0,-22
18405,0,0,32,0,-32
18406,1,0,105,0,-105
18407,1,0,8,0,-8
18408,0,0,47,0,-47
18409,1,1,151,1267,1116
18410,1,1,314,3985,3671
18411,0,0,0,0,0
18412,0,0,1,0,-1
18413,1,0,51,0,-51
18414,0,0,370,0,-370
18415,1,0,54,0,-54
18416,1,1,316,1441,1125
18417,1,1,238,1411,1173
18418,1,0,9,0,-9
18419,1,1,159,1583,1424
18420,1,1,349,1222,873
18421,1,1,907,1669,762
18422,0,0,166,0,-166
18423,1,0,59,0,-59
18424,1,0,55,0,-55
18425,0,0,65,0,-65
18426,1,0,24,0,-24
18427,0,0,122,0,-122
18428,0,0,46,0,-46
18429,1,0,8,0,-8
18430,1,0,3,0,-3
18431,0,0,22,0,-22
18432,1,0,15,0,-15
18433,0,0,48,0,-48
18434,1,1,447,1264,817
18435,0,0,18,0,-18
18436,1,0,3,0,-3
18437,1,1,85,1346,1261
18438,0,0,46,0,-46
18439,1,1,1299,1567,268
18440,0,0,81,0,-81
18441,0,0,28,0,-28
18442,1,0,23,0,-23
18443,1,1,189,3060,2871
18444,1,0,14,0,-14
18445,0,0,59,0,-59
18446,1,0,10,0,-10
18447,1,1,895,1259,364
18448,0,0,103,0,-103
18449,1,1,262,1960,1698
18450,1,0,310,0,-310
18451,1,0,12,0,-12
18452,1,0,16,0,-16
18453,0,0,75,0,-75
18454,0,0,21,0,-21
18455,1,0,49,0,-49
18456,0,0,20,0,-20
18457,0,0,146,0,-146
18458,1,0,196,0,-196
18459,1,1,375,1295,920
18460,1,1,593,1277,684
18461,0,0,15,0,-15
18462,0,0,30,0,-30
18463,0,0,54,0,-54
18464,1,1,155,1917,1762
18465,1,0,46,0,-46
18466,1,1,773,1403,630
18467,0,0,11,0,-11
18468,0,0,98,0,-98
18469,1,1,155,1918,1763
18470,1,1,328,1508,1180
18471,0,0,97,0,-97
18472,1,0,12,0,-12
18473,1,1,286,1243,957
18474,1,1,886,1262,376
18475,0,0,29,0,-29
18476,1,0,70,0,-70
18477,1,1,95,1202,1107
18478,1,1,686,1359,673
18479,0,0,133,0,-133
18480,1,0,0,0,0
18481,1,0,6,0,-6
18482,1,0,36,0,-36
18483,0,0,63,0,-63
18484,1,1,606,1411,805
18485,1,0,165,0,-165
18486,1,0,13,0,-13
18487,1,1,494,1277,783
18488,0,0,25,0,-25
18489,0,0,62,0,-62
18490,1,0,78,0,-78
18491,0,0,84,0,-84
18492,1,1,238,1571,1333
18493,1,1,68,1229,1161
18494,0,0,67,0,-67
18495,0,0,133,0,-133
18496,0,0,74,0,-74
18497,0,0,27,0,-27
18498,1,1,543,1677,1134
18499,0,0,125,0,-125
18500,1,0,17,0,-17
18501,0,0,25,0,-25
18502,0,0,33,0,-33
18503,0,0,31,0,-31
18504,0,0,12,0,-12
18505,1,0,57,0,-57
18506,0,0,9,0,-9
18507,1,0,7,0,-7
18508,0,0,24,0,-24
18509,0,0,36,0,-36
18510,0,0,14,0,-14
18511,0,0,10,0,-10
18512,0,0,9,0,-9
18513,1,1,210,2001,1791
18514,0,0,122,0,-122
18515,1,0,47,0,-47
18516,1,0,143,0,-143
18517,0,0,43,0,-43
18518,1,0,87,0,-87
18519,0,0,34,0,-34
18520,1,0,25,0,-25
18521,1,1,391,1440,1049
18522,1,1,102,1317,1215
18523,1,1,356,1394,1038
18524,1,0,8,0,-8
18525,0,0,103,0,-103
18526,0,0,10,0,-10
18527,1,1,1698,1598,-100
18528,1,1,174,1413,1239
18529,1,0,106,0,-106
18530,0,0,57,0,-57
18531,1,0,63,0,-63
18532,0,0,31,0,-31
18533,0,0,48,0,-48
18534,1,1,1294,1258,-36
18535,0,0,95,0,-95
18536,0,0,23,0,-23
18537,0,0,20,0,-20
18538,1,1,922,10938,10016
18539,1,0,103,0,-103
18540,0,0,8,0,-8
18541,1,1,128,1201,1073
18542,0,0,43,0,-43
18543,0,0,11,0,-11
18544,0,0,54,0,-54
18545,0,0,63,0,-63
18546,0,0,9,0,-9
18547,1,1,1888,1346,-542
18548,1,1,340,1971,1631
18549,1,1,359,1531,1172
18550,1,0,35,0,-35
18551,1,1,353,1571,1218
18552,1,0,44,0,-44
18553,1,0,5,0,-5
18554,1,1,581,1200,619
18555,0,0,17,0,-17
18556,1,1,298,1620,1322
18557,1,1,129,1927,1798
18558,0,0,22,0,-22
18559,1,1,247,1240,993
18560,1,0,24,0,-24
18561,0,0,33,0,-33
18562,1,0,10,0,-10
18563,0,0,6,0,-6
18564,1,0,38,0,-38
18565,0,0,31,0,-31
18566,1,1,1560,1312,-248
18567,1,0,75,0,-75
18568,1,1,146,1246,1100
18569,1,1,436,1651,1215
18570,0,0,25,0,-25
18571,1,0,13,0,-13
18572,0,0,47,0,-47
18573,1,1,62,1422,1360
18574,1,0,43,0,-43
18575,1,0,81,0,-81
18576,1,0,14,0,-14
18577,0,0,41,0,-41
18578,0,0,1,0,-1
18579,0,0,49,0,-49
18580,1,0,23,0,-23
18581,0,0,2,0,-2
18582,1,0,93,0,-93
18583,1,1,445,1511,1066
18584,1,0,88,0,-88
18585,1,1,967,1346,379
18586,1,0,41,0,-41
18587,0,0,42,0,-42
18588,0,0,64,0,-64
18589,0,0,70,0,-70
18590,0,0,41,0,-41
18591,0,0,34,0,-34
18592,0,0,3,0,-3
18593,1,0,5,0,-5
18594,0,0,8,0,-8
18595,0,0,1,0,-1
18596,1,1,225,1239,1014
18597,1,1,1370,1419,49
18598,1,0,20,0,-20
18599,1,1,437,1629,1192
18600,1,1,806,1380,574
18601,1,0,25,0,-25
18602,1,1,148,1306,1158
18603,0,0,20,0,-20
18604,0,0,15,0,-15
18605,0,0,26,0,-26
18606,0,0,0,0,0
18607,1,0,19,0,-19
18608,0,0,9,0,-9
18609,1,0,111,0,-111
18610,1,0,3,0,-3
18611,1,1,384,1735,1351
18612,0,0,2,0,-2
18613,0,0,6,0,-6
18614,0,0,24,0,-24
18615,1,0,87,0,-87
18616,1,1,503,1355,852
18617,1,1,1762,1245,-517
18618,1,0,136,0,-136
18619,1,1,602,1351,749
18620,0,0,8,0,-8
18621,1,1,507,1736,1229
18622,1,0,28,0,-28
18623,0,0,52,0,-52
18624,1,0,59,0,-59
18625,1,1,836,1424,588
18626,1,1,410,1274,864
18627,0,0,57,0,-57
18628,1,1,437,1323,886
18629,1,1,409,1687,1278
18630,1,1,227,2633,2406
18631,0,0,159,0,-159
18632,0,0,95,0,-95
18633,1,0,28,0,-28
18634,0,0,41,0,-41
18635,1,1,338,1458,1120
18636,1,0,5,0,-5
18637,0,0,51,0,-51
18638,1,1,1312,1550,238
18639,1,0,6,0,-6
18640,1,1,227,1214,987
18641,1,0,92,0,-92
18642,1,0,65,0,-65
18643,0,0,75,0,-75
18644,1,1,45,1642,1597
18645,1,0,77,0,-77
18646,0,0,19,0,-19
18647,1,0,62,0,-62
18648,0,0,2,0,-2
18649,0,0,20,0,-20
18650,0,0,19,0,-19
18651,0,0,25,0,-25
18652,1,1,883,1220,337
18653,0,0,328,0,-328
18654,1,0,23,0,-23
18655,0,0,30,0,-30
18656,1,0,67,0,-67
18657,1,1,1346,1512,166
18658,1,0,77,0,-77
18659,1,0,7,0,-7
18660,0,0,4,0,-4
18661,0,0,13,0,-13
18662,1,1,191,1245,1054
18663,0,0,84,0,-84
18664,1,1,639,1455,816
18665,1,1,345,1724,1379
18666,1,0,4,0,-4
18667,1,0,78,0,-78
18668,1,0,26,0,-26
18669,1,1,362,1448,1086
18670,1,0,44,0,-44
18671,1,0,41,0,-41
18672,0,0,51,0,-51
18673,1,0,55,0,-55
18674,1,0,14,0,-14
18675,0,0,1,0,-1
18676,1,0,5,0,-5
18677,1,1,1297,1387,90
18678,0,0,47,0,-47
18679,1,0,26,0,-26
18680,1,0,71,0,-71
18681,1,1,27,1326,1299
18682,0,0,0,0,0
18683,0,0,91,0,-91
18684,1,1,366,1361,995
18685,0,0,45,0,-45
18686,1,1,335,1561,1226
18687,0,0,4,0,-4
18688,0,0,17,0,-17
18689,0,0,140,0,-140
18690,1,1,2441,1285,-1156
18691,1,0,29,0,-29
18692,1,1,182,1272,1090
18693,1,0,23,0,-23
18694,1,1,1432,1540,108
18695,1,1,212,1510,1298
18696,0,0,21,0,-21
18697,0,0,108,0,-108
18698,1,0,4,0,-4
18699,1,0,50,0,-50
18700,0,0,16,0,-16
18701,1,0,98,0,-98
18702,1,1,233,1503,1270
18703,0,0,64,0,-64
18704,0,0,47,0,-47
18705,1,0,237,0,-237
18706,1,0,41,0,-41
18707,1,1,954,1217,263
18708,1,1,8,1470,1462
18709,0,0,25,0,-25
18710,0,0,93,0,-93
18711,0,0,54,0,-54
18712,1,0,48,0,-48
18713,1,1,666,1564,898
18714,0,0,14,0,-14
18715,0,0,49,0,-49
18716,0,0,55,0,-55
18717,0,0,90,0,-90
18718,1,0,26,0,-26
18719,1,1,813,2181,1368
18720,0,0,64,0,-64
18721,1,1,114,1584,1470
18722,1,0,25,0,-25
18723,1,1,175,1431,1256
18724,1,0,70,0,-70
18725,1,1,150,1575,1425
18726,1,1,1043,1204,161
18727,1,0,43,0,-43
18728,1,0,89,0,-89
18729,1,0,38,0,-38
18730,1,1,1050,1562,512
18731,0,0,108,0,-108
18732,0,0,22,0,-22
18733,0,0,41,0,-41
18734,1,1,157,1215,1058
18735,1,0,15,0,-15
18736,1,1,592,1235,643
18737,1,1,904,1766,862
18738,1,1,350,1818,1468
18739,0,0,22,0,-22
18740,1,0,8,0,-8
18741,0,0,3,0,-3
18742,1,0,72,0,-72
18743,1,1,941,2177,1236
18744,0,0,173,0,-173
18745,0,0,49,0,-49
18746,0,0,53,0,-53
18747,0,0,10,0,-10
18748,0,0,9,0,-9
18749,1,1,311,1356,1045
18750,1,1,277,1703,1426
18751,1,0,4,0,-4
18752,1,1,480,1791,1311
18753,1,0,1,0,-1
18754,1,0,25,0,-25
18755,0,0,65,0,-65
18756,1,1,1170,1405,235
18757,1,1,400,1288,888
18758,1,0,27,0,-27
18759,0,0,24,0,-24
18760,1,0,13,0,-13
18761,1,0,35,0,-35
18762,0,0,51,0,-51
18763,1,1,207,2633,2426
18764,1,1,161,1305,1144
18765,0,0,46,0,-46
18766,1,1,64,2533,2469
18767,0,0,49,0,-49
18768,0,0,40,0,-40
18769,0,0,31,0,-31
18770,0,0,56,0,-56
18771,1,1,1035,1615,580
18772,1,1,2361,1204,-1157
18773,1,1,496,1362,866
18774,1,0,70,0,-70
18775,1,0,33,0,-33
18776,0,0,11,0,-11
18777,1,1,158,1280,1122
18778,1,0,18,0,-18
18779,0,0,110,0,-110
18780,0,0,70,0,-70
18781,1,0,35,0,-35
18782,0,0,53,0,-53
18783,1,1,393,1296,903
18784,0,0,20,0,-20
18785,0,0,168,0,-168
18786,1,0,15,0,-15
18787,0,0,8,0,-8
18788,1,0,73,0,-73
18789,1,1,217,2066,1849
18790,0,0,89,0,-89
18791,0,0,58,0,-58
18792,0,0,11,0,-11
18793,0,0,8,0,-8
18794,0,0,77,0,-77
18795,0,0,46,0,-46
18796,0,0,113,0,-113
18797,1,0,99,0,-99
18798,0,0,3,0,-3
18799,1,1,67,1204,1137
18800,1,0,34,0,-34
18801,1,1,486,1657,1171
18802,0,0,0,0,0
18803,1,1,146,1831,1685
18804,1,1,873,1208,335
18805,1,1,841,2325,1484
18806,1,1,2052,1458,-594
18807,0,0,77,0,-77
18808,0,0,81,0,-81
18809,0,0,26,0,-26
18810,1,1,338,1245,907
18811,1,1,737,1221,484
18812,0,0,23,0,-23
18813,1,1,620,1326,706
18814,0,0,1,0,-1
18815,1,0,11,0,-11
18816,1,0,38,0,-38
18817,0,0,80,0,-80
18818,1,0,36,0,-36
18819,1,1,782,1341,559
18820,1,1,368,1308,940
18821,1,1,2334,1364,-970
18822,0,0,6,0,-6
18823,0,0,119,0,-119
18824,1,0,86,0,-86
18825,1,0,119,0,-119
18826,1,1,1178,1310,132
18827,0,0,23,0,-23
18828,1,1,174,1220,1046
18829,0,0,17,0,-17
18830,1,1,187,2754,2567
18831,0,0,26,0,-26
18832,1,0,86,0,-86
18833,1,0,37,0,-37
18834,1,0,2,0,-2
18835,1,1,1917,1349,-568
18836,1,1,962,1440,478
18837,0,0,11,0,-11
18838,1,0,51,0,-51
18839,1,0,8,0,-8
18840,1,0,131,0,-131
18841,1,1,90,1450,1360
18842,1,0,48,0,-48
18843,1,0,60,0,-60
18844,0,0,31,0,-31
18845,0,0,110,0,-110
18846,0,0,11,0,-11
18847,1,1,1034,1278,244
18848,0,0,114,0,-114
18849,0,0,1,0,-1
18850,0,0,8,0,-8
18851,1,0,47,0,-47
18852,1,0,132,0,-132
18853,1,0,15,0,-15
18854,1,1,96,1283,1187
18855,1,1,238,1206,968
18856,0,0,68,0,-68
18857,0,0,15,0,-15
18858,0,0,1,0,-1
18859,1,0,63,0,-63
18860,0,0,64,0,-64
18861,1,1,626,1216,590
18862,1,1,406,1503,1097
18863,1,0,32,0,-32
18864,1,0,75,0,-75
18865,0,0,61,0,-61
18866,1,0,5,0,-5
18867,1,1,331,1271,940
18868,1,1,752,1615,863
18869,1,1,146,1284,1138
18870,1,0,53,0,-53
18871,1,1,1130,1290,160
18872,1,0,6,0,-6
18873,0,0,22,0,-22
18874,1,1,731,1495,764
18875,0,0,16,0,-16
18876,0,0,119,0,-119
18877,1,1,179,1482,1303
18878,1,0,6,0,-6
18879,1,0,9,0,-9
18880,0,0,5,0,-5
18881,1,0,82,0,-82
18882,0,0,22,0,-22
18883,1,0,65,0,-65
18884,0,0,39,0,-39
18885,0,0,70,0,-70
18886,1,0,29,0,-29
18887,0,0,30,0,-30
18888,0,0,25,0,-25
18889,1,0,0,0,0
18890,0,0,3,0,-3
18891,1,0,79,0,-79
18892,1,1,153,1273,1120
18893,1,0,74,0,-74
18894,0,0,43,0,-43
18895,1,0,40,0,-40
18896,0,0,0,0,0
18897,1,1,288,3937,3649
18898,0,0,46,0,-46
18899,0,0,66,0,-66
18900,1,0,17,0,-17
18901,0,0,60,0,-60
18902,1,1,433,1346,913
18903,1,0,10,0,-10
18904,1,1,405,1879,1474
18905,1,0,31,0,-31
18906,0,0,27,0,-27
18907,1,0,31,0,-31
18908,1,0,89,0,-89
18909,1,0,44,0,-44
18910,1,0,27,0,-27
18911,1,1,1301,2072,771
18912,0,0,57,0,-57
18913,1,1,138,1547,1409
18914,0,0,84,0,-84
18915,1,0,16,0,-16
18916,1,1,1726,1375,-351
18917,1,0,33,0,-33
18918,1,1,1217,1234,17
18919,0,0,182,0,-182
18920,1,0,56,0,-56
18921,0,0,20,0,-20
18922,1,1,1406,1252,-154
18923,1,1,222,1439,1217
18924,1,0,55,0,-55
18925,0,0,8,0,-8
18926,0,0,128,0,-128
18927,1,0,285,0,-285
18928,1,0,59,0,-59
18929,1,1,282,2105,1823
18930,1,0,37,0,-37
18931,1,1,582,1423,841
18932,1,0,14,0,-14
18933,0,0,2,0,-2
18934,1,0,11,0,-11
18935,0,0,86,0,-86
18936,1,0,22,0,-22
18937,0,0,173,0,-173
18938,1,0,14,0,-14
18939,0,0,17,0,-17
18940,1,0,61,0,-61
18941,1,1,1305,1209,-96
18942,1,0,19,0,-19
18943,0,0,7,0,-7
18944,1,0,53,0,-53
18945,1,1,698,1496,798
18946,0,0,51,0,-51
18947,0,0,33,0,-33
18948,0,0,61,0,-61
18949,0,0,51,0,-51
18950,1,0,6,0,-6
18951,0,0,27,0,-27
18952,1,0,52,0,-52
18953,1,0,78,0,-78
18954,0,0,56,0,-56
18955,1,0,125,0,-125
18956,1,1,403,1628,1225
18957,1,0,1,0,-1
18958,0,0,19,0,-19
18959,1,1,184,1503,1319
18960,1,0,80,0,-80
18961,1,0,30,0,-30
18962,1,1,797,1273,476
18963,0,0,96,0,-96
18964,0,0,33,0,-33
18965,0,0,12,0,-12
18966,0,0,49,0,-49
18967,1,0,120,0,-120
18968,1,1,905,1446,541
18969,1,1,94,1706,1612
18970,1,1,118,1712,1594
18971,0,0,53,0,-53
18972,1,0,29,0,-29
18973,1,1,282,1255,973
18974,1,0,95,0,-95
18975,1,0,6,0,-6
18976,1,1,271,1892,1621
18977,1,0,159,0,-159
18978,0,0,16,0,-16
18979,1,0,88,0,-88
18980,0,0,58,0,-58
18981,0,0,71,0,-71
18982,1,1,1072,1448,376
18983,1,1,348,1433,1085
18984,0,0,115,0,-115
18985,1,1,729,1319,590
18986,1,1,291,1809,1518
18987,1,1,101,1935,1834
18988,1,1,385,1374,989
18989,1,0,32,0,-32
18990,1,0,49,0,-49
18991,1,0,93,0,-93
18992,1,1,103,5227,5124
18993,1,0,81,0,-81
18994,1,1,67,1637,1570
18995,0,0,135,0,-135
18996,0,0,92,0,-92
18997,1,0,14,0,-14
18998,0,0,39,0,-39
18999,0,0,94,0,-94
19000,0,0,13,0,-13
19001,0,0,29,0,-29
19002,0,0,14,0,-14
19003,1,1,266,1454,1188
19004,1,0,4,0,-4
19005,1,1,688,1874,1186
19006,1,1,833,2436,1603
19007,1,0,29,0,-29
19008,0,0,21,0,-21
19009,1,0,2,0,-2
19010,1,0,157,0,-157
19011,1,1,428,1295,867
19012,1,1,570,1585,1015
19013,0,0,11,0,-11
19014,1,1,171,1459,1288
19015,0,0,18,0,-18
19016,0,0,36,0,-36
19017,1,1,1173,1702,529
19018,0,0,0,0,0
19019,1,1,1395,1820,425
19020,0,0,36,0,-36
19021,0,0,206,0,-206
19022,1,0,66,0,-66
19023,1,0,38,0,-38
19024,0,0,40,0,-40
19025,1,1,1126,1254,128
19026,1,0,82,0,-82
19027,1,1,212,1659,1447
19028,1,0,15,0,-15
19029,1,0,1,0,-1
19030,1,0,3,0,-3
19031,0,0,134,0,-134
19032,0,0,58,0,-58
19033,0,0,20,0,-20
19034,1,0,13,0,-13
19035,1,1,190,1261,1071
19036,0,0,13,0,-13
19037,1,0,11,0,-11
19038,1,1,393,2020,1627
19039,1,0,15,0,-15
19040,1,1,197,2075,1878
19041,1,1,216,1789,1573
19042,0,0,4,0,-4
19043,1,0,23,0,-23
19044,1,1,51,1389,1338
19045,0,0,11,0,-11
19046,0,0,45,0,-45
19047,1,1,1008,1573,565
19048,1,0,70,0,-70
19049,1,1,730,1689,959
19050,1,0,36,0,-36
19051,0,0,15,0,-15
19052,0,0,39,0,-39
19053,0,0,24,0,-24
19054,0,0,31,0,-31
19055,0,0,26,0,-26
19056,1,0,6,0,-6
19057,1,1,230,1315,1085
19058,1,0,246,0,-246
19059,0,0,26,0,-26
19060,0,0,31,0,-31
19061,0,0,122,0,-122
19062,0,0,28,0,-28
19063,1,1,693,1313,620
19064,0,0,16,0,-16
19065,0,0,28,0,-28
19066,1,1,703,1231,528
19067,1,1,147,1249,1102
19068,1,0,8,0,-8
19069,1,0,130,0,-130
19070,0,0,0,0,0
19071,1,1,233,1472,1239
19072,0,0,26,0,-26
19073,1,0,9,0,-9
19074,1,0,5,0,-5
19075,0,0,27,0,-27
19076,1,0,54,0,-54
19077,1,0,5,0,-5
19078,0,0,19,0,-19
19079,0,0,42,0,-42
19080,0,0,130,0,-130
19081,0,0,54,0,-54
19082,0,0,51,0,-51
19083,0,0,6,0,-6
19084,1,0,1,0,-1
19085,1,1,1393,1310,-83
19086,1,1,602,1352,750
19087,1,1,475,1411,936
19088,0,0,2,0,-2
19089,1,1,23,1410,1387
19090,1,1,173,1228,1055
19091,0,0,72,0,-72
19092,1,1,1199,1766,567
19093,0,0,4,0,-4
19094,1,1,519,1210,691
19095,0,0,6,0,-6
19096,1,0,36,0,-36
19097,1,0,0,0,0
19098,1,0,41,0,-41
19099,0,0,58,0,-58
19100,1,0,28,0,-28
19101,1,0,8,0,-8
19102,1,0,6,0,-6
19103,1,1,17,1413,1396
19104,1,0,73,0,-73
19105,1,1,324,1231,907
19106,0,0,14,0,-14
19107,1,0,50,0,-50
19108,1,1,250,2383,2133
19109,0,0,15,0,-15
19110,0,0,17,0,-17
19111,0,0,126,0,-126
19112,1,0,176,0,-176
19113,1,0,8,0,-8
19114,0,0,84,0,-84
19115,1,0,6,0,-6
19116,0,0,32,0,-32
19117,0,0,79,0,-79
19118,0,0,38,0,-38
19119,1,0,77,0,-77
19120,1,0,1,0,-1
19121,0,0,24,0,-24
19122,1,1,93,1217,1124
19123,1,1,1517,1924,407
19124,0,0,2,0,-2
19125,0,0,48,0,-48
19126,1,0,32,0,-32
19127,1,1,649,1280,631
19128,0,0,27,0,-27
19129,0,0,18,0,-18
19130,1,0,140,0,-140
19131,1,0,7,0,-7
19132,1,0,20,0,-20
19133,0,0,30,0,-30
19134,0,0,45,0,-45
19135,0,0,43,0,-43
19136,1,0,66,0,-66
19137,1,0,58,0,-58
19138,0,0,24,0,-24
19139,0,0,86,0,-86
19140,1,0,0,0,0
19141,0,0,64,0,-64
19142,1,1,742,1437,695
19143,1,1,1085,1241,156
19144,0,0,6,0,-6
19145,1,1,33,1255,1222
19146,1,1,502,1236,734
19147,1,1,1095,1709,614
19148,0,0,90,0,-90
19149,0,0,24,0,-24
19150,1,0,212,0,-212
19151,0,0,149,0,-149
19152,1,0,50,0,-50
19153,0,0,74,0,-74
19154,0,0,29,0,-29
19155,1,1,1060,1248,188
19156,0,0,11,0,-11
19157,1,0,39,0,-39
19158,1,0,13,0,-13
19159,1,1,170,1794,1624
19160,0,0,27,0,-27
19161,0,0,4,0,-4
19162,0,0,40,0,-40
19163,0,0,194,0,-194
19164,1,0,37,0,-37
19165,1,0,159,0,-159
19166,0,0,58,0,-58
19167,0,0,20,0,-20
19168,0,0,13,0,-13
19169,1,0,42,0,-42
19170,0,0,83,0,-83
19171,0,0,51,0,-51
19172,0,0,3,0,-3
19173,0,0,27,0,-27
19174,0,0,23,0,-23
19175,0,0,18,0,-18
19176,1,0,20,0,-20
19177,0,0,96,0,-96
19178,0,0,32,0,-32
19179,1,1,108,1352,1244
19180,1,0,92,0,-92
19181,1,0,13,0,-13
19182,0,0,37,0,-37
19183,0,0,26,0,-26
19184,1,1,170,1395,1225
19185,1,0,8,0,-8
19186,1,0,2,0,-2
19187,1,1,25,1462,1437
19188,0,0,41,0,-41
19189,0,0,15,0,-15
19190,0,0,19,0,-19
19191,1,1,568,2061,1493
19192,0,0,8,0,-8
19193,1,1,999,2160,1161
19194,0,0,2,0,-2
19195,0,0,59,0,-59
19196,1,0,52,0,-52
19197,1,1,447,2416,1969
19198,0,0,32,0,-32
19199,1,1,112,2479,2367
19200,1,0,115,0,-115
19201,1,0,79,0,-79
19202,1,1,571,1806,1235
19203,1,0,39,0,-39
19204,1,1,1122,1351,229
19205,0,0,21,0,-21
19206,1,0,24,0,-24
19207,1,1,307,1335,1028
19208,1,1,477,1276,799
19209,1,1,957,1228,271
19210,1,0,65,0,-65
19211,1,0,3,0,-3
19212,1,0,127,0,-127
19213,1,1,249,1366,1117
19214,1,0,10,0,-10
19215,0,0,10,0,-10
19216,1,1,877,1324,447
19217,1,1,291,1260,969
19218,0,0,146,0,-146
19219,1,1,20,2154,2134
19220,1,1,45,1340,1295
19221,1,0,2,0,-2
19222,0,0,373,0,-373
19223,1,1,166,2598,2432
19224,0,0,27,0,-27
19225,0,0,7,0,-7
19226,1,0,18,0,-18
19227,1,0,5,0,-5
19228,0,0,118,0,-118
19229,1,1,1005,1420,415
19230,0,0,13,0,-13
19231,1,0,51,0,-51
19232,0,0,50,0,-50
19233,1,1,268,1310,1042
19234,1,0,54,0,-54
19235,0,0,22,0,-22
19236,1,0,69,0,-69
19237,0,0,135,0,-135
19238,0,0,8,0,-8
19239,1,1,113,1216,1103
19240,1,0,84,0,-84
19241,0,0,20,0,-20
19242,1,0,49,0,-49
19243,0,0,26,0,-26
19244,0,0,89,0,-89
19245,1,0,35,0,-35
19246,0,0,19,0,-19
19247,1,1,376,1426,1050
19248,0,0,5,0,-5
19249,1,1,647,1307,660
19250,0,0,15,0,-15
19251,0,0,41,0,-41
19252,0,0,73,0,-73
19253,1,1,796,1235,439
19254,1,0,7,0,-7
19255,0,0,23,0,-23
19256,0,0,18,0,-18
19257,1,0,5,0,-5
19258,1,1,909,1810,901
19259,0,0,201,0,-201
19260,0,0,5,0,-5
19261,0,0,18,0,-18
19262,0,0,21,0,-21
19263,1,0,0,0,0
19264,1,1,786,1405,619
19265,1,1,177,1431,1254
19266,1,0,21,0,-21
19267,0,0,11,0,-11
19268,0,0,55,0,-55
19269,1,1,130,1394,1264
19270,0,0,88,0,-88
19271,1,0,36,0,-36
19272,1,0,11,0,-11
19273,0,0,13,0,-13
19274,1,0,24,0,-24
19275,0,0,102,0,-102
19276,0,0,53,0,-53
19277,1,1,569,1458,889
19278,0,0,3,0,-3
19279,1,1,148,1226,1078
19280,1,1,1597,2315,718
19281,1,0,17,0,-17
19282,1,1,265,1596,1331
19283,0,0,1,0,-1
19284,0,0,9,0,-9
19285,0,0,4,0,-4
19286,1,1,387,1253,866
19287,1,0,68,0,-68
19288,1,0,29,0,-29
19289,0,0,4,0,-4
19290,1,0,21,0,-21
19291,1,0,68,0,-68
19292,0,0,63,0,-63
19293,0,0,9,0,-9
19294,1,1,1073,1343,270
19295,0,0,9,0,-9
19296,0,0,246,0,-246
19297,1,0,126,0,-126
19298,1,0,66,0,-66
19299,0,0,42,0,-42
19300,0,0,39,0,-39
19301,1,1,242,1813,1571
19302,1,1,160,1322,1162
19303,1,1,814,1536,722
19304,1,1,94,1997,1903
19305,1,0,50,0,-50
19306,1,1,160,1295,1135
19307,1,1,368,1730,1362
19308,0,0,17,0,-17
19309,0,0,7,0,-7
19310,1,1,264,1302,1038
19311,0,0,29,0,-29
19312,1,0,40,0,-40
19313,1,0,104,0,-104
19314,1,1,31,1296,1265
19315,0,0,8,0,-8
19316,0,0,33,0,-33
19317,0,0,117,0,-117
19318,0,0,13,0,-13
19319,1,1,788,1378,590
19320,0,0,0,0,0
19321,0,0,130,0,-130
19322,1,1,129,1470,1341
19323,1,0,41,0,-41
19324,0,0,21,0,-21
19325,0,0,8,0,-8
19326,0,0,6,0,-6
19327,0,0,253,0,-253
19328,0,0,46,0,-46
19329,1,0,11,0,-11
19330,1,0,69,0,-69
19331,0,0,166,0,-166
19332,1,0,7,0,-7
19333,1,0,17,0,-17
19334,1,1,116,1300,1184
19335,1,1,622,1510,888
19336,1,0,55,0,-55
19337,1,1,83,1386,1303
19338,0,0,10,0,-10
19339,0,0,104,0,-104
19340,0,0,33,0,-33
19341,1,1,351,2720,2369
19342,0,0,1,0,-1
19343,1,0,6,0,-6
19344,0,0,17,0,-17
19345,1,0,42,0,-42
19346,0,0,72,0,-72
19347,0,0,254,0,-254
19348,0,0,68,0,-68
19349,0,0,17,0,-17
19350,1,1,410,1481,1071
19351,1,0,28,0,-28
19352,1,0,133,0,-133
19353,0,0,26,0,-26
19354,0,0,1,0,-1
19355,0,0,0,0,0
19356,1,0,55,0,-55
19357,1,0,19,0,-19
19358,1,1,822,1260,438
19359,0,0,90,0,-90
19360,0,0,30,0,-30
19361,1,1,157,1570,1413
19362,1,0,17,0,-17
19363,1,1,42,1252,1210
19364,1,1,596,1872,1276
19365,0,0,33,0,-33
19366,0,0,18,0,-18
19367,0,0,19,0,-19
19368,0,0,49,0,-49
19369,1,0,115,0,-115
19370,1,0,5,0,-5
19371,1,1,428,1421,993
19372,0,0,17,0,-17
19373,0,0,75,0,-75
19374,0,0,12,0,-12
19375,1,0,20,0,-20
19376,0,0,186,0,-186
19377,0,0,12,0,-12
19378,1,0,23,0,-23
19379,1,0,77,0,-77
19380,1,0,3,0,-3
19381,1,0,29,0,-29
19382,1,0,40,0,-40
19383,0,0,66,0,-66
19384,0,0,10,0,-10
19385,0,0,80,0,-80
19386,0,0,316,0,-316
19387,1,0,56,0,-56
19388,1,0,58,0,-58
19389,1,1,43,2547,2504
19390,1,1,130,1320,1190
19391,1,0,33,0,-33
19392,1,0,15,0,-15
19393,0,0,90,0,-90
19394,0,0,19,0,-19
19395,1,1,1049,1254,205
19396,1,0,80,0,-80
19397,1,0,25,0,-25
19398,1,0,7,0,-7
19399,0,0,71,0,-71
19400,1,0,71,0,-71
19401,1,1,1190,1257,67
19402,0,0,137,0,-137
19403,1,1,113,1323,1210
19404,1,0,4,0,-4
19405,1,0,88,0,-88
19406,1,0,31,0,-31
19407,0,0,6,0,-6
19408,0,0,52,0,-52
19409,1,0,156,0,-156
19410,1,1,170,1703,1533
19411,1,0,54,0,-54
19412,0,0,38,0,-38
19413,1,0,24,0,-24
19414,1,1,285,1418,1133
19415,1,0,15,0,-15
19416,1,0,43,0,-43
19417,1,1,308,1220,912
19418,1,1,210,1680,1470
19419,1,1,101,1455,1354
19420,0,0,28,0,-28
19421,1,0,20,0,-20
19422,1,0,71,0,-71
19423,1,0,62,0,-62
19424,1,1,807,2220,1413
19425,0,0,83,0,-83
19426,1,1,784,1309,525
19427,1,0,37,0,-37
19428,0,0,88,0,-88
19429,0,0,66,0,-66
19430,1,1,582,1649,1067
19431,1,1,1347,1708,361
19432,1,0,10,0,-10
19433,0,0,3,0,-3
19434,1,0,11,0,-11
19435,1,0,120,0,-120
19436,1,0,21,0,-21
19437,1,0,50,0,-50
19438,1,1,185,1265,1080
19439,1,0,49,0,-49
19440,0,0,32,0,-32
19441,1,1,1083,1290,207
19442,0,0,75,0,-75
19443,0,0,168,0,-168
19444,1,1,612,2044,1432
19445,0,0,57,0,-57
19446,1,1,215,1256,1041
19447,0,0,36,0,-36
19448,0,0,193,0,-193
19449,0,0,8,0,-8
19450,0,0,7,0,-7
19451,0,0,67,0,-67
19452,1,1,1097,1703,606
19453,1,1,205,1420,1215
19454,1,0,41,0,-41
19455,0,0,15,0,-15
19456,0,0,46,0,-46
19457,1,1,731,1947,1216
19458,0,0,13,0,-13
19459,0,0,120,0,-120
19460,1,1,431,1215,784
19461,0,0,29,0,-29
19462,0,0,271,0,-271
19463,0,0,82,0,-82
19464,0,0,25,0,-25
19465,1,0,6,0,-6
19466,1,1,664,1760,1096
19467,1,0,26,0,-26
19468,0,0,91,0,-91
19469,0,0,67,0,-67
19470,0,0,109,0,-109
19471,1,1,127,1697,1570
19472,1,0,47,0,-47
19473,1,0,101,0,-101
19474,1,1,239,1509,1270
19475,0,0,83,0,-83
19476,1,0,78,0,-78
19477,1,0,0,0,0
19478,0,0,51,0,-51
19479,1,1,869,1607,738
19480,1,1,290,1896,1606
19481,1,1,1134,1750,616
19482,1,1,26,1201,1175
19483,0,0,7,0,-7
19484,1,1,111,1670,1559
19485,0,0,9,0,-9
19486,0,0,21,0,-21
19487,1,1,699,2079,1380
19488,0,0,0,0,0
19489,1,0,21,0,-21
19490,1,0,40,0,-40
19491,0,0,7,0,-7
19492,1,1,511,1234,723
19493,0,0,48,0,-48
19494,1,1,117,1365,1248
19495,0,0,26,0,-26
19496,1,0,32,0,-32
19497,1,0,7,0,-7
19498,1,0,61,0,-61
19499,1,1,958,1253,295
19500,1,1,194,1427,1233
19501,1,1,453,1283,830
19502,1,0,82,0,-82
19503,1,0,55,0,-55
19504,1,0,4,0,-4
19505,0,0,97,0,-97
19506,0,0,107,0,-107
19507,1,0,9,0,-9
19508,1,0,52,0,-52
19509,0,0,14,0,-14
19510,0,0,25,0,-25
19511,0,0,81,0,-81
19512,1,1,215,6455,6240
19513,1,1,2303,1462,-841
19514,1,0,204,0,-204
19515,1,0,1,0,-1
19516,0,0,34,0,-34
19517,1,1,232,1996,1764
19518,0,0,16,0,-16
19519,1,1,438,1233,795
19520,0,0,75,0,-75
19521,1,1,1534,2308,774
19522,0,0,29,0,-29
19523,1,0,0,0,0
19524,1,1,61,1715,1654
19525,1,0,37,0,-37
19526,1,0,7,0,-7
19527,0,0,23,0,-23
19528,1,1,650,1558,908
19529,1,0,32,0,-32
19530,0,0,40,0,-40
19531,0,0,34,0,-34
19532,0,0,11,0,-11
19533,1,1,101,1262,1161
19534,1,0,1,0,-1
19535,1,1,172,1275,1103
19536,0,0,34,0,-34
19537,0,0,4,0,-4
19538,0,0,27,0,-27
19539,1,0,21,0,-21
19540,1,1,235,1292,1057
19541,0,0,3,0,-3
19542,1,0,15,0,-15
19543,1,1,339,1362,1023
19544,0,0,67,0,-67
19545,0,0,77,0,-77
19546,1,1,395,1470,1075
19547,0,0,67,0,-67
19548,1,1,500,1292,792
19549,1,0,82,0,-82
19550,1,0,87,0,-87
19551,1,0,56,0,-56
19552,0,0,23,0,-23
19553,1,0,112,0,-112
19554,1,1,177,1247,1070
19555,0,0,8,0,-8
19556,1,1,260,1225,965
19557,1,1,144,1406,1262
19558,1,1,109,1277,1168
19559,1,0,10,0,-10
19560,0,0,100,0,-100
19561,1,0,41,0,-41
19562,0,0,97,0,-97
19563,0,0,34,0,-34
19564,1,0,2,0,-2
19565,1,1,125,2875,2750
19566,1,1,2649,1545,-1104
19567,0,0,122,0,-122
19568,1,1,514,1236,722
19569,0,0,54,0,-54
19570,0,0,16,0,-16
19571,0,0,17,0,-17
19572,0,0,9,0,-9
19573,1,0,37,0,-37
19574,1,0,27,0,-27
19575,0,0,23,0,-23
19576,1,0,145,0,-145
19577,1,0,46,0,-46
19578,1,0,0,0,0
19579,0,0,54,0,-54
19580,0,0,38,0,-38
19581,1,0,52,0,-52
19582,0,0,81,0,-81
19583,1,1,301,2099,1798
19584,0,0,71,0,-71
19585,1,1,483,1278,795
19586,0,0,2,0,-2
19587,0,0,41,0,-41
19588,0,0,41,0,-41
19589,1,0,24,0,-24
19590,1,1,1779,1312,-467
19591,1,0,19,0,-19
19592,0,0,34,0,-34
19593,0,0,35,0,-35
19594,1,1,150,1230,1080
19595,0,0,1,0,-1
19596,1,1,1430,1221,-209
19597,0,0,0,0,0
19598,1,0,11,0,-11
19599,1,0,64,0,-64
19600,1,0,91,0,-91
19601,1,1,1002,1225,223
19602,1,0,75,0,-75
19603,1,1,229,1814,1585
19604,1,1,672,1546,874
19605,0,0,27,0,-27
19606,0,0,40,0,-40
19607,1,0,49,0,-49
19608,1,1,198,1363,1165
19609,1,0,54,0,-54
19610,0,0,36,0,-36
19611,1,0,68,0,-68
19612,0,0,98,0,-98
19613,1,1,448,1725,1277
19614,1,1,743,1491,748
19615,1,1,146,1563,1417
19616,1,1,305,1533,1228
19617,0,0,31,0,-31
19618,1,0,178,0,-178
19619,0,0,12,0,-12
19620,0,0,56,0,-56
19621,1,1,668,1475,807
19622,1,1,1130,2313,1183
19623,1,0,38,0,-38
19624,1,1,246,1937,1691
19625,0,0,23,0,-23
19626,1,1,530,1510,980
19627,0,0,12,0,-12
19628,0,0,51,0,-51
19629,1,0,17,0,-17
19630,1,1,604,1215,611
19631,1,1,117,1246,1129
19632,1,1,324,1425,1101
19633,0,0,84,0,-84
19634,1,1,252,1434,1182
19635,1,1,727,2308,1581
19636,1,1,421,1351,930
19637,1,0,19,0,-19
19638,1,0,1,0,-1
19639,1,0,36,0,-36
19640,0,0,39,0,-39
19641,0,0,6,0,-6
19642,1,0,1,0,-1
19643,0,0,48,0,-48
19644,0,0,2,0,-2
19645,1,0,52,0,-52
19646,1,1,216,1642,1426
19647,1,1,248,1256,1008
19648,1,0,46,0,-46
19649,0,0,210,0,-210
19650,1,0,87,0,-87
19651,0,0,39,0,-39
19652,0,0,47,0,-47
19653,0,0,130,0,-130
19654,1,1,246,1984,1738
19655,0,0,13,0,-13
19656,0,0,28,0,-28
19657,1,0,72,0,-72
19658,1,0,42,0,-42
19659,0,0,38,0,-38
19660,1,0,82,0,-82
19661,1,0,38,0,-38
19662,0,0,60,0,-60
19663,0,0,15,0,-15
19664,0,0,4,0,-4
19665,1,0,99,0,-99
19666,0,0,13,0,-13
19667,1,1,1250,2453,1203
19668,1,1,628,1213,585
19669,1,0,29,0,-29
19670,1,0,30,0,-30
19671,1,0,54,0,-54
19672,1,1,923,1776,853
19673,1,0,5,0,-5
19674,0,0,29,0,-29
19675,0,0,54,0,-54
19676,1,1,1491,1521,30
19677,0,0,386,0,-386
19678,1,0,24,0,-24
19679,0,0,2,0,-2
19680,0,0,23,0,-23
19681,0,0,69,0,-69
19682,1,0,33,0,-33
19683,1,0,82,0,-82
19684,0,0,37,0,-37
19685,1,0,18,0,-18
19686,1,0,98,0,-98
19687,1,0,3,0,-3
19688,0,0,79,0,-79
19689,1,0,68,0,-68
19690,1,1,165,1383,1218
19691,0,0,30,0,-30
19692,1,1,402,1327,925
19693,1,0,26,0,-26
19694,0,0,0,0,0
19695,0,0,187,0,-187
19696,1,1,374,1219,845
19697,1,0,100,0,-100
19698,1,0,21,0,-21
19699,0,0,0,0,0
19700,0,0,19,0,-19
19701,1,1,154,1395,1241
19702,1,1,1107,1675,568
19703,0,0,33,0,-33
19704,1,1,100,4689,4589
19705,0,0,84,0,-84
19706,1,1,83,1524,1441
19707,1,0,6,0,-6
19708,0,0,34,0,-34
19709,1,1,452,1261,809
19710,0,0,5,0,-5
19711,1,0,35,0,-35
19712,1,0,6,0,-6
19713,1,1,672,1454,782
19714,0,0,30,0,-30
19715,1,1,324,4327,4003
19716,0,0,203,0,-203
19717,1,1,554,1747,1193
19718,0,0,45,0,-45
19719,0,0,154,0,-154
19720,1,0,7,0,-7
19721,1,1,59,3246,3187
19722,0,0,19,0,-19
19723,1,0,87,0,-87
19724,0,0,29,0,-29
19725,0,0,3,0,-3
19726,1,0,14,0,-14
19727,1,0,104,0,-104
19728,1,0,79,0,-79
19729,1,1,89,1236,1147
19730,1,1,115,1406,1291
19731,1,0,24,0,-24
19732,1,1,545,1281,736
19733,0,0,53,0,-53
19734,0,0,30,0,-30
19735,1,1,473,1295,822
19736,0,0,162,0,-162
19737,1,0,92,0,-92
19738,1,1,1183,1313,130
19739,1,1,4073,1430,-2643
19740,0,0,14,0,-14
19741,1,1,248,1434,1186
19742,1,1,308,1940,1632
19743,1,1,663,1470,807
19744,1,0,55,0,-55
19745,1,0,70,0,-70
19746,1,1,316,1648,1332
19747,0,0,0,0,0
19748,1,0,32,0,-32
19749,1,1,1429,1874,445
19750,0,0,7,0,-7
19751,1,1,462,2029,1567
19752,1,1,32,1244,1212
19753,1,0,69,0,-69
19754,1,0,34,0,-34
19755,0,0,33,0,-33
19756,1,1,121,1334,1213
19757,0,0,137,0,-137
19758,1,0,58,0,-58
19759,1,1,1277,1596,319
19760,1,1,323,1272,949
19761,0,0,93,0,-93
19762,1,0,37,0,-37
19763,1,1,470,1205,735
19764,1,1,632,1267,635
19765,0,0,56,0,-56
19766,0,0,90,0,-90
19767,1,0,63,0,-63
19768,0,0,25,0,-25
19769,0,0,18,0,-18
19770,0,0,0,0,0
19771,0,0,45,0,-45
19772,1,0,10,0,-10
19773,0,0,144,0,-144
19774,0,0,30,0,-30
19775,0,0,85,0,-85
19776,1,1,440,1648,1208
19777,0,0,45,0,-45
19778,0,0,8,0,-8
19779,0,0,40,0,-40
19780,0,0,67,0,-67
19781,0,0,3,0,-3
19782,1,1,59,1290,1231
19783,0,0,2,0,-2
19784,0,0,92,0,-92
19785,1,1,1267,1207,-60
19786,0,0,52,0,-52
19787,1,1,305,1849,1544
19788,1,1,886,1242,356
19789,0,0,178,0,-178
19790,1,1,118,1217,1099
19791,0,0,30,0,-30
19792,0,0,8,0,-8
19793,1,0,106,0,-106
19794,1,0,66,0,-66
19795,1,0,46,0,-46
19796,1,1,222,1894,1672
19797,0,0,105,0,-105
19798,0,0,6,0,-6
19799,0,0,19,0,-19
19800,0,0,20,0,-20
19801,0,0,53,0,-53
19802,1,1,51,1381,1330
19803,0,0,63,0,-63
19804,0,0,14,0,-14
19805,1,1,218,1312,1094
19806,1,1,170,1389,1219
19807,0,0,25,0,-25
19808,1,0,9,0,-9
19809,0,0,109,0,-109
19810,0,0,80,0,-80
19811,1,1,130,1244,1114
19812,0,0,79,0,-79
19813,1,0,27,0,-27
19814,1,0,16,0,-16
19815,1,1,1258,2029,771
19816,1,1,366,1418,1052
19817,1,1,131,2731,2600
19818,1,0,13,0,-13
19819,1,0,44,0,-44
19820,1,1,313,1406,1093
19821,0,0,14,0,-14
19822,0,0,0,0,0
19823,0,0,30,0,-30
19824,0,0,138,0,-138
19825,1,0,36,0,-36
19826,0,0,70,0,-70
19827,1,1,441,1831,1390
19828,1,1,134,1491,1357
19829,1,1,1168,2052,884
19830,0,0,3,0,-3
19831,1,0,169,0,-169
19832,1,1,1153,1502,349
19833,1,0,44,0,-44
19834,0,0,59,0,-59
19835,0,0,11,0,-11
19836,0,0,28,0,-28
19837,1,1,80,1393,1313
19838,1,1,439,1403,964
19839,1,1,203,1297,1094
19840,0,0,60,0,-60
19841,0,0,10,0,-10
19842,0,0,99,0,-99
19843,1,1,163,1308,1145
19844,1,0,8,0,-8
19845,1,0,29,0,-29
19846,0,0,43,0,-43
19847,0,0,40,0,-40
19848,1,0,90,0,-90
19849,1,0,44,0,-44
19850,1,0,84,0,-84
19851,1,1,370,1405,1035
19852,0,0,8,0,-8
19853,1,0,7,0,-7
19854,1,0,43,0,-43
19855,0,0,72,0,-72
19856,0,0,44,0,-44
19857,1,1,537,2075,1538
19858,1,0,8,0,-8
19859,0,0,18,0,-18
19860,0,0,12,0,-12
19861,0,0,47,0,-47
19862,1,0,20,0,-20
19863,0,0,71,0,-71
19864,0,0,36,0,-36
19865,1,1,762,1298,536
19866,0,0,21,0,-21
19867,0,0,27,0,-27
19868,1,1,771,1282,511
19869,0,0,49,0,-49
19870,1,0,42,0,-42
19871,1,1,413,1259,846
19872,0,0,13,0,-13
19873,0,0,51,0,-51
19874,0,0,20,0,-20
19875,1,0,112,0,-112
19876,0,0,7,0,-7
19877,0,0,27,0,-27
19878,0,0,27,0,-27
19879,0,0,57,0,-57
19880,1,1,115,1709,1594
19881,1,0,66,0,-66
19882,1,0,48,0,-48
19883,1,1,284,1413,1129
19884,0,0,36,0,-36
19885,1,0,34,0,-34
19886,1,1,114,1423,1309
19887,1,0,2,0,-2
19888,1,0,25,0,-25
19889,0,0,9,0,-9
19890,1,0,302,0,-302
19891,1,0,48,0,-48
19892,1,0,1,0,-1
19893,0,0,51,0,-51
19894,1,1,24,1679,1655
19895,1,1,1580,1875,295
19896,0,0,46,0,-46
19897,0,0,61,0,-61
19898,1,1,205,2392,2187
19899,1,0,22,0,-22
19900,1,1,1039,1606,567
19901,0,0,93,0,-93
19902,0,0,4,0,-4
19903,0,0,92,0,-92
19904,0,0,56,0,-56
19905,1,1,1133,1471,338
19906,1,0,2,0,-2
19907,1,0,5,0,-5
19908,1,0,20,0,-20
19909,1,0,13,0,-13
19910,0,0,47,0,-47
19911,1,1,194,1585,1391
19912,0,0,25,0,-25
19913,1,1,143,2243,2100
19914,0,0,48,0,-48
19915,0,0,100,0,-100
19916,0,0,5,0,-5
19917,1,0,106,0,-106
19918,1,1,2743,1542,-1201
19919,1,1,607,1206,599
19920,0,0,5,0,-5
19921,0,0,89,0,-89
19922,1,0,39,0,-39
19923,1,1,421,1211,790
19924,0,0,4,0,-4
19925,0,0,61,0,-61
19926,1,0,25,0,-25
19927,1,0,35,0,-35
19928,0,0,10,0,-10
19929,1,1,524,1412,888
19930,1,1,799,1568,769
19931,1,0,41,0,-41
19932,1,1,92,1286,1194
19933,1,0,50,0,-50
19934,1,1,63,1230,1167
19935,0,0,0,0,0
19936,1,0,143,0,-143
19937,1,1,916,1237,321
19938,0,0,44,0,-44
19939,0,0,54,0,-54
19940,1,1,1063,1218,155
19941,1,0,129,0,-129
19942,0,0,3,0,-3
19943,0,0,112,0,-112
19944,1,0,29,0,-29
19945,1,0,59,0,-59
19946,0,0,46,0,-46
19947,1,1,1540,1238,-302
19948,1,0,90,0,-90
19949,1,0,5,0,-5
19950,0,0,41,0,-41
19951,1,0,40,0,-40
19952,1,0,51,0,-51
19953,1,0,6,0,-6
19954,1,1,956,1402,446
19955,1,0,30,0,-30
19956,1,0,165,0,-165
19957,0,0,83,0,-83
19958,1,0,112,0,-112
19959,0,0,25,0,-25
19960,0,0,58,0,-58
19961,1,1,1230,1288,58
19962,1,1,1004,1214,210
19963,0,0,10,0,-10
19964,1,1,1078,1342,264
19965,1,0,23,0,-23
19966,0,0,31,0,-31
19967,0,0,22,0,-22
19968,0,0,62,0,-62
19969,1,1,339,4555,4216
19970,1,1,400,1217,817
19971,0,0,87,0,-87
19972,0,0,153,0,-153
19973,1,0,20,0,-20
19974,1,1,269,1294,1025
19975,1,0,75,0,-75
19976,0,0,39,0,-39
19977,1,1,681,1294,613
19978,1,0,5,0,-5
19979,1,1,60,1256,1196
19980,1,1,1654,1277,-377
19981,0,0,134,0,-134
19982,0,0,7,0,-7
19983,1,1,26,2172,2146
19984,1,0,49,0,-49
19985,0,0,34,0,-34
19986,1,1,582,1350,768
19987,1,1,438,2326,1888
19988,1,0,160,0,-160
19989,0,0,1,0,-1
19990,0,0,4,0,-4
19991,1,1,352,1410,1058
19992,0,0,66,0,-66
19993,1,0,81,0,-81
19994,0,0,48,0,-48
19995,0,0,1,0,-1
19996,0,0,80,0,-80
19997,1,1,472,1904,1432
19998,0,0,13,0,-13
19999,1,0,2,0,-2
20000,1,1,199,1540,1341
20001,0,0,30,0,-30
20002,1,0,16,0,-16
20003,0,0,84,0,-84
20004,0,0,185,0,-185
20005,0,0,26,0,-26
20006,1,0,12,0,-12
20007,0,0,46,0,-46
20008,1,1,866,1382,516
20009,1,0,268,0,-268
20010,0,0,226,0,-226
20011,1,0,5,0,-5
20012,0,0,45,0,-45
20013,0,0,132,0,-132
20014,1,0,148,0,-148
20015,1,1,342,1216,874
20016,0,0,64,0,-64
20017,1,0,15,0,-15
20018,1,1,99,1467,1368
20019,0,0,182,0,-182
20020,1,0,52,0,-52
20021,0,0,24,0,-24
20022,0,0,86,0,-86
20023,0,0,62,0,-62
20024,1,0,104,0,-104
20025,1,1,562,1268,706
20026,0,0,134,0,-134
20027,0,0,64,0,-64
20028,1,1,1689,1302,-387
20029,0,0,14,0,-14
20030,1,0,114,0,-114
20031,1,1,148,1307,1159
20032,1,0,27,0,-27
20033,1,1,188,1642,1454
20034,0,0,378,0,-378
20035,0,0,24,0,-24
20036,1,1,113,1930,1817
20037,0,0,12,0,-12
20038,1,1,517,1299,782
20039,1,1,375,1794,1419
20040,0,0,84,0,-84
20041,1,1,1270,1391,121
20042,0,0,32,0,-32
20043,1,1,955,1435,480
20044,0,0,84,0,-84
20045,0,0,66,0,-66
20046,1,0,53,0,-53
20047,1,0,21,0,-21
20048,0,0,61,0,-61
20049,1,0,0,0,0
20050,0,0,17,0,-17
20051,1,1,300,1440,1140
20052,1,1,590,1386,796
20053,1,1,151,1222,1071
20054,0,0,18,0,-18
20055,1,0,44,0,-44
20056,1,0,11,0,-11
20057,0,0,28,0,-28
20058,1,1,292,2965,2673
20059,1,1,1321,1624,303
20060,1,0,16,0,-16
20061,0,0,4,0,-4
20062,0,0,18,0,-18
20063,0,0,25,0,-25
20064,0,0,12,0,-12
20065,0,0,2,0,-2
20066,1,1,119,1387,1268
20067,0,0,119,0,-119
20068,1,0,177,0,-177
20069,0,0,53,0,-53
20070,0,0,46,0,-46
20071,0,0,32,0,-32
20072,1,0,26,0,-26
20073,0,0,56,0,-56
20074,0,0,18,0,-18
20075,1,1,124,3550,3426
20076,0,0,109,0,-109
20077,1,1,180,1464,1284
20078,1,0,51,0,-51
20079,1,0,213,0,-213
20080,0,0,93,0,-93
20081,1,1,393,1358,965
20082,0,0,34,0,-34
20083,1,1,2302,1271,-1031
20084,1,0,6,0,-6
20085,0,0,2,0,-2
20086,0,0,14,0,-14
20087,1,0,9,0,-9
20088,1,0,88,0,-88
20089,0,0,0,0,0
20090,1,0,15,0,-15
20091,1,0,34,0,-34
20092,1,0,1,0,-1
20093,1,1,526,1253,727
20094,1,0,41,0,-41
20095,1,1,590,1745,1155
20096,1,0,28,0,-28
20097,1,0,17,0,-17
20098,0,0,136,0,-136
20099,1,1,1136,3916,2780
20100,0,0,6,0,-6
20101,0,0,4,0,-4
20102,1,0,37,0,-37
20103,1,0,26,0,-26
20104,1,1,818,1312,494
20105,1,0,49,0,-49
20106,1,0,46,0,-46
20107,0,0,73,0,-73
20108,1,0,2,0,-2
20109,1,0,79,0,-79
20110,0,0,35,0,-35
20111,0,0,14,0,-14
20112,1,0,98,0,-98
20113,1,1,487,1660,1173
20114,1,0,57,0,-57
20115,1,1,34,1221,1187
20116,1,0,28,0,-28
20117,0,0,3,0,-3
20118,1,1,1678,1441,-237
20119,0,0,227,0,-227
20120,1,0,47,0,-47
20121,1,0,10,0,-10
20122,0,0,10,0,-10
20123,1,1,90,1338,1248
20124,1,0,25,0,-25
20125,1,1,335,1284,949
20126,0,0,2,0,-2
20127,1,0,12,0,-12
20128,1,1,181,1852,1671
20129,0,0,40,0,-40
20130,1,0,15,0,-15
20131,1,1,1122,1441,319
20132,0,0,0,0,0
20133,1,0,19,0,-19
20134,0,0,41,0,-41
20135,1,0,6,0,-6
20136,1,0,16,0,-16
20137,1,0,120,0,-120
20138,0,0,93,0,-93
20139,1,0,231,0,-231
20140,1,0,76,0,-76
20141,1,1,433,1255,822
20142,0,0,37,0,-37
20143,1,0,56,0,-56
20144,1,1,147,2376,2229
20145,1,0,53,0,-53
20146,1,0,47,0,-47
20147,0,0,8,0,-8
20148,1,0,16,0,-16
20149,1,0,52,0,-52
20150,1,1,504,1682,1178
20151,0,0,10,0,-10
20152,0,0,14,0,-14
20153,1,0,6,0,-6
20154,0,0,13,0,-13
20155,1,1,489,1650,1161
20156,1,0,112,0,-112
20157,1,0,16,0,-16
20158,1,0,18,0,-18
20159,1,1,559,1453,894
20160,1,1,110,1347,1237
20161,1,1,129,1489,1360
20162,1,0,70,0,-70
20163,0,0,36,0,-36
20164,0,0,1,0,-1
20165,0,0,144,0,-144
20166,1,1,316,1305,989
20167,0,0,108,0,-108
20168,1,0,17,0,-17
20169,0,0,83,0,-83
20170,1,0,0,0,0
20171,1,0,14,0,-14
20172,1,0,82,0,-82
20173,1,0,18,0,-18
20174,1,0,23,0,-23
20175,0,0,142,0,-142
20176,0,0,38,0,-38
20177,1,1,880,1520,640
20178,0,0,96,0,-96
20179,0,0,14,0,-14
20180,0,0,16,0,-16
20181,0,0,27,0,-27
20182,0,0,17,0,-17
20183,1,0,0,0,0
20184,1,1,526,1217,691
20185,1,1,200,1269,1069
20186,1,1,152,2274,2122
20187,1,1,1072,1340,268
20188,1,0,158,0,-158
20189,1,0,16,0,-16
20190,1,0,38,0,-38
20191,0,0,4,0,-4
20192,0,0,72,0,-72
20193,0,0,27,0,-27
20194,1,0,41,0,-41
20195,1,0,19,0,-19
20196,1,0,210,0,-210
20197,1,1,442,1540,1098
20198,0,0,23,0,-23
20199,1,0,57,0,-57
20200,1,1,160,1410,1250
20201,1,1,157,1465,1308
20202,1,0,47,0,-47
20203,0,0,267,0,-267
20204,1,0,84,0,-84
20205,0,0,1,0,-1
20206,1,0,34,0,-34
20207,1,0,3,0,-3
20208,1,1,1053,1731,678
20209,1,0,165,0,-165
20210,1,1,852,1224,372
20211,1,0,8,0,-8
20212,1,1,1705,1888,183
20213,0,0,36,0,-36
20214,1,0,104,0,-104
20215,0,0,6,0,-6
20216,1,1,256,1318,1062
20217,1,1,305,1640,1335
20218,0,0,28,0,-28
20219,1,1,1130,2035,905
20220,0,0,0,0,0
20221,1,0,74,0,-74
20222,1,1,46,2995,2949
20223,1,0,83,0,-83
20224,0,0,34,0,-34
20225,1,0,61,0,-61
20226,1,1,777,2067,1290
20227,0,0,38,0,-38
20228,1,1,123,1200,1077
20229,0,0,57,0,-57
20230,0,0,29,0,-29
20231,0,0,81,0,-81
20232,1,1,110,1446,1336
20233,0,0,121,0,-121
20234,1,1,170,1350,1180
20235,0,0,12,0,-12
20236,1,0,177,0,-177
20237,0,0,40,0,-40
20238,0,0,29,0,-29
20239,0,0,42,0,-42
20240,0,0,1,0,-1
20241,1,1,550,1388,838
20242,1,1,537,1724,1187
20243,1,0,190,0,-190
20244,1,0,55,0,-55
20245,1,0,25,0,-25
20246,0,0,44,0,-44
20247,1,0,87,0,-87
20248,1,0,78,0,-78
20249,0,0,38,0,-38
20250,1,0,153,0,-153
20251,0,0,65,0,-65
20252,1,1,1530,3311,1781
20253,0,0,14,0,-14
20254,1,1,143,1276,1133
20255,1,0,13,0,-13
20256,1,0,21,0,-21
20257,1,1,831,1202,371
20258,1,0,25,0,-25
20259,1,1,764,1201,437
20260,1,1,135,1640,1505
20261,0,0,40,0,-40
20262,1,1,80,1360,1280
20263,0,0,85,0,-85
20264,1,1,246,1806,1560
20265,1,1,260,1589,1329
20266,0,0,95,0,-95
20267,1,0,12,0,-12
20268,1,1,312,1755,1443
20269,1,0,6,0,-6
20270,1,1,267,2097,1830
20271,1,0,174,0,-174
20272,1,0,11,0,-11
20273,0,0,41,0,-41
20274,0,0,58,0,-58
20275,0,0,48,0,-48
20276,0,0,37,0,-37
20277,1,1,535,1424,889
20278,1,1,516,4192,3676
20279,0,0,101,0,-101
20280,0,0,105,0,-105
20281,0,0,56,0,-56
20282,0,0,123,0,-123
20283,0,0,34,0,-34
20284,1,0,73,0,-73
20285,1,1,61,1509,1448
20286,1,1,518,2624,2106
20287,0,0,112,0,-112
20288,1,0,11,0,-11
20289,1,1,214,1282,1068
20290,1,0,15,0,-15
20291,1,0,54,0,-54
20292,1,0,15,0,-15
20293,1,1,719,1357,638
20294,1,1,956,1630,674
20295,0,0,5,0,-5
20296,1,1,2038,1364,-674
20297,0,0,4,0,-4
20298,0,0,17,0,-17
20299,0,0,13,0,-13
20300,1,1,272,1403,1131
20301,1,1,304,1243,939
20302,1,0,41,0,-41
20303,0,0,169,0,-169
20304,1,1,737,2103,1366
20305,1,0,152,0,-152
20306,0,0,73,0,-73
20307,1,1,1322,1980,658
20308,0,0,90,0,-90
20309,1,0,14,0,-14
20310,1,0,6,0,-6
20311,1,1,1369,2649,1280
20312,1,1,95,1472,1377
20313,1,1,251,1260,1009
20314,1,0,85,0,-85
20315,1,1,1371,2240,869
20316,1,1,258,1218,960
20317,1,0,67,0,-67
20318,1,1,285,1331,1046
20319,0,0,13,0,-13
20320,0,0,132,0,-132
20321,0,0,0,0,0
20322,0,0,32,0,-32
20323,0,0,5,0,-5
20324,0,0,51,0,-51
20325,0,0,106,0,-106
20326,1,0,54,0,-54
20327,0,0,40,0,-40
20328,1,1,1025,1358,333
20329,1,1,433,3253,2820
20330,1,0,115,0,-115
20331,0,0,35,0,-35
20332,0,0,234,0,-234
20333,1,0,21,0,-21
20334,0,0,21,0,-21
20335,1,1,675,1731,1056
20336,1,1,158,1306,1148
20337,1,1,1336,2468,1132
20338,0,0,32,0,-32
20339,1,0,34,0,-34
20340,0,0,66,0,-66
20341,0,0,45,0,-45
20342,1,1,125,1492,1367
20343,1,1,266,2768,2502
20344,1,1,679,1567,888
20345,1,1,289,1304,1015
20346,1,0,34,0,-34
20347,0,0,13,0,-13
20348,0,0,65,0,-65
20349,1,0,39,0,-39
20350,1,0,2,0,-2
20351,1,1,723,2086,1363
20352,1,0,54,0,-54
20353,1,0,7,0,-7
20354,1,0,63,0,-63
20355,0,0,22,0,-22
20356,1,1,3450,1348,-2102
20357,0,0,88,0,-88
20358,1,1,106,3559,3453
20359,0,0,2,0,-2
20360,0,0,13,0,-13
20361,1,1,353,1960,1607
20362,0,0,15,0,-15
20363,1,0,32,0,-32
20364,0,0,104,0,-104
20365,1,1,637,1985,1348
20366,1,0,44,0,-44
20367,0,0,77,0,-77
20368,0,0,142,0,-142
20369,1,1,60,1244,1184
20370,1,0,12,0,-12
20371,0,0,9,0,-9
20372,1,1,95,1203,1108
20373,1,0,22,0,-22
20374,1,1,469,1284,815
20375,0,0,40,0,-40
20376,0,0,89,0,-89
20377,0,0,85,0,-85
20378,0,0,120,0,-120
20379,0,0,20,0,-20
20380,1,1,1019,1606,587
20381,1,1,113,1394,1281
20382,1,1,16,1245,1229
20383,0,0,8,0,-8
20384,0,0,25,0,-25
20385,1,0,188,0,-188
20386,1,0,31,0,-31
20387,1,0,14,0,-14
20388,1,1,156,1634,1478
20389,1,0,95,0,-95
20390,0,0,26,0,-26
20391,1,1,426,1234,808
20392,0,0,155,0,-155
20393,1,1,34,1293,1259
20394,0,0,28,0,-28
20395,0,0,81,0,-81
20396,1,1,189,2813,2624
20397,0,0,5,0,-5
20398,0,0,27,0,-27
20399,0,0,5,0,-5
20400,1,1,578,2191,1613
20401,1,1,1028,1248,220
20402,0,0,1,0,-1
20403,1,0,107,0,-107
20404,1,1,208,1460,1252
20405,1,1,54,2814,2760
20406,1,1,709,1299,590
20407,1,1,32,1213,1181
20408,1,0,2,0,-2
20409,0,0,54,0,-54
20410,1,0,4,0,-4
20411,0,0,9,0,-9
20412,1,0,42,0,-42
20413,1,0,24,0,-24
20414,1,0,19,0,-19
20415,1,0,54,0,-54
20416,1,0,16,0,-16
20417,1,1,717,1339,622
20418,1,0,199,0,-199
20419,1,1,174,1267,1093
20420,1,1,440,1211,771
20421,1,1,84,1501,1417
20422,1,1,321,1261,940
20423,1,0,109,0,-109
20424,1,1,654,1574,920
20425,1,0,19,0,-19
20426,0,0,117,0,-117
20427,1,0,12,0,-12
20428,1,1,287,1286,999
20429,1,0,6,0,-6
20430,1,0,13,0,-13
20431,0,0,30,0,-30
20432,1,1,1508,1566,58
20433,1,0,94,0,-94
20434,0,0,106,0,-106
20435,1,0,38,0,-38
20436,0,0,8,0,-8
20437,0,0,12,0,-12
20438,0,0,8,0,-8
20439,0,0,27,0,-27
20440,1,0,65,0,-65
20441,1,0,177,0,-177
20442,1,0,118,0,-118
20443,1,1,199,1316,1117
20444,1,1,387,1257,870
20445,1,0,34,0,-34
20446,1,1,121,2311,2190
20447,0,0,34,0,-34
20448,0,0,58,0,-58
20449,1,0,95,0,-95
20450,0,0,37,0,-37
20451,1,1,117,1265,1148
20452,0,0,28,0,-28
20453,1,0,78,0,-78
20454,1,0,41,0,-41
20455,0,0,4,0,-4
20456,0,0,123,0,-123
20457,0,0,3,0,-3
20458,1,0,67,0,-67
20459,1,0,13,0,-13
20460,0,0,45,0,-45
20461,0,0,63,0,-63
20462,0,0,78,0,-78
20463,1,0,92,0,-92
20464,1,1,994,1299,305
20465,0,0,1,0,-1
20466,0,0,30,0,-30
20467,0,0,5,0,-5
20468,1,1,542,1441,899
20469,1,0,9,0,-9
20470,0,0,14,0,-14
20471,1,0,75,0,-75
20472,0,0,25,0,-25
20473,1,1,541,1825,1284
20474,0,0,6,0,-6
20475,1,0,78,0,-78
20476,1,1,221,1247,1026
20477,1,1,2088,1566,-522
20478,1,1,244,1261,1017
20479,1,1,563,1411,848
20480,0,0,94,0,-94
20481,0,0,6,0,-6
20482,0,0,4,0,-4
20483,0,0,17,0,-17
20484,0,0,39,0,-39
20485,0,0,17,0,-17
20486,1,1,116,1212,1096
20487,1,1,689,1399,710
20488,0,0,115,0,-115
20489,1,0,113,0,-113
20490,1,0,39,0,-39
20491,0,0,31,0,-31
20492,0,0,52,0,-52
20493,1,1,1254,1924,670
20494,1,0,25,0,-25
20495,0,0,66,0,-66
20496,1,1,637,2569,1932
20497,0,0,12,0,-12
20498,1,1,413,2190,1777
20499,1,0,11,0,-11
20500,1,0,16,0,-16
20501,1,1,497,1330,833
20502,0,0,1,0,-1
20503,0,0,1,0,-1
20504,1,1,865,2199,1334
20505,1,0,119,0,-119
20506,1,0,88,0,-88
20507,0,0,55,0,-55
20508,1,0,0,0,0
20509,1,1,226,1203,977
20510,0,0,1,0,-1
20511,1,1,342,1376,1034
20512,0,0,151,0,-151
20513,0,0,44,0,-44
20514,1,1,1115,1200,85
20515,1,1,940,1715,775
20516,1,1,2067,1565,-502
20517,0,0,57,0,-57
20518,1,1,246,1541,1295
20519,0,0,164,0,-164
20520,0,0,1,0,-1
20521,1,0,83,0,-83
20522,1,1,623,1320,697
20523,1,0,17,0,-17
20524,1,0,38,0,-38
20525,0,0,51,0,-51
20526,1,0,8,0,-8
20527,1,1,1503,1217,-286
20528,1,0,69,0,-69
20529,0,0,86,0,-86
20530,0,0,42,0,-42
20531,1,1,243,1336,1093
20532,0,0,49,0,-49
20533,0,0,35,0,-35
20534,1,0,28,0,-28
20535,0,0,26,0,-26
20536,0,0,11,0,-11
20537,1,0,227,0,-227
20538,0,0,1,0,-1
20539,0,0,57,0,-57
20540,1,0,61,0,-61
20541,1,0,18,0,-18
20542,1,0,21,0,-21
20543,1,0,3,0,-3
20544,1,1,479,1928,1449
20545,0,0,63,0,-63
20546,1,0,64,0,-64
20547,0,0,56,0,-56
20548,0,0,4,0,-4
20549,1,1,58,2966,2908
20550,0,0,45,0,-45
20551,1,1,194,1223,1029
20552,1,0,18,0,-18
20553,1,0,5,0,-5
20554,1,0,153,0,-153
20555,0,0,10,0,-10
20556,1,1,145,2015,1870
20557,1,0,60,0,-60
20558,1,0,167,0,-167
20559,0,0,3,0,-3
20560,0,0,0,0,0
20561,0,0,37,0,-37
20562,1,0,60,0,-60
20563,1,0,38,0,-38
20564,0,0,17,0,-17
20565,1,0,33,0,-33
20566,0,0,37,0,-37
20567,0,0,5,0,-5
20568,1,0,85,0,-85
20569,0,0,20,0,-20
20570,1,0,158,0,-158
20571,0,0,7,0,-7
20572,1,1,1570,1899,329
20573,0,0,104,0,-104
20574,0,0,21,0,-21
20575,1,1,831,1460,629
20576,0,0,40,0,-40
20577,0,0,30,0,-30
20578,0,0,32,0,-32
20579,0,0,38,0,-38
20580,1,0,57,0,-57
20581,1,0,16,0,-16
20582,1,0,43,0,-43
20583,0,0,14,0,-14
20584,1,0,80,0,-80
20585,0,0,4,0,-4
20586,0,0,46,0,-46
20587,1,0,6,0,-6
20588,0,0,23,0,-23
20589,1,1,543,1571,1028
20590,1,0,60,0,-60
20591,0,0,115,0,-115
20592,1,0,77,0,-77
20593,0,0,139,0,-139
20594,1,1,73,1313,1240
20595,0,0,56,0,-56
20596,1,0,146,0,-146
20597,1,1,859,1500,641
20598,0,0,85,0,-85
20599,1,1,317,1214,897
20600,1,0,9,0,-9
20601,0,0,64,0,-64
20602,1,1,283,1681,1398
20603,0,0,1,0,-1
20604,0,0,9,0,-9
20605,0,0,13,0,-13
20606,0,0,32,0,-32
20607,1,0,2,0,-2
20608,1,1,153,1247,1094
20609,1,0,172,0,-172
20610,1,0,1,0,-1
20611,1,1,131,1769,1638
20612,0,0,162,0,-162
20613,1,0,98,0,-98
20614,1,1,595,1570,975
20615,0,0,18,0,-18
20616,1,0,104,0,-104
20617,1,1,549,1866,1317
20618,1,1,194,1502,1308
20619,0,0,113,0,-113
20620,1,1,141,1634,1493
20621,1,0,2,0,-2
20622,0,0,37,0,-37
20623,0,0,207,0,-207
20624,0,0,96,0,-96
20625,0,0,88,0,-88
20626,1,1,78,1562,1484
20627,1,0,11,0,-11
20628,0,0,9,0,-9
20629,1,1,2450,1293,-1157
20630,0,0,43,0,-43
20631,1,0,11,0,-11
20632,0,0,26,0,-26
20633,1,0,151,0,-151
20634,1,0,65,0,-65
20635,0,0,90,0,-90
20636,0,0,23,0,-23
20637,1,0,41,0,-41
20638,1,0,39,0,-39
20639,0,0,6,0,-6
20640,0,0,16,0,-16
20641,1,1,101,1455,1354
20642,1,1,159,1201,1042
20643,0,0,32,0,-32
20644,1,0,110,0,-110
20645,0,0,130,0,-130
20646,1,1,172,1341,1169
20647,1,1,111,2260,2149
20648,0,0,26,0,-26
20649,0,0,58,0,-58
20650,0,0,7,0,-7
20651,1,0,28,0,-28
20652,1,1,441,1442,1001
20653,1,0,51,0,-51
20654,1,0,8,0,-8
20655,0,0,35,0,-35
20656,1,1,231,1624,1393
20657,0,0,36,0,-36
20658,0,0,39,0,-39
20659,1,1,230,1261,1031
20660,0,0,61,0,-61
20661,0,0,67,0,-67
20662,1,1,155,1578,1423
20663,0,0,34,0,-34
20664,1,1,550,1311,761
20665,0,0,82,0,-82
20666,1,1,729,2622,1893
20667,0,0,44,0,-44
20668,0,0,5,0,-5
20669,1,0,1,0,-1
20670,1,1,388,1224,836
20671,1,1,743,1202,459
20672,0,0,315,0,-315
20673,1,0,49,0,-49
20674,1,1,121,1361,1240
20675,1,0,21,0,-21
20676,0,0,12,0,-12
20677,1,0,24,0,-24
20678,0,0,72,0,-72
20679,1,0,41,0,-41
20680,1,0,9,0,-9
20681,0,0,81,0,-81
20682,1,0,5,0,-5
20683,0,0,75,0,-75
20684,0,0,154,0,-154
20685,1,0,17,0,-17
20686,1,0,148,0,-148
20687,0,0,6,0,-6
20688,0,0,40,0,-40
20689,1,0,180,0,-180
20690,1,1,265,1397,1132
20691,1,1,37,1519,1482
20692,1,1,549,1432,883
20693,0,0,171,0,-171
20694,0,0,44,0,-44
20695,1,1,53,1273,1220
20696,1,0,59,0,-59
20697,0,0,6,0,-6
20698,0,0,9,0,-9
20699,1,0,33,0,-33
20700,1,0,86,0,-86
20701,0,0,45,0,-45
20702,1,0,13,0,-13
20703,0,0,7,0,-7
20704,0,0,1,0,-1
20705,1,0,5,0,-5
20706,0,0,52,0,-52
20707,1,1,496,1273,777
20708,0,0,13,0,-13
20709,1,1,896,1416,520
20710,0,0,11,0,-11
20711,1,0,428,0,-428
20712,1,1,206,1431,1225
20713,1,0,52,0,-52
20714,0,0,34,0,-34
20715,1,1,676,1948,1272
20716,0,0,2,0,-2
20717,1,0,5,0,-5
20718,1,0,0,0,0
20719,0,0,51,0,-51
20720,1,1,291,1345,1054
20721,1,1,211,1541,1330
20722,0,0,119,0,-119
20723,1,1,279,1393,1114
20724,0,0,162,0,-162
20725,1,1,123,2258,2135
20726,1,0,45,0,-45
20727,1,1,998,1322,324
20728,0,0,89,0,-89
20729,1,0,15,0,-15
20730,0,0,37,0,-37
20731,1,1,385,1394,1009
20732,0,0,127,0,-127
20733,1,1,546,1279,733
20734,1,0,192,0,-192
20735,1,1,188,1728,1540
20736,1,1,1030,1892,862
20737,1,0,0,0,0
20738,0,0,66,0,-66
20739,1,1,122,1273,1151
20740,0,0,14,0,-14
20741,1,0,17,0,-17
20742,0,0,0,0,0
20743,0,0,35,0,-35
20744,0,0,79,0,-79
20745,0,0,1,0,-1
20746,1,1,393,1202,809
20747,0,0,18,0,-18
20748,1,1,268,2605,2337
20749,1,1,117,2383,2266
20750,0,0,3,0,-3
20751,0,0,13,0,-13
20752,1,1,321,1413,1092
20753,1,1,430,1648,1218
20754,1,1,527,1258,731
20755,1,0,141,0,-141
20756,0,0,39,0,-39
20757,1,0,2,0,-2
20758,1,1,235,1377,1142
20759,1,1,1577,1210,-367
20760,1,1,846,1573,727
20761,1,0,34,0,-34
20762,1,0,91,0,-91
20763,0,0,49,0,-49
20764,0,0,27,0,-27
20765,1,0,11,0,-11
20766,0,0,6,0,-6
20767,1,0,57,0,-57
20768,1,1,372,1244,872
20769,1,1,469,1652,1183
20770,1,0,9,0,-9
20771,1,0,28,0,-28
20772,1,0,62,0,-62
20773,0,0,2,0,-2
20774,0,0,0,0,0
20775,1,0,69,0,-69
20776,1,1,248,1456,1208
20777,0,0,19,0,-19
20778,0,0,22,0,-22
20779,1,0,17,0,-17
20780,1,0,98,0,-98
20781,1,1,126,1389,1263
20782,0,0,24,0,-24
20783,1,0,2,0,-2
20784,0,0,49,0,-49
20785,1,1,608,1253,645
20786,1,1,101,1555,1454
20787,0,0,13,0,-13
20788,0,0,29,0,-29
20789,1,1,336,1224,888
20790,1,0,4,0,-4
20791,1,1,2444,3487,1043
20792,1,0,59,0,-59
20793,1,1,424,1551,1127
20794,1,0,25,0,-25
20795,1,1,34,1435,1401
20796,1,0,105,0,-105
20797,0,0,12,0,-12
20798,1,0,247,0,-247
20799,0,0,219,0,-219
20800,0,0,2,0,-2
20801,1,1,595,1222,627
20802,0,0,61,0,-61
20803,1,0,24,0,-24
20804,1,0,68,0,-68
20805,0,0,11,0,-11
20806,0,0,45,0,-45
20807,0,0,72,0,-72
20808,1,0,4,0,-4
20809,1,1,727,2369,1642
20810,0,0,25,0,-25
20811,1,1,119,1253,1134
20812,0,0,106,0,-106
20813,0,0,28,0,-28
20814,1,0,48,0,-48
20815,0,0,16,0,-16
20816,1,0,19,0,-19
20817,0,0,101,0,-101
20818,1,1,971,1569,598
20819,1,0,65,0,-65
20820,0,0,319,0,-319
20821,0,0,83,0,-83
20822,0,0,35,0,-35
20823,1,0,29,0,-29
20824,1,1,850,1218,368
20825,1,0,83,0,-83
20826,1,1,71,2211,2140
20827,1,0,35,0,-35
20828,1,1,465,1611,1146
20829,1,1,612,1296,684
20830,0,0,67,0,-67
20831,0,0,67,0,-67
20832,0,0,49,0,-49
20833,0,0,44,0,-44
20834,0,0,110,0,-110
20835,1,0,116,0,-116
20836,1,0,44,0,-44
20837,1,0,22,0,-22
20838,1,1,80,1314,1234
20839,1,1,205,1295,1090
20840,0,0,86,0,-86
20841,1,0,27,0,-27
20842,1,0,58,0,-58
20843,0,0,70,0,-70
20844,1,0,40,0,-40
20845,0,0,86,0,-86
20846,0,0,7,0,-7
20847,0,0,32,0,-32
20848,1,1,311,1339,1028
20849,1,0,7,0,-7
20850,1,0,87,0,-87
20851,1,0,58,0,-58
20852,1,0,6,0,-6
20853,0,0,31,0,-31
20854,1,1,534,1545,1011
20855,1,1,814,1406,592
20856,0,0,15,0,-15
20857,0,0,70,0,-70
20858,1,1,1548,1297,-251
20859,1,1,147,1668,1521
20860,0,0,3,0,-3
20861,1,0,85,0,-85
20862,1,0,10,0,-10
20863,1,1,864,1558,694
20864,1,1,883,2031,1148
20865,0,0,37,0,-37
20866,0,0,58,0,-58
20867,1,0,12,0,-12
20868,0,0,46,0,-46
20869,1,0,95,0,-95
20870,0,0,2,0,-2
20871,1,1,168,1514,1346
20872,0,0,12,0,-12
20873,1,1,133,1327,1194
20874,0,0,10,0,-10
20875,0,0,43,0,-43
20876,1,1,604,1932,1328
20877,0,0,3,0,-3
20878,0,0,49,0,-49
20879,0,0,65,0,-65
20880,1,1,1295,1279,-16
20881,0,0,78,0,-78
20882,1,0,33,0,-33
20883,0,0,52,0,-52
20884,1,1,710,2392,1682
20885,0,0,69,0,-69
20886,1,0,2,0,-2
20887,0,0,1,0,-1
20888,1,0,5,0,-5
20889,1,0,61,0,-61
20890,1,1,341,1260,919
20891,1,0,12,0,-12
20892,1,0,61,0,-61
20893,0,0,56,0,-56
20894,1,0,34,0,-34
20895,0,0,32,0,-32
20896,0,0,38,0,-38
20897,0,0,1,0,-1
20898,1,0,48,0,-48
20899,1,0,9,0,-9
20900,0,0,58,0,-58
20901,1,1,224,1301,1077
20902,1,0,133,0,-133
20903,1,1,18,2087,2069
20904,0,0,80,0,-80
20905,1,1,193,1303,1110
20906,0,0,290,0,-290
20907,1,1,332,1825,1493
20908,1,1,308,1396,1088
20909,0,0,44,0,-44
20910,0,0,38,0,-38
20911,1,0,65,0,-65
20912,0,0,33,0,-33
20913,1,1,57,1314,1257
20914,0,0,123,0,-123
20915,1,0,68,0,-68
20916,1,1,598,1562,964
20917,1,0,22,0,-22
20918,0,0,24,0,-24
20919,1,1,98,2082,1984
20920,0,0,174,0,-174
20921,0,0,90,0,-90
20922,1,0,49,0,-49
20923,1,0,28,0,-28
20924,0,0,9,0,-9
20925,0,0,156,0,-156
20926,1,1,293,1216,923
20927,0,0,73,0,-73
20928,1,1,136,1300,1164
20929,1,1,1240,1449,209
20930,0,0,121,0,-121
20931,0,0,37,0,-37
20932,0,0,17,0,-17
20933,1,0,66,0,-66
20934,0,0,103,0,-103
20935,0,0,72,0,-72
20936,0,0,41,0,-41
20937,0,0,61,0,-61
20938,0,0,5,0,-5
20939,0,0,10,0,-10
20940,1,0,2,0,-2
20941,1,1,802,1308,506
20942,1,1,334,1238,904
20943,0,0,6,0,-6
20944,1,0,23,0,-23
20945,0,0,14,0,-14
20946,1,1,1602,1265,-337
20947,0,0,35,0,-35
20948,1,1,9,2027,2018
20949,1,1,216,1844,1628
20950,0,0,176,0,-176
20951,1,0,0,0,0
20952,0,0,6,0,-6
20953,1,1,143,1512,1369
20954,1,1,1294,1712,418
20955,1,1,95,1212,1117
20956,0,0,93,0,-93
20957,1,0,7,0,-7
20958,1,0,37,0,-37
20959,0,0,17,0,-17
20960,1,1,260,1501,1241
20961,1,0,48,0,-48
20962,1,1,149,1404,1255
20963,0,0,26,0,-26
20964,0,0,21,0,-21
20965,1,0,17,0,-17
20966,0,0,11,0,-11
20967,1,0,10,0,-10
20968,1,0,29,0,-29
20969,1,1,666,1288,622
20970,1,1,322,2343,2021
20971,0,0,17,0,-17
20972,0,0,71,0,-71
20973,0,0,16,0,-16
20974,1,1,101,1292,1191
20975,1,0,18,0,-18
20976,1,0,67,0,-67
20977,1,0,27,0,-27
20978,0,0,50,0,-50
20979,0,0,54,0,-54
20980,0,0,12,0,-12
20981,0,0,19,0,-19
20982,1,0,51,0,-51
20983,0,0,55,0,-55
20984,0,0,20,0,-20
20985,0,0,175,0,-175
20986,1,1,623,1733,1110
20987,0,0,21,0,-21
20988,0,0,32,0,-32
20989,1,0,56,0,-56
20990,0,0,5,0,-5
20991,1,0,23,0,-23
20992,1,0,38,0,-38
20993,0,0,31,0,-31
20994,1,0,1,0,-1
20995,1,1,591,1302,711
20996,1,1,377,1304,927
20997,1,1,181,1235,1054
20998,0,0,33,0,-33
20999,0,0,53,0,-53
21000,1,0,12,0,-12
21001,1,1,525,1253,728
21002,0,0,25,0,-25
21003,0,0,19,0,-19
21004,1,1,74,1733,1659
21005,0,0,47,0,-47
21006,1,0,18,0,-18
21007,0,0,22,0,-22
21008,1,1,671,1265,594
21009,1,1,1542,1759,217
21010,1,0,19,0,-19
21011,0,0,18,0,-18
21012,0,0,23,0,-23
21013,0,0,81,0,-81
21014,0,0,37,0,-37
21015,0,0,64,0,-64
21016,1,1,319,1543,1224
21017,1,1,99,1833,1734
21018,0,0,15,0,-15
21019,0,0,199,0,-199
21020,0,0,52,0,-52
21021,1,1,443,1216,773
21022,1,0,7,0,-7
21023,0,0,15,0,-15
21024,1,1,1044,1397,353
21025,0,0,35,0,-35
21026,0,0,8,0,-8
21027,1,0,66,0,-66
21028,1,1,381,2156,1775
21029,1,1,142,1449,1307
21030,0,0,32,0,-32
21031,1,1,1048,1660,612
21032,0,0,53,0,-53
21033,1,1,22,1517,1495
21034,1,1,6,1402,1396
21035,1,1,368,3427,3059
21036,1,1,369,1659,1290
21037,1,1,288,1303,1015
21038,0,0,49,0,-49
21039,0,0,26,0,-26
21040,1,0,6,0,-6
21041,0,0,412,0,-412
21042,0,0,75,0,-75
21043,1,1,39,1409,1370
21044,0,0,40,0,-40
21045,1,0,28,0,-28
21046,0,0,19,0,-19
21047,1,0,26,0,-26
21048,1,1,408,1218,810
21049,1,1,513,1225,712
21050,1,1,386,1674,1288
21051,1,1,67,1945,1878
21052,1,1,215,1450,1235
21053,0,0,133,0,-133
21054,1,1,322,1243,921
21055,1,1,141,1830,1689
21056,1,1,372,1571,1199
21057,1,1,1243,1421,178
21058,1,0,4,0,-4
21059,1,0,20,0,-20
21060,1,1,419,1511,1092
21061,1,1,690,1343,653
21062,1,1,591,1846,1255
21063,0,0,48,0,-48
21064,1,0,104,0,-104
21065,1,0,19,0,-19
21066,1,1,410,1693,1283
21067,1,0,222,0,-222
21068,1,1,2061,1496,-565
21069,0,0,64,0,-64
21070,0,0,10,0,-10
21071,1,0,8,0,-8
21072,1,0,195,0,-195
21073,1,0,29,0,-29
21074,0,0,17,0,-17
21075,1,0,12,0,-12
21076,1,1,580,1317,737
21077,0,0,95,0,-95
21078,0,0,17,0,-17
21079,0,0,1,0,-1
21080,1,1,202,1327,1125
21081,1,0,31,0,-31
21082,1,1,1048,1214,166
21083,1,1,222,4408,4186
21084,1,0,189,0,-189
21085,1,0,8,0,-8
21086,1,0,48,0,-48
21087,1,0,13,0,-13
21088,1,1,742,1265,523
21089,1,1,801,1212,411
21090,1,0,59,0,-59
21091,0,0,17,0,-17
21092,0,0,69,0,-69
21093,1,1,1325,1300,-25
21094,1,0,34,0,-34
21095,0,0,63,0,-63
21096,1,1,170,1267,1097
21097,1,0,71,0,-71
21098,0,0,91,0,-91
21099,0,0,32,0,-32
21100,0,0,37,0,-37
21101,1,0,146,0,-146
21102,0,0,5,0,-5
21103,0,0,114,0,-114
21104,1,0,21,0,-21
21105,0,0,0,0,0
21106,0,0,127,0,-127
21107,1,1,536,1309,773
21108,0,0,129,0,-129
21109,1,1,1641,1505,-136
21110,1,1,167,1453,1286
21111,1,1,396,1486,1090
21112,1,1,1083,1589,506
21113,1,1,240,1328,1088
21114,1,0,34,0,-34
21115,1,1,1181,1997,816
21116,0,0,36,0,-36
21117,1,0,88,0,-88
21118,0,0,12,0,-12
21119,1,0,1,0,-1
21120,1,0,19,0,-19
21121,1,1,514,1729,1215
21122,0,0,1,0,-1
21123,0,0,5,0,-5
21124,1,1,891,1388,497
21125,1,1,531,1288,757
21126,0,0,20,0,-20
21127,1,1,61,1240,1179
21128,1,0,33,0,-33
21129,1,1,28,1305,1277
21130,1,1,76,1849,1773
21131,1,0,20,0,-20
21132,0,0,121,0,-121
21133,0,0,123,0,-123
21134,1,1,946,1243,297
21135,0,0,20,0,-20
21136,1,1,46,1758,1712
21137,1,0,59,0,-59
21138,0,0,67,0,-67
21139,1,1,103,1854,1751
21140,1,0,23,0,-23
21141,1,0,41,0,-41
21142,0,0,84,0,-84
21143,1,0,23,0,-23
21144,0,0,2,0,-2
21145,0,0,118,0,-118
21146,0,0,6,0,-6
21147,0,0,21,0,-21
21148,1,0,2,0,-2
21149,0,0,1,0,-1
21150,1,1,907,1442,535
21151,0,0,112,0,-112
21152,1,1,441,1841,1400
21153,1,1,748,1427,679
21154,1,1,241,1362,1121
21155,0,0,70,0,-70
21156,0,0,53,0,-53
21157,1,1,174,1505,1331
21158,1,1,467,1503,1036
21159,1,0,116,0,-116
21160,0,0,66,0,-66
21161,1,1,3638,1286,-2352
21162,1,0,31,0,-31
21163,0,0,65,0,-65
21164,1,1,2136,1655,-481
21165,0,0,62,0,-62
21166,1,1,139,1456,1317
21167,0,0,13,0,-13
21168,1,0,173,0,-173
21169,0,0,120,0,-120
21170,0,0,58,0,-58
21171,1,1,194,1271,1077
21172,0,0,48,0,-48
21173,0,0,133,0,-133
21174,0,0,141,0,-141
21175,1,1,720,1295,575
21176,1,1,293,1507,1214
21177,0,0,73,0,-73
21178,0,0,66,0,-66
21179,1,0,29,0,-29
21180,1,0,129,0,-129
21181,1,1,231,1386,1155
21182,0,0,18,0,-18
21183,0,0,3,0,-3
21184,0,0,50,0,-50
21185,1,1,209,2116,1907
21186,1,1,912,1208,296
21187,0,0,47,0,-47
21188,1,0,65,0,-65
21189,1,1,948,1738,790
21190,1,0,33,0,-33
21191,1,1,1163,1873,710
21192,1,1,222,1208,986
21193,0,0,12,0,-12
21194,0,0,42,0,-42
21195,0,0,19,0,-19
21196,1,0,17,0,-17
21197,0,0,12,0,-12
21198,0,0,158,0,-158
21199,1,1,155,1461,1306
21200,1,0,21,0,-21
21201,1,0,76,0,-76
21202,1,1,590,1613,1023
21203,1,1,1643,1689,46
21204,1,1,60,2563,2503
21205,1,1,108,1201,1093
21206,1,1,133,1694,1561
21207,0,0,196,0,-196
21208,0,0,159,0,-159
21209,1,1,64,1499,1435
21210,1,0,125,0,-125
21211,0,0,120,0,-120
21212,1,0,33,0,-33
21213,1,0,77,0,-77
21214,0,0,57,0,-57
21215,1,0,62,0,-62
21216,0,0,19,0,-19
21217,0,0,181,0,-181
21218,1,1,1265,1469,204
21219,1,0,22,0,-22
21220,0,0,5,0,-5
21221,0,0,13,0,-13
21222,1,0,12,0,-12
21223,1,0,28,0,-28
21224,0,0,43,0,-43
21225,1,1,736,2138,1402
21226,1,1,186,1219,1033
21227,0,0,56,0,-56
21228,1,0,15,0,-15
21229,0,0,14,0,-14
21230,0,0,40,0,-40
21231,0,0,8,0,-8
21232,0,0,1,0,-1
21233,1,1,718,1879,1161
21234,1,1,910,1714,804
21235,1,0,66,0,-66
21236,1,0,33,0,-33
21237,1,0,83,0,-83
21238,0,0,1,0,-1
21239,1,1,773,1333,560
21240,1,0,34,0,-34
21241,1,0,15,0,-15
21242,0,0,19,0,-19
21243,1,1,403,1349,946
21244,1,1,465,1417,952
21245,1,1,1667,1341,-326
21246,1,1,116,1467,1351
21247,1,0,19,0,-19
21248,1,0,59,0,-59
21249,0,0,32,0,-32
21250,1,0,15,0,-15
21251,1,1,518,1540,1022
21252,0,0,115,0,-115
21253,0,0,82,0,-82
21254,1,0,27,0,-27
21255,1,0,64,0,-64
21256,0,0,77,0,-77
21257,0,0,69,0,-69
21258,1,1,1694,1280,-414
21259,1,0,127,0,-127
21260,1,0,42,0,-42
21261,1,1,134,1258,1124
21262,0,0,80,0,-80
21263,0,0,18,0,-18
21264,0,0,22,0,-22
21265,0,0,135,0,-135
21266,0,0,61,0,-61
21267,1,1,842,1384,542
21268,1,0,45,0,-45
21269,0,0,78,0,-78
21270,0,0,27,0,-27
21271,1,1,158,1272,1114
21272,0,0,2,0,-2
21273,1,0,131,0,-131
21274,0,0,39,0,-39
21275,1,0,80,0,-80
21276,1,1,508,1252,744
21277,1,1,899,1419,520
21278,0,0,28,0,-28
21279,0,0,21,0,-21
21280,0,0,1,0,-1
21281,1,1,517,1347,830
21282,0,0,7,0,-7
21283,1,0,5,0,-5
21284,1,1,1637,1219,-418
21285,0,0,22,0,-22
21286,1,0,20,0,-20
21287,1,0,33,0,-33
21288,1,1,577,1375,798
21289,0,0,13,0,-13
21290,1,1,1308,2017,709
21291,1,1,90,1816,1726
21292,1,0,45,0,-45
21293,1,0,69,0,-69
21294,0,0,46,0,-46
21295,1,1,991,1438,447
21296,0,0,11,0,-11
21297,0,0,24,0,-24
21298,1,1,289,1275,986
21299,0,0,5,0,-5
21300,1,1,553,1251,698
21301,1,0,73,0,-73
21302,0,0,10,0,-10
21303,1,0,23,0,-23
21304,0,0,51,0,-51
21305,1,0,16,0,-16
21306,0,0,79,0,-79
21307,0,0,10,0,-10
21308,1,0,2,0,-2
21309,1,0,40,0,-40
21310,1,1,426,1608,1182
21311,1,0,15,0,-15
21312,1,0,18,0,-18
21313,1,1,25,1280,1255
21314,0,0,12,0,-12
21315,1,1,570,1338,768
21316,1,1,538,1467,929
21317,0,0,28,0,-28
21318,1,0,59,0,-59
21319,1,0,36,0,-36
21320,1,1,304,1278,974
21321,1,0,6,0,-6
21322,1,1,34,1353,1319
21323,1,1,29,1501,1472
21324,1,1,147,2262,2115
21325,1,1,334,1894,1560
21326,0,0,3,0,-3
21327,0,0,119,0,-119
21328,1,0,30,0,-30
21329,1,1,848,1297,449
21330,1,1,431,1395,964
21331,1,0,152,0,-152
21332,1,1,573,1872,1299
21333,1,1,1699,1392,-307
21334,0,0,71,0,-71
21335,1,1,1095,1436,341
21336,0,0,168,0,-168
21337,1,1,405,1225,820
21338,1,0,11,0,-11
21339,0,0,58,0,-58
21340,1,1,256,1950,1694
21341,1,1,938,1606,668
21342,1,1,1355,1293,-62
21343,0,0,21,0,-21
21344,1,0,10,0,-10
21345,0,0,186,0,-186
21346,1,0,6,0,-6
21347,0,0,73,0,-73
21348,1,0,9,0,-9
21349,0,0,43,0,-43
21350,1,1,714,1253,539
21351,1,0,19,0,-19
21352,0,0,85,0,-85
21353,0,0,19,0,-19
21354,0,0,99,0,-99
21355,0,0,9,0,-9
21356,0,0,70,0,-70
21357,1,1,157,2126,1969
21358,0,0,27,0,-27
21359,0,0,75,0,-75
21360,0,0,20,0,-20
21361,1,1,636,2080,1444
21362,0,0,32,0,-32
21363,1,0,15,0,-15
21364,1,0,30,0,-30
21365,0,0,15,0,-15
21366,0,0,78,0,-78
21367,1,1,941,2279,1338
21368,0,0,0,0,0
21369,0,0,87,0,-87
21370,1,1,450,1275,825
21371,0,0,31,0,-31
21372,1,0,4,0,-4
21373,0,0,68,0,-68
21374,1,1,1573,1390,-183
21375,1,1,29,1704,1675
21376,1,1,422,1372,950
21377,1,1,3901,1930,-1971
21378,0,0,4,0,-4
21379,1,0,6,0,-6
21380,0,0,17,0,-17
21381,0,0,106,0,-106
21382,0,0,84,0,-84
21383,1,0,73,0,-73
21384,1,1,1491,1506,15
21385,0,0,9,0,-9
21386,1,1,633,1508,875
21387,1,0,46,0,-46
21388,1,0,45,0,-45
21389,1,0,43,0,-43
21390,1,0,34,0,-34
21391,0,0,0,0,0
21392,0,0,9,0,-9
21393,1,1,144,1374,1230
21394,1,1,66,2047,1981
21395,1,1,437,2382,1945
21396,1,0,5,0,-5
21397,1,0,42,0,-42
21398,0,0,7,0,-7
21399,1,1,861,1468,607
21400,1,1,171,2015,1844
21401,1,0,3,0,-3
21402,1,0,27,0,-27
21403,1,0,41,0,-41
21404,0,0,53,0,-53
21405,0,0,22,0,-22
21406,1,0,75,0,-75
21407,1,1,331,1718,1387
21408,1,0,141,0,-141
21409,0,0,142,0,-142
21410,1,1,362,1779,1417
21411,0,0,65,0,-65
21412,0,0,4,0,-4
21413,1,0,31,0,-31
21414,0,0,18,0,-18
21415,1,0,5,0,-5
21416,0,0,106,0,-106
21417,1,1,373,1247,874
21418,1,1,357,1479,1122
21419,1,0,15,0,-15
21420,1,1,146,1230,1084
21421,1,0,139,0,-139
21422,0,0,4,0,-4
21423,0,0,12,0,-12
21424,1,1,397,1233,836
21425,1,0,31,0,-31
21426,1,0,33,0,-33
21427,1,0,33,0,-33
21428,1,1,407,2428,2021
21429,1,1,714,3021,2307
21430,0,0,310,0,-310
21431,0,0,64,0,-64
21432,1,1,275,1228,953
21433,1,0,42,0,-42
21434,1,1,133,1817,1684
21435,0,0,26,0,-26
21436,1,0,149,0,-149
21437,1,0,14,0,-14
21438,1,1,305,3558,3253
21439,1,1,759,1674,915
21440,0,0,51,0,-51
21441,1,0,32,0,-32
21442,1,1,586,1490,904
21443,0,0,211,0,-211
21444,1,1,93,1356,1263
21445,1,0,39,0,-39
21446,1,1,118,1276,1158
21447,0,0,19,0,-19
21448,1,1,1038,3094,2056
21449,1,0,0,0,0
21450,1,1,838,1377,539
21451,1,1,140,1256,1116
21452,0,0,4,0,-4
21453,0,0,38,0,-38
21454,1,1,898,1230,332
21455,0,0,67,0,-67
21456,1,1,685,1291,606
21457,0,0,28,0,-28
21458,1,1,700,1254,554
21459,0,0,21,0,-21
21460,0,0,6,0,-6
21461,0,0,17,0,-17
21462,1,0,39,0,-39
21463,0,0,55,0,-55
21464,1,1,1725,1709,-16
21465,0,0,124,0,-124
21466,0,0,82,0,-82
21467,1,0,64,0,-64
21468,1,0,50,0,-50
21469,1,0,84,0,-84
21470,1,1,1322,1775,453
21471,1,0,42,0,-42
21472,0,0,19,0,-19
21473,0,0,3,0,-3
21474,1,1,753,1328,575
21475,1,1,910,1266,356
21476,1,1,240,1719,1479
21477,1,0,21,0,-21
21478,0,0,131,0,-131
21479,1,1,2759,1577,-1182
21480,1,1,566,1500,934
21481,1,0,5,0,-5
21482,1,1,1931,1460,-471
21483,0,0,9,0,-9
21484,0,0,41,0,-41
21485,1,0,10,0,-10
21486,0,0,15,0,-15
21487,1,0,12,0,-12
21488,1,1,313,1215,902
21489,1,1,1058,1885,827
21490,1,0,25,0,-25
21491,1,1,561,1238,677
21492,0,0,6,0,-6
21493,0,0,0,0,0
21494,1,1,19,1622,1603
21495,0,0,34,0,-34
21496,1,0,128,0,-128
21497,1,1,2353,1230,-1123
21498,0,0,65,0,-65
21499,1,0,34,0,-34
21500,1,1,676,1655,979
21501,1,0,51,0,-51
21502,1,0,25,0,-25
21503,1,1,55,1711,1656
21504,0,0,1,0,-1
21505,0,0,120,0,-120
21506,1,0,132,0,-132
21507,1,0,39,0,-39
21508,1,1,6,1519,1513
21509,1,0,48,0,-48
21510,0,0,89,0,-89
21511,1,0,0,0,0
21512,0,0,32,0,-32
21513,1,0,97,0,-97
21514,0,0,120,0,-120
21515,1,1,199,1235,1036
21516,1,0,1,0,-1
21517,0,0,36,0,-36
21518,0,0,49,0,-49
21519,0,0,4,0,-4
21520,0,0,41,0,-41
21521,1,1,306,1941,1635
21522,1,0,47,0,-47
21523,0,0,5,0,-5
21524,0,0,0,0,0
21525,0,0,9,0,-9
21526,1,1,50,1235,1185
21527,1,0,88,0,-88
21528,1,1,492,1417,925
21529,0,0,9,0,-9
21530,1,0,12,0,-12
21531,1,1,267,1399,1132
21532,1,0,14,0,-14
21533,0,0,115,0,-115
21534,1,1,102,1359,1257
21535,1,1,290,1981,1691
21536,1,0,3,0,-3
21537,1,0,34,0,-34
21538,1,0,7,0,-7
21539,0,0,2,0,-2
21540,1,1,145,1436,1291
21541,0,0,81,0,-81
21542,1,1,418,1568,1150
21543,1,0,57,0,-57
21544,0,0,1,0,-1
21545,1,1,607,2029,1422
21546,1,0,40,0,-40
21547,0,0,102,0,-102
21548,0,0,28,0,-28
21549,0,0,47,0,-47
21550,0,0,22,0,-22
21551,0,0,4,0,-4
21552,1,0,16,0,-16
21553,1,0,107,0,-107
21554,0,0,39,0,-39
21555,0,0,50,0,-50
21556,1,0,11,0,-11
21557,0,0,25,0,-25
21558,1,1,1202,1764,562
21559,1,0,97,0,-97
21560,1,0,4,0,-4
21561,1,0,74,0,-74
21562,1,1,1143,1375,232
21563,0,0,92,0,-92
21564,0,0,114,0,-114
21565,0,0,22,0,-22
21566,0,0,23,0,-23
21567,0,0,13,0,-13
21568,1,0,32,0,-32
21569,1,0,14,0,-14
21570,0,0,39,0,-39
21571,0,0,6,0,-6
21572,1,1,59,1258,1199
21573,0,0,16,0,-16
21574,1,1,2082,1394,-688
21575,0,0,7,0,-7
21576,1,1,251,1416,1165
21577,1,1,157,1374,1217
21578,1,0,45,0,-45
21579,1,1,45,1382,1337
21580,1,0,66,0,-66
21581,0,0,13,0,-13
21582,1,0,90,0,-90
21583,1,0,82,0,-82
21584,0,0,77,0,-77
21585,0,0,35,0,-35
21586,0,0,15,0,-15
21587,1,1,198,1411,1213
21588,0,0,40,0,-40
21589,0,0,32,0,-32
21590,0,0,12,0,-12
21591,1,0,131,0,-131
21592,1,0,22,0,-22
21593,0,0,15,0,-15
21594,1,1,553,1203,650
21595,0,0,20,0,-20
21596,1,1,207,1288,1081
21597,1,1,203,1218,1015
21598,0,0,123,0,-123
21599,0,0,54,0,-54
21600,1,0,173,0,-173
21601,0,0,24,0,-24
21602,0,0,77,0,-77
21603,1,0,12,0,-12
21604,1,1,613,1232,619
21605,1,0,41,0,-41
21606,0,0,3,0,-3
21607,0,0,61,0,-61
21608,1,1,1064,1259,195
21609,0,0,110,0,-110
21610,0,0,14,0,-14
21611,1,1,981,1432,451
21612,1,1,407,1303,896
21613,0,0,18,0,-18
21614,1,0,27,0,-27
21615,0,0,2,0,-2
21616,1,0,39,0,-39
21617,0,0,8,0,-8
21618,1,0,22,0,-22
21619,1,0,71,0,-71
21620,0,0,46,0,-46
21621,0,0,2,0,-2
21622,1,0,22,0,-22
21623,1,0,52,0,-52
21624,0,0,135,0,-135
21625,1,0,83,0,-83
21626,1,1,185,1728,1543
21627,1,0,7,0,-7
21628,0,0,18,0,-18
21629,1,1,556,3684,3128
21630,1,0,82,0,-82
21631,1,0,40,0,-40
21632,1,0,21,0,-21
21633,0,0,98,0,-98
21634,1,1,283,1298,1015
21635,1,1,606,1252,646
21636,1,0,18,0,-18
21637,1,0,45,0,-45
21638,1,1,604,1261,657
21639,0,0,60,0,-60
21640,1,0,27,0,-27
21641,1,1,153,1454,1301
21642,0,0,5,0,-5
21643,1,1,873,1203,330
21644,1,1,515,1265,750
21645,0,0,6,0,-6
21646,1,0,21,0,-21
21647,0,0,309,0,-309
21648,0,0,47,0,-47
21649,1,0,20,0,-20
21650,1,1,202,1992,1790
21651,1,0,5,0,-5
21652,1,1,242,3516,3274
21653,1,0,0,0,0
21654,1,1,747,1456,709
21655,1,0,127,0,-127
21656,1,0,46,0,-46
21657,0,0,82,0,-82
21658,0,0,44,0,-44
21659,1,1,174,1235,1061
21660,1,0,35,0,-35
21661,1,0,64,0,-64
21662,0,0,14,0,-14
21663,1,1,1474,1230,-244
21664,1,0,5,0,-5
21665,1,1,81,1533,1452
21666,1,0,1,0,-1
21667,1,0,27,0,-27
21668,0,0,43,0,-43
21669,0,0,13,0,-13
21670,1,1,1735,1410,-325
21671,0,0,20,0,-20
21672,0,0,7,0,-7
21673,1,0,55,0,-55
21674,0,0,147,0,-147
21675,1,1,106,1202,1096
21676,0,0,82,0,-82
21677,1,1,520,1325,805
21678,1,0,23,0,-23
21679,1,1,1066,1823,757
21680,1,1,261,1418,1157
21681,0,0,87,0,-87
21682,1,0,70,0,-70
21683,1,0,75,0,-75
21684,0,0,66,0,-66
21685,0,0,49,0,-49
21686,0,0,21,0,-21
21687,1,1,199,1931,1732
21688,1,1,421,1758,1337
21689,0,0,10,0,-10
21690,0,0,159,0,-159
21691,1,0,25,0,-25
21692,1,0,10,0,-10
21693,0,0,8,0,-8
21694,1,1,411,1449,1038
21695,1,1,156,1552,1396
21696,0,0,126,0,-126
21697,1,1,89,1211,1122
21698,0,0,36,0,-36
21699,1,1,184,1487,1303
21700,0,0,88,0,-88
21701,0,0,4,0,-4
21702,0,0,13,0,-13
21703,1,0,14,0,-14
21704,1,1,131,2281,2150
21705,1,1,795,1513,718
21706,1,0,248,0,-248
21707,0,0,26,0,-26
21708,1,1,191,1333,1142
21709,0,0,57,0,-57
21710,1,1,130,1322,1192
21711,0,0,71,0,-71
21712,1,1,508,2053,1545
21713,0,0,9,0,-9
21714,1,0,62,0,-62
21715,1,0,17,0,-17
21716,0,0,50,0,-50
21717,0,0,18,0,-18
21718,0,0,156,0,-156
21719,0,0,5,0,-5
21720,0,0,45,0,-45
21721,1,0,8,0,-8
21722,0,0,2,0,-2
21723,0,0,27,0,-27
21724,0,0,178,0,-178
21725,1,0,33,0,-33
21726,1,0,117,0,-117
21727,1,1,249,1832,1583
21728,1,1,202,1271,1069
21729,1,1,164,1671,1507
21730,1,1,99,5279,5180
21731,1,1,931,1531,600
21732,0,0,9,0,-9
21733,0,0,51,0,-51
21734,1,0,23,0,-23
21735,1,0,59,0,-59
21736,1,0,57,0,-57
21737,0,0,60,0,-60
21738,1,1,282,1679,1397
21739,0,0,36,0,-36
21740,0,0,15,0,-15
21741,0,0,87,0,-87
21742,0,0,30,0,-30
21743,1,0,27,0,-27
21744,0,0,64,0,-64
21745,0,0,36,0,-36
21746,1,0,5,0,-5
21747,0,0,58,0,-58
21748,1,0,2,0,-2
21749,1,0,70,0,-70
21750,0,0,179,0,-179
21751,1,0,17,0,-17
21752,0,0,71,0,-71
21753,0,0,35,0,-35
21754,1,1,116,1275,1159
21755,1,0,19,0,-19
21756,1,0,5,0,-5
21757,0,0,79,0,-79
21758,1,1,530,1259,729
21759,0,0,29,0,-29
21760,1,1,1208,1236,28
21761,0,0,25,0,-25
21762,1,1,55,1471,1416
21763,1,0,16,0,-16
21764,1,1,542,2257,1715
21765,1,0,29,0,-29
21766,1,0,65,0,-65
21767,1,1,1353,1943,590
21768,1,0,16,0,-16
21769,1,0,19,0,-19
21770,0,0,30,0,-30
21771,1,1,1016,1498,482
21772,1,1,221,1500,1279
21773,0,0,268,0,-268
21774,1,0,5,0,-5
21775,1,1,1186,1308,122
21776,1,1,106,1496,1390
21777,1,1,262,1264,1002
21778,1,0,78,0,-78
21779,0,0,13,0,-13
21780,1,0,14,0,-14
21781,0,0,76,0,-76
21782,1,1,944,1568,624
21783,1,1,117,1428,1311
21784,1,1,75,1291,1216
21785,1,1,1648,1419,-229
21786,1,1,688,1219,531
21787,0,0,68,0,-68
21788,1,0,85,0,-85
21789,0,0,131,0,-131
21790,1,1,215,2062,1847
21791,1,0,22,0,-22
21792,1,0,58,0,-58
21793,0,0,144,0,-144
21794,0,0,12,0,-12
21795,1,0,84,0,-84
21796,0,0,72,0,-72
21797,1,1,161,1880,1719
21798,0,0,33,0,-33
21799,1,0,3,0,-3
21800,1,1,380,1200,820
21801,1,1,280,1317,1037
21802,1,0,37,0,-37
21803,1,0,116,0,-116
21804,1,0,23,0,-23
21805,1,0,1,0,-1
21806,1,0,55,0,-55
21807,0,0,69,0,-69
21808,1,0,41,0,-41
21809,0,0,77,0,-77
21810,1,0,103,0,-103
21811,1,0,4,0,-4
21812,1,0,21,0,-21
21813,1,1,175,1304,1129
21814,1,1,248,1564,1316
21815,0,0,1,0,-1
21816,1,1,504,1265,761
21817,0,0,22,0,-22
21818,1,0,111,0,-111
21819,0,0,0,0,0
21820,0,0,60,0,-60
21821,0,0,176,0,-176
21822,1,1,246,1326,1080
21823,0,0,32,0,-32
21824,0,0,36,0,-36
21825,1,0,111,0,-111
21826,1,1,28,1241,1213
21827,0,0,53,0,-53
21828,0,0,36,0,-36
21829,1,1,449,1863,1414
21830,0,0,1,0,-1
21831,1,0,0,0,0
21832,1,1,113,1393,1280
21833,1,0,53,0,-53
21834,1,0,113,0,-113
21835,1,0,3,0,-3
21836,0,0,28,0,-28
21837,0,0,33,0,-33
21838,0,0,24,0,-24
21839,0,0,10,0,-10
21840,1,1,197,1274,1077
21841,0,0,88,0,-88
21842,0,0,24,0,-24
21843,1,0,64,0,-64
21844,1,1,1344,2154,810
21845,0,0,4,0,-4
21846,0,0,3,0,-3
21847,1,0,30,0,-30
21848,1,1,268,1284,1016
21849,1,0,62,0,-62
21850,0,0,38,0,-38
21851,1,0,36,0,-36
21852,1,0,3,0,-3
21853,1,0,15,0,-15
21854,0,0,26,0,-26
21855,0,0,14,0,-14
21856,1,1,401,1438,1037
21857,1,1,650,1240,590
21858,0,0,78,0,-78
21859,0,0,2,0,-2
21860,1,1,1079,1295,216
21861,0,0,53,0,-53
21862,0,0,6,0,-6
21863,1,0,91,0,-91
21864,1,1,662,1264,602
21865,1,1,214,1436,1222
21866,1,1,359,2806,2447
21867,1,0,52,0,-52
21868,1,0,252,0,-252
21869,1,0,25,0,-25
21870,0,0,39,0,-39
21871,1,0,13,0,-13
21872,1,0,5,0,-5
21873,1,0,79,0,-79
21874,0,0,158,0,-158
21875,1,1,36,1625,1589
21876,1,0,9,0,-9
21877,0,0,74,0,-74
21878,0,0,23,0,-23
21879,1,1,553,2363,1810
21880,1,1,196,1855,1659
21881,1,1,524,1629,1105
21882,0,0,79,0,-79
21883,0,0,2,0,-2
21884,1,1,147,1662,1515
21885,1,0,29,0,-29
21886,1,0,54,0,-54
21887,1,0,23,0,-23
21888,1,1,634,1259,625
21889,1,0,216,0,-216
21890,1,0,48,0,-48
21891,0,0,41,0,-41
21892,0,0,39,0,-39
21893,1,0,16,0,-16
21894,1,0,53,0,-53
21895,0,0,43,0,-43
21896,1,0,1,0,-1
21897,1,0,10,0,-10
21898,0,0,63,0,-63
21899,1,1,976,1246,270
21900,1,0,93,0,-93
21901,0,0,24,0,-24
21902,1,1,483,1360,877
21903,1,1,392,1404,1012
21904,1,1,106,1214,1108
21905,0,0,8,0,-8
21906,1,1,168,1398,1230
21907,1,0,31,0,-31
21908,1,0,65,0,-65
21909,0,0,134,0,-134
21910,1,1,191,3636,3445
21911,1,0,107,0,-107
21912,1,0,7,0,-7
21913,1,0,44,0,-44
21914,1,0,21,0,-21
21915,1,1,734,1495,761
21916,1,1,366,1634,1268
21917,1,0,18,0,-18
21918,1,0,5,0,-5
21919,0,0,44,0,-44
21920,1,0,28,0,-28
21921,1,0,4,0,-4
21922,0,0,19,0,-19
21923,0,0,93,0,-93
21924,0,0,21,0,-21
21925,0,0,139,0,-139
21926,1,0,52,0,-52
21927,1,1,189,1348,1159
21928,0,0,23,0,-23
21929,1,1,699,1391,692
21930,1,1,169,1247,1078
21931,1,0,17,0,-17
21932,0,0,4,0,-4
21933,0,0,78,0,-78
21934,1,1,411,1719,1308
21935,0,0,2,0,-2
21936,1,1,776,1373,597
21937,1,1,418,1789,1371
21938,0,0,70,0,-70
21939,1,1,131,1327,1196
21940,0,0,158,0,-158
21941,1,0,231,0,-231
21942,1,1,170,1210,1040
21943,1,1,1112,1222,110
21944,0,0,3,0,-3
21945,1,1,1284,1334,50
21946,0,0,74,0,-74
21947,1,1,1400,1560,160
21948,0,0,18,0,-18
21949,1,1,655,2028,1373
21950,1,0,173,0,-173
21951,1,0,41,0,-41
21952,0,0,29,0,-29
21953,0,0,106,0,-106
21954,1,0,9,0,-9
21955,1,1,1024,1533,509
21956,1,1,162,1219,1057
21957,1,1,103,1623,1520
21958,0,0,34,0,-34
21959,1,1,763,1917,1154
21960,0,0,39,0,-39
21961,1,1,43,1310,1267
21962,0,0,5,0,-5
21963,1,0,10,0,-10
21964,0,0,25,0,-25
21965,1,0,46,0,-46
21966,0,0,3,0,-3
21967,0,0,85,0,-85
21968,1,1,527,1352,825
21969,1,0,22,0,-22
21970,1,0,80,0,-80
21971,1,0,5,0,-5
21972,1,1,1006,1443,437
21973,0,0,15,0,-15
21974,1,0,61,0,-61
21975,1,1,484,4002,3518
21976,0,0,80,0,-80
21977,0,0,74,0,-74
21978,1,1,119,1367,1248
21979,1,1,161,1213,1052
21980,1,0,165,0,-165
21981,1,1,249,1402,1153
21982,1,0,48,0,-48
21983,1,0,5,0,-5
21984,1,0,63,0,-63
21985,0,0,105,0,-105
21986,1,0,28,0,-28
21987,0,0,7,0,-7
21988,0,0,26,0,-26
21989,1,0,51,0,-51
21990,1,1,272,2185,1913
21991,0,0,129,0,-129
21992,0,0,2,0,-2
21993,1,1,846,1272,426
21994,0,0,49,0,-49
21995,1,0,90,0,-90
21996,1,0,9,0,-9
21997,1,0,121,0,-121
21998,1,0,82,0,-82
21999,1,0,25,0,-25
22000,1,1,61,1353,1292
22001,1,0,30,0,-30
22002,0,0,32,0,-32
22003,1,1,894,3432,2538
22004,0,0,116,0,-116
22005,1,1,141,2024,1883
22006,0,0,86,0,-86
22007,1,0,82,0,-82
22008,1,0,57,0,-57
22009,1,0,74,0,-74
22010,1,1,419,4077,3658
22011,1,1,500,1582,1082
22012,1,1,327,1393,1066
22013,0,0,22,0,-22
22014,1,1,203,1726,1523
22015,1,1,898,1276,378
22016,1,1,649,1505,856
22017,0,0,40,0,-40
22018,1,0,68,0,-68
22019,1,0,31,0,-31
22020,1,1,131,1847,1716
22021,0,0,4,0,-4
22022,1,0,11,0,-11
22023,1,1,119,1329,1210
22024,1,1,208,1323,1115
22025,1,0,182,0,-182
22026,1,1,179,2130,1951
22027,1,0,66,0,-66
22028,0,0,22,0,-22
22029,1,0,2,0,-2
22030,1,0,123,0,-123
22031,1,0,4,0,-4
22032,0,0,136,0,-136
22033,1,1,234,1200,966
22034,1,0,51,0,-51
22035,1,0,5,0,-5
22036,0,0,41,0,-41
22037,0,0,20,0,-20
22038,1,0,6,0,-6
22039,1,0,57,0,-57
22040,0,0,12,0,-12
22041,1,1,1026,1409,383
22042,1,1,54,1610,1556
22043,0,0,29,0,-29
22044,1,0,3,0,-3
22045,1,0,35,0,-35
22046,1,0,14,0,-14
22047,1,1,130,1312,1182
22048,1,1,1428,1552,124
22049,1,1,1347,1219,-128
22050,1,1,531,1313,782
22051,1,0,40,0,-40
22052,0,0,8,0,-8
22053,1,1,1374,1291,-83
22054,0,0,16,0,-16
22055,0,0,50,0,-50
22056,1,1,615,1222,607
22057,1,1,239,1213,974
22058,1,1,1402,1762,360
22059,1,0,14,0,-14
22060,0,0,12,0,-12
22061,1,1,358,1220,862
22062,1,1,605,1354,749
22063,1,1,582,1573,991
22064,0,0,132,0,-132
22065,1,1,113,1631,1518
22066,1,1,1199,1961,762
22067,0,0,36,0,-36
22068,0,0,5,0,-5
22069,1,0,21,0,-21
22070,1,1,1286,1332,46
22071,1,1,86,1219,1133
22072,1,1,327,1676,1349
22073,1,1,1273,1413,140
22074,1,0,37,0,-37
22075,1,0,46,0,-46
22076,1,0,39,0,-39
22077,0,0,52,0,-52
22078,1,1,1559,7079,5520
22079,0,0,83,0,-83
22080,0,0,74,0,-74
22081,0,0,14,0,-14
22082,1,1,103,1485,1382
22083,1,1,367,1321,954
22084,1,1,333,1552,1219
22085,1,1,363,1234,871
22086,1,0,4,0,-4
22087,0,0,3,0,-3
22088,1,0,148,0,-148
22089,1,1,1653,1848,195
22090,0,0,17,0,-17
22091,1,0,116,0,-116
22092,1,0,3,0,-3
22093,1,0,5,0,-5
22094,0,0,20,0,-20
22095,1,1,417,1542,1125
22096,1,1,542,2733,2191
22097,0,0,87,0,-87
22098,1,1,402,4185,3783
22099,0,0,53,0,-53
22100,1,1,796,1364,568
22101,1,0,71,0,-71
22102,1,0,18,0,-18
22103,1,0,36,0,-36
22104,0,0,4,0,-4
22105,1,0,4,0,-4
22106,0,0,15,0,-15
22107,1,0,130,0,-130
22108,1,1,244,1974,1730
22109,0,0,2,0,-2
22110,0,0,5,0,-5
22111,1,1,214,1625,1411
22112,1,0,68,0,-68
22113,1,1,13,1466,1453
22114,1,0,115,0,-115
22115,0,0,9,0,-9
22116,1,0,35,0,-35
22117,0,0,14,0,-14
22118,1,0,80,0,-80
22119,0,0,52,0,-52
22120,0,0,8,0,-8
22121,1,1,181,1866,1685
22122,1,0,4,0,-4
22123,0,0,3,0,-3
22124,0,0,39,0,-39
22125,1,0,77,0,-77
22126,0,0,4,0,-4
22127,1,0,27,0,-27
22128,0,0,2,0,-2
22129,1,1,649,1706,1057
22130,0,0,3,0,-3
22131,0,0,44,0,-44
22132,1,1,178,1419,1241
22133,1,1,49,1318,1269
22134,1,0,0,0,0
22135,1,0,84,0,-84
22136,0,0,25,0,-25
22137,1,0,19,0,-19
22138,1,1,370,1377,1007
22139,0,0,46,0,-46
22140,0,0,120,0,-120
22141,0,0,64,0,-64
22142,1,1,143,1332,1189
22143,1,0,27,0,-27
22144,0,0,133,0,-133
22145,1,1,1114,1316,202
22146,1,1,747,1923,1176
22147,0,0,41,0,-41
22148,1,0,13,0,-13
22149,1,0,16,0,-16
22150,1,0,59,0,-59
22151,0,0,43,0,-43
22152,0,0,1,0,-1
22153,1,1,408,1471,1063
22154,1,1,575,1624,1049
22155,1,0,4,0,-4
22156,0,0,5,0,-5
22157,0,0,23,0,-23
22158,0,0,255,0,-255
22159,1,1,757,1304,547
22160,1,0,45,0,-45
22161,0,0,13,0,-13
22162,0,0,9,0,-9
22163,0,0,67,0,-67
22164,0,0,59,0,-59
22165,0,0,49,0,-49
22166,1,1,1654,1225,-429
22167,0,0,12,0,-12
22168,0,0,13,0,-13
22169,1,1,741,5351,4610
22170,1,0,15,0,-15
22171,1,1,794,1715,921
22172,1,0,28,0,-28
22173,1,0,27,0,-27
22174,1,0,67,0,-67
22175,1,0,5,0,-5
22176,1,1,377,1933,1556
22177,0,0,30,0,-30
22178,0,0,179,0,-179
22179,1,0,0,0,0
22180,1,0,55,0,-55
22181,1,0,85,0,-85
22182,1,1,143,2049,1906
22183,1,1,1277,1841,564
22184,1,1,280,1246,966
22185,1,1,253,1412,1159
22186,1,0,81,0,-81
22187,1,1,1471,1853,382
22188,0,0,11,0,-11
22189,1,1,272,1263,991
22190,0,0,25,0,-25
22191,1,1,342,1235,893
22192,0,0,173,0,-173
22193,0,0,3,0,-3
22194,1,1,1807,1621,-186
22195,0,0,24,0,-24
22196,1,0,10,0,-10
22197,1,1,237,1457,1220
22198,1,1,207,1673,1466
22199,0,0,27,0,-27
22200,1,1,816,2071,1255
22201,1,0,40,0,-40
22202,1,0,73,0,-73
22203,1,0,45,0,-45
22204,1,0,2,0,-2
22205,0,0,16,0,-16
22206,1,0,23,0,-23
22207,1,1,197,1861,1664
22208,0,0,19,0,-19
22209,1,1,1879,1838,-41
22210,1,0,73,0,-73
22211,1,1,564,1452,888
22212,1,1,605,1636,1031
22213,0,0,50,0,-50
22214,1,0,71,0,-71
22215,0,0,14,0,-14
22216,1,0,34,0,-34
22217,1,1,262,3184,2922
22218,0,0,48,0,-48
22219,0,0,18,0,-18
22220,0,0,3,0,-3
22221,1,0,14,0,-14
22222,1,1,36,1480,1444
22223,1,1,340,1468,1128
22224,1,0,9,0,-9
22225,1,0,20,0,-20
22226,1,1,541,1320,779
22227,1,0,25,0,-25
22228,1,1,1970,1393,-577
22229,0,0,95,0,-95
22230,0,0,5,0,-5
22231,0,0,39,0,-39
22232,0,0,10,0,-10
22233,1,0,37,0,-37
22234,0,0,6,0,-6
22235,1,0,110,0,-110
22236,0,0,25,0,-25
22237,0,0,22,0,-22
22238,1,0,22,0,-22
22239,0,0,69,0,-69
22240,0,0,197,0,-197
22241,1,1,219,1218,999
22242,1,0,28,0,-28
22243,0,0,6,0,-6
22244,0,0,36,0,-36
22245,1,0,4,0,-4
22246,1,1,1763,1940,177
22247,0,0,84,0,-84
22248,1,0,33,0,-33
22249,0,0,68,0,-68
22250,1,0,26,0,-26
22251,0,0,47,0,-47
22252,0,0,10,0,-10
22253,1,0,16,0,-16
22254,1,1,758,1250,492
22255,0,0,227,0,-227
22256,1,0,41,0,-41
22257,0,0,6,0,-6
22258,0,0,7,0,-7
22259,0,0,14,0,-14
22260,1,0,29,0,-29
22261,0,0,12,0,-12
22262,1,1,129,1853,1724
22263,1,0,84,0,-84
22264,1,1,686,1440,754
22265,1,1,1122,1338,216
22266,1,0,26,0,-26
22267,0,0,51,0,-51
22268,1,0,7,0,-7
22269,0,0,16,0,-16
22270,1,1,228,1550,1322
22271,0,0,3,0,-3
22272,1,0,41,0,-41
22273,0,0,53,0,-53
22274,1,1,96,1258,1162
22275,1,0,40,0,-40
22276,1,0,11,0,-11
22277,1,1,194,1315,1121
22278,1,0,3,0,-3
22279,1,1,1565,1427,-138
22280,0,0,29,0,-29
22281,1,0,108,0,-108
22282,0,0,69,0,-69
22283,1,1,169,2352,2183
22284,0,0,10,0,-10
22285,1,0,36,0,-36
22286,1,1,540,1391,851
22287,1,0,4,0,-4
22288,0,0,12,0,-12
22289,0,0,159,0,-159
22290,1,0,30,0,-30
22291,1,0,21,0,-21
22292,1,0,168,0,-168
22293,0,0,23,0,-23
22294,0,0,2,0,-2
22295,1,0,91,0,-91
22296,1,1,343,1242,899
22297,1,0,22,0,-22
22298,0,0,57,0,-57
22299,1,0,30,0,-30
22300,1,0,83,0,-83
22301,1,0,20,0,-20
22302,0,0,80,0,-80
22303,0,0,18,0,-18
22304,0,0,28,0,-28
22305,1,1,137,1205,1068
22306,0,0,16,0,-16
22307,0,0,8,0,-8
22308,1,0,19,0,-19
22309,0,0,66,0,-66
22310,0,0,11,0,-11
22311,1,0,99,0,-99
22312,1,0,42,0,-42
22313,0,0,33,0,-33
22314,1,1,228,1407,1179
22315,1,0,68,0,-68
22316,0,0,126,0,-126
22317,0,0,44,0,-44
22318,1,0,32,0,-32
22319,1,1,404,1253,849
22320,1,0,54,0,-54
22321,0,0,45,0,-45
22322,0,0,46,0,-46
22323,1,1,127,1363,1236
22324,0,0,159,0,-159
22325,1,0,18,0,-18
22326,1,0,175,0,-175
22327,0,0,80,0,-80
22328,0,0,6,0,-6
22329,1,0,10,0,-10
22330,0,0,25,0,-25
22331,0,0,0,0,0
22332,0,0,23,0,-23
22333,0,0,26,0,-26
22334,0,0,31,0,-31
22335,1,1,367,1644,1277
22336,1,1,293,1987,1694
22337,1,1,230,1286,1056
22338,0,0,37,0,-37
22339,1,0,71,0,-71
22340,1,1,727,1311,584
22341,1,1,808,1888,1080
22342,0,0,6,0,-6
22343,0,0,8,0,-8
22344,0,0,6,0,-6
22345,0,0,75,0,-75
22346,1,1,133,1617,1484
22347,0,0,56,0,-56
22348,1,0,115,0,-115
22349,0,0,44,0,-44
22350,1,0,19,0,-19
22351,0,0,4,0,-4
22352,1,0,27,0,-27
22353,1,1,92,1257,1165
22354,0,0,33,0,-33
22355,0,0,9,0,-9
22356,0,0,9,0,-9
22357,0,0,10,0,-10
22358,0,0,16,0,-16
22359,0,0,19,0,-19
22360,0,0,82,0,-82
22361,0,0,30,0,-30
22362,0,0,1,0,-1
22363,0,0,84,0,-84
22364,0,0,47,0,-47
22365,0,0,67,0,-67
22366,0,0,12,0,-12
22367,1,1,58,1332,1274
22368,1,0,76,0,-76
22369,0,0,7,0,-7
22370,0,0,17,0,-17
22371,1,1,1552,1943,391
22372,0,0,135,0,-135
22373,1,0,125,0,-125
22374,1,1,558,1274,716
22375,1,0,69,0,-69
22376,0,0,194,0,-194
22377,1,0,202,0,-202
22378,1,1,849,1403,554
22379,1,0,86,0,-86
22380,0,0,80,0,-80
22381,1,1,140,3171,3031
22382,1,1,115,1243,1128
22383,1,0,18,0,-18
22384,0,0,9,0,-9
22385,0,0,10,0,-10
22386,1,1,1702,1517,-185
22387,1,1,757,1257,500
22388,1,0,87,0,-87
22389,0,0,11,0,-11
22390,1,0,12,0,-12
22391,0,0,81,0,-81
22392,1,1,224,1711,1487
22393,0,0,15,0,-15
22394,1,1,400,1571,1171
22395,0,0,54,0,-54
22396,0,0,44,0,-44
22397,1,0,56,0,-56
22398,0,0,35,0,-35
22399,1,1,868,1355,487
22400,1,0,69,0,-69
22401,0,0,2,0,-2
22402,1,0,22,0,-22
22403,0,0,22,0,-22
22404,1,1,167,1218,1051
22405,0,0,8,0,-8
22406,0,0,52,0,-52
22407,1,0,96,0,-96
22408,1,0,49,0,-49
22409,0,0,100,0,-100
22410,1,0,34,0,-34
22411,0,0,82,0,-82
22412,0,0,60,0,-60
22413,0,0,24,0,-24
22414,1,1,676,1628,952
22415,1,1,1323,2063,740
22416,0,0,3,0,-3
22417,1,0,159,0,-159
22418,1,1,1103,1798,695
22419,0,0,26,0,-26
22420,0,0,54,0,-54
22421,0,0,10,0,-10
22422,1,1,155,1300,1145
22423,1,1,111,2536,2425
22424,0,0,108,0,-108
22425,0,0,13,0,-13
22426,1,1,260,1894,1634
22427,1,1,1049,1275,226
22428,1,1,1121,1300,179
22429,1,0,98,0,-98
22430,1,0,13,0,-13
22431,1,0,27,0,-27
22432,0,0,21,0,-21
22433,1,0,5,0,-5
22434,0,0,6,0,-6
22435,1,0,3,0,-3
22436,1,1,388,1504,1116
22437,1,0,102,0,-102
22438,0,0,8,0,-8
22439,0,0,9,0,-9
22440,0,0,25,0,-25
22441,1,1,180,1336,1156
22442,1,1,180,2223,2043
22443,0,0,30,0,-30
22444,0,0,24,0,-24
22445,0,0,82,0,-82
22446,1,1,482,1453,971
22447,0,0,66,0,-66
22448,0,0,17,0,-17
22449,1,0,9,0,-9
22450,1,0,31,0,-31
22451,1,0,28,0,-28
22452,1,0,22,0,-22
22453,0,0,21,0,-21
22454,1,0,4,0,-4
22455,1,0,65,0,-65
22456,0,0,34,0,-34
22457,1,1,107,1342,1235
22458,1,1,2446,1721,-725
22459,0,0,4,0,-4
22460,1,0,14,0,-14
22461,1,0,35,0,-35
22462,1,1,212,1602,1390
22463,0,0,83,0,-83
22464,1,1,33,1487,1454
22465,1,0,10,0,-10
22466,0,0,72,0,-72
22467,1,1,1148,1320,172
22468,0,0,1,0,-1
22469,0,0,6,0,-6
22470,1,1,340,1227,887
22471,1,0,25,0,-25
22472,0,0,16,0,-16
22473,1,1,476,1643,1167
22474,0,0,65,0,-65
22475,0,0,0,0,0
22476,0,0,8,0,-8
22477,1,1,1173,1321,148
22478,1,0,57,0,-57
22479,1,1,262,1741,1479
22480,1,1,222,1804,1582
22481,0,0,13,0,-13
22482,1,1,1550,1278,-272
22483,1,0,60,0,-60
22484,0,0,126,0,-126
22485,1,1,1704,1235,-469
22486,1,1,534,1547,1013
22487,1,0,13,0,-13
22488,1,0,125,0,-125
22489,1,0,9,0,-9
22490,0,0,82,0,-82
22491,1,1,55,2274,2219
22492,0,0,24,0,-24
22493,1,0,101,0,-101
22494,1,0,31,0,-31
22495,1,0,2,0,-2
22496,0,0,19,0,-19
22497,1,1,1558,1249,-309
22498,1,1,335,1311,976
22499,0,0,127,0,-127
22500,0,0,97,0,-97
22501,1,0,102,0,-102
22502,0,0,36,0,-36
22503,1,0,5,0,-5
22504,0,0,38,0,-38
22505,0,0,51,0,-51
22506,0,0,52,0,-52
22507,1,0,26,0,-26
22508,1,1,195,1225,1030
22509,1,1,1036,1279,243
22510,1,0,67,0,-67
22511,1,0,100,0,-100
22512,1,1,689,1397,708
22513,1,0,38,0,-38
22514,1,0,42,0,-42
22515,1,1,1244,1398,154
22516,1,0,41,0,-41
22517,1,0,66,0,-66
22518,0,0,2,0,-2
22519,0,0,106,0,-106
22520,0,0,12,0,-12
22521,1,0,5,0,-5
22522,0,0,18,0,-18
22523,1,1,756,1364,608
22524,1,1,97,1265,1168
22525,1,0,25,0,-25
22526,1,1,3920,1731,-2189
22527,1,0,33,0,-33
22528,0,0,93,0,-93
22529,1,1,262,1331,1069
22530,1,0,23,0,-23
22531,1,1,256,1321,1065
22532,1,1,296,1603,1307
22533,0,0,8,0,-8
22534,1,0,25,0,-25
22535,0,0,7,0,-7
22536,0,0,25,0,-25
22537,1,0,83,0,-83
22538,1,0,43,0,-43
22539,1,1,957,1675,718
22540,1,0,39,0,-39
22541,1,1,325,1664,1339
22542,0,0,2,0,-2
22543,1,0,13,0,-13
22544,1,0,50,0,-50
22545,1,0,0,0,0
22546,0,0,73,0,-73
22547,0,0,45,0,-45
22548,1,1,788,1386,598
22549,1,0,1,0,-1
22550,0,0,97,0,-97
22551,0,0,10,0,-10
22552,0,0,65,0,-65
22553,0,0,12,0,-12
22554,0,0,16,0,-16
22555,1,0,99,0,-99
22556,1,1,1739,1935,196
22557,1,1,21,1825,1804
22558,1,0,6,0,-6
22559,1,1,282,1235,953
22560,1,0,57,0,-57
22561,1,1,585,1388,803
22562,1,1,172,1518,1346
22563,1,0,99,0,-99
22564,1,0,105,0,-105
22565,1,0,1,0,-1
22566,1,0,36,0,-36
22567,0,0,19,0,-19
22568,0,0,4,0,-4
22569,0,0,6,0,-6
22570,1,1,1363,1330,-33
22571,0,0,14,0,-14
22572,1,1,1183,1880,697
22573,1,0,23,0,-23
22574,0,0,70,0,-70
22575,1,1,793,1200,407
22576,0,0,10,0,-10
22577,1,1,618,1563,945
22578,0,0,19,0,-19
22579,1,1,229,1262,1033
22580,1,1,243,1466,1223
22581,0,0,52,0,-52
22582,1,0,82,0,-82
22583,0,0,15,0,-15
22584,1,0,27,0,-27
22585,0,0,5,0,-5
22586,0,0,16,0,-16
22587,0,0,46,0,-46
22588,0,0,88,0,-88
22589,1,0,19,0,-19
22590,1,1,698,1637,939
22591,0,0,4,0,-4
22592,1,1,45,1265,1220
22593,1,1,184,1887,1703
22594,1,0,146,0,-146
22595,1,0,9,0,-9
22596,1,1,641,1304,663
22597,1,1,1204,1310,106
22598,0,0,3,0,-3
22599,1,1,842,8495,7653
22600,0,0,41,0,-41
22601,1,0,37,0,-37
22602,1,1,142,1327,1185
22603,1,0,32,0,-32
22604,1,1,43,1452,1409
22605,1,0,2,0,-2
22606,0,0,174,0,-174
22607,1,1,517,1580,1063
22608,0,0,71,0,-71
22609,0,0,115,0,-115
22610,0,0,3,0,-3
22611,0,0,139,0,-139
22612,0,0,8,0,-8
22613,1,1,230,1269,1039
22614,1,1,985,1684,699
22615,1,1,1370,1257,-113
22616,1,1,491,1830,1339
22617,1,0,21,0,-21
22618,0,0,15,0,-15
22619,1,0,27,0,-27
22620,1,0,74,0,-74
22621,0,0,10,0,-10
22622,0,0,24,0,-24
22623,0,0,20,0,-20
22624,0,0,68,0,-68
22625,1,0,91,0,-91
22626,1,1,333,2286,1953
22627,1,0,121,0,-121
22628,1,1,245,1266,1021
22629,0,0,7,0,-7
22630,1,0,46,0,-46
22631,1,0,31,0,-31
22632,1,1,233,1200,967
22633,0,0,87,0,-87
22634,1,1,256,1918,1662
22635,1,0,25,0,-25
22636,0,0,12,0,-12
22637,0,0,181,0,-181
22638,1,1,507,1773,1266
22639,0,0,87,0,-87
22640,0,0,390,0,-390
22641,1,0,8,0,-8
22642,0,0,39,0,-39
22643,0,0,15,0,-15
22644,0,0,103,0,-103
22645,0,0,123,0,-123
22646,1,1,340,1210,870
22647,1,0,8,0,-8
22648,0,0,13,0,-13
22649,1,0,38,0,-38
22650,0,0,18,0,-18
22651,1,0,116,0,-116
22652,1,1,134,2116,1982
22653,0,0,72,0,-72
22654,0,0,5,0,-5
22655,1,0,3,0,-3
22656,0,0,130,0,-130
22657,1,1,59,1541,1482
22658,0,0,16,0,-16
22659,0,0,5,0,-5
22660,1,0,14,0,-14
22661,0,0,45,0,-45
22662,1,1,345,1962,1617
22663,1,1,164,1321,1157
22664,0,0,6,0,-6
22665,1,1,1149,1962,813
22666,0,0,72,0,-72
22667,0,0,32,0,-32
22668,0,0,16,0,-16
22669,1,1,271,1299,1028
22670,0,0,36,0,-36
22671,1,1,260,1349,1089
22672,1,0,24,0,-24
22673,0,0,21,0,-21
22674,1,0,4,0,-4
22675,1,0,21,0,-21
22676,1,1,72,1338,1266
22677,1,1,504,1416,912
22678,0,0,4,0,-4
22679,0,0,82,0,-82
22680,1,0,6,0,-6
22681,0,0,5,0,-5
22682,1,1,71,1299,1228
22683,1,0,1,0,-1
22684,0,0,41,0,-41
22685,0,0,15,0,-15
22686,0,0,42,0,-42
22687,0,0,75,0,-75
22688,1,0,36,0,-36
22689,1,0,22,0,-22
22690,1,0,17,0,-17
22691,1,1,1376,2899,1523
22692,1,1,769,1658,889
22693,1,0,46,0,-46
22694,0,0,7,0,-7
22695,0,0,107,0,-107
22696,1,0,5,0,-5
22697,1,1,430,1290,860
22698,1,1,214,1254,1040
22699,1,0,11,0,-11
22700,1,1,158,1770,1612
22701,1,0,49,0,-49
22702,1,0,10,0,-10
22703,0,0,209,0,-209
22704,0,0,16,0,-16
22705,1,0,46,0,-46
22706,1,1,256,1238,982
22707,1,0,85,0,-85
22708,1,1,70,1408,1338
22709,0,0,8,0,-8
22710,1,1,888,1533,645
22711,0,0,33,0,-33
22712,1,0,20,0,-20
22713,0,0,84,0,-84
22714,0,0,6,0,-6
22715,1,1,614,1506,892
22716,1,1,686,1275,589
22717,1,0,5,0,-5
22718,1,1,716,1345,629
22719,1,1,695,1480,785
22720,1,0,44,0,-44
22721,1,1,433,1675,1242
22722,1,0,95,0,-95
22723,1,0,56,0,-56
22724,1,0,54,0,-54
22725,1,1,1129,1208,79
22726,0,0,4,0,-4
22727,0,0,182,0,-182
22728,1,0,54,0,-54
22729,0,0,27,0,-27
22730,0,0,58,0,-58
22731,0,0,90,0,-90
22732,0,0,11,0,-11
22733,1,0,52,0,-52
22734,1,1,535,1684,1149
22735,1,1,603,1247,644
22736,0,0,36,0,-36
22737,1,1,2068,2474,406
22738,1,0,21,0,-21
22739,1,0,32,0,-32
22740,0,0,8,0,-8
22741,1,1,343,1350,1007
22742,0,0,14,0,-14
22743,1,0,47,0,-47
22744,1,1,185,1230,1045
22745,1,0,14,0,-14
22746,1,1,1160,1539,379
22747,1,1,935,2263,1328
22748,1,1,529,1453,924
22749,0,0,115,0,-115
22750,1,0,19,0,-19
22751,1,1,975,1219,244
22752,1,0,9,0,-9
22753,0,0,5,0,-5
22754,0,0,55,0,-55
22755,0,0,42,0,-42
22756,0,0,1,0,-1
22757,1,1,357,1288,931
22758,1,0,51,0,-51
22759,1,1,674,1536,862
22760,0,0,33,0,-33
22761,0,0,102,0,-102
22762,0,0,74,0,-74
22763,0,0,12,0,-12
22764,1,1,1070,2748,1678
22765,1,0,12,0,-12
22766,0,0,13,0,-13
22767,1,0,9,0,-9
22768,1,0,5,0,-5
22769,0,0,2,0,-2
22770,1,1,973,1254,281
22771,0,0,64,0,-64
22772,1,0,9,0,-9
22773,1,1,187,1262,1075
22774,0,0,30,0,-30
22775,0,0,29,0,-29
22776,0,0,7,0,-7
22777,1,1,140,1505,1365
22778,0,0,146,0,-146
22779,1,0,217,0,-217
22780,0,0,147,0,-147
22781,0,0,65,0,-65
22782,0,0,65,0,-65
22783,1,0,126,0,-126
22784,1,1,181,1686,1505
22785,1,0,126,0,-126
22786,1,1,65,1227,1162
22787,1,0,6,0,-6
22788,0,0,8,0,-8
22789,1,1,204,1913,1709
22790,1,1,45,3000,2955
22791,1,1,90,1299,1209
22792,1,1,628,2408,1780
22793,0,0,197,0,-197
22794,1,1,516,1428,912
22795,0,0,55,0,-55
22796,1,1,614,1644,1030
22797,0,0,41,0,-41
22798,0,0,73,0,-73
22799,1,1,79,1269,1190
22800,1,1,376,1664,1288
22801,0,0,35,0,-35
22802,1,1,170,1282,1112
22803,1,0,11,0,-11
22804,1,1,929,2152,1223
22805,0,0,3,0,-3
22806,1,1,1998,1297,-701
22807,0,0,50,0,-50
22808,1,1,418,1226,808
22809,0,0,62,0,-62
22810,0,0,1,0,-1
22811,1,1,1113,1356,243
22812,1,0,35,0,-35
22813,1,1,208,1379,1171
22814,0,0,108,0,-108
22815,1,1,271,1305,1034
22816,0,0,25,0,-25
22817,0,0,49,0,-49
22818,1,1,415,1833,1418
22819,1,0,23,0,-23
22820,1,1,44,1330,1286
22821,1,0,19,0,-19
22822,1,0,92,0,-92
22823,1,0,15,0,-15
22824,0,0,36,0,-36
22825,1,0,25,0,-25
22826,0,0,7,0,-7
22827,1,1,384,1686,1302
22828,1,1,944,1731,787
22829,1,0,12,0,-12
22830,1,0,51,0,-51
22831,0,0,3,0,-3
22832,1,0,34,0,-34
22833,0,0,89,0,-89
22834,1,1,1364,1311,-53
22835,1,0,26,0,-26
22836,0,0,12,0,-12
22837,0,0,15,0,-15
22838,0,0,2,0,-2
22839,0,0,9,0,-9
22840,0,0,40,0,-40
22841,1,0,155,0,-155
22842,0,0,129,0,-129
22843,1,0,67,0,-67
22844,1,1,930,1790,860
22845,1,1,218,1654,1436
22846,0,0,62,0,-62
22847,1,0,7,0,-7
22848,0,0,14,0,-14
22849,0,0,23,0,-23
22850,1,0,64,0,-64
22851,1,0,85,0,-85
22852,0,0,151,0,-151
22853,0,0,100,0,-100
22854,1,1,1580,2310,730
22855,0,0,28,0,-28
22856,1,0,2,0,-2
22857,1,1,138,3759,3621
22858,0,0,13,0,-13
22859,1,1,383,1516,1133
22860,0,0,89,0,-89
22861,0,0,26,0,-26
22862,0,0,72,0,-72
22863,0,0,31,0,-31
22864,0,0,26,0,-26
22865,1,1,1584,2137,553
22866,0,0,115,0,-115
22867,1,0,6,0,-6
22868,0,0,21,0,-21
22869,1,1,268,1272,1004
22870,1,0,5,0,-5
22871,1,1,327,1221,894
22872,1,1,247,8648,8401
22873,1,0,84,0,-84
22874,1,0,6,0,-6
22875,0,0,16,0,-16
22876,0,0,235,0,-235
22877,1,1,129,1220,1091
22878,1,0,14,0,-14
22879,1,1,177,3035,2858
22880,1,0,57,0,-57
22881,1,0,25,0,-25
22882,0,0,28,0,-28
22883,0,0,7,0,-7
22884,1,0,35,0,-35
22885,0,0,116,0,-116
22886,0,0,28,0,-28
22887,0,0,41,0,-41
22888,1,0,10,0,-10
22889,1,0,112,0,-112
22890,1,0,64,0,-64
22891,1,1,211,1451,1240
22892,1,1,1360,1285,-75
22893,0,0,7,0,-7
22894,1,0,0,0,0
22895,1,0,147,0,-147
22896,1,1,214,1566,1352
22897,1,0,56,0,-56
22898,1,1,191,1239,1048
22899,1,1,897,1514,617
22900,1,1,106,1366,1260
22901,0,0,67,0,-67
22902,0,0,14,0,-14
22903,1,0,18,0,-18
22904,0,0,125,0,-125
22905,1,0,18,0,-18
22906,0,0,67,0,-67
22907,1,1,646,1633,987
22908,0,0,123,0,-123
22909,0,0,2,0,-2
22910,0,0,65,0,-65
22911,0,0,6,0,-6
22912,1,1,541,1412,871
22913,1,1,235,1599,1364
22914,1,1,150,1267,1117
22915,0,0,10,0,-10
22916,0,0,45,0,-45
22917,1,1,438,1499,1061
22918,0,0,19,0,-19
22919,1,0,3,0,-3
22920,1,1,92,1253,1161
22921,1,1,382,2045,1663
22922,1,0,16,0,-16
22923,1,1,455,3622,3167
22924,0,0,49,0,-49
22925,0,0,56,0,-56
22926,1,0,107,0,-107
22927,1,0,57,0,-57
22928,1,1,748,1286,538
22929,1,0,28,0,-28
22930,0,0,12,0,-12
22931,0,0,85,0,-85
22932,1,0,89,0,-89
22933,1,1,411,1377,966
22934,1,1,586,1503,917
22935,1,1,123,4745,4622
22936,1,1,119,1272,1153
22937,0,0,10,0,-10
22938,1,0,174,0,-174
22939,1,1,141,1285,1144
22940,0,0,142,0,-142
22941,1,1,1322,1347,25
22942,0,0,9,0,-9
22943,0,0,81,0,-81
22944,1,0,64,0,-64
22945,0,0,192,0,-192
22946,1,0,34,0,-34
22947,0,0,52,0,-52
22948,1,1,575,2162,1587
22949,1,0,186,0,-186
22950,1,1,503,1541,1038
22951,0,0,6,0,-6
22952,1,1,790,1917,1127
22953,1,0,16,0,-16
22954,0,0,21,0,-21
22955,1,0,2,0,-2
22956,0,0,106,0,-106
22957,0,0,13,0,-13
22958,1,0,30,0,-30
22959,0,0,90,0,-90
22960,0,0,66,0,-66
22961,1,1,176,1575,1399
22962,0,0,11,0,-11
22963,0,0,24,0,-24
22964,1,1,1358,1201,-157
22965,1,0,42,0,-42
22966,1,1,1060,2088,1028
22967,0,0,39,0,-39
22968,1,1,776,1335,559
22969,1,0,33,0,-33
22970,1,0,16,0,-16
22971,1,0,22,0,-22
22972,0,0,33,0,-33
22973,1,0,102,0,-102
22974,0,0,24,0,-24
22975,1,1,97,1225,1128
22976,1,1,157,3092,2935
22977,0,0,7,0,-7
22978,0,0,29,0,-29
22979,1,1,1627,1390,-237
22980,1,1,1401,1245,-156
22981,0,0,73,0,-73
22982,0,0,23,0,-23
22983,1,0,56,0,-56
22984,1,0,9,0,-9
22985,0,0,2,0,-2
22986,1,1,935,1550,615
22987,1,1,271,1554,1283
22988,1,0,19,0,-19
22989,1,0,28,0,-28
22990,1,0,37,0,-37
22991,1,0,167,0,-167
22992,0,0,10,0,-10
22993,1,0,33,0,-33
22994,0,0,95,0,-95
22995,0,0,86,0,-86
22996,0,0,4,0,-4
22997,0,0,39,0,-39
22998,0,0,3,0,-3
22999,1,0,94,0,-94
23000,1,0,24,0,-24
23001,1,1,531,1317,786
23002,1,0,102,0,-102
23003,1,0,5,0,-5
23004,1,1,518,1717,1199
23005,1,1,618,2047,1429
23006,0,0,23,0,-23
23007,1,0,20,0,-20
23008,0,0,11,0,-11
23009,1,1,1251,2363,1112
23010,0,0,182,0,-182
23011,1,1,1493,2106,613
23012,0,0,77,0,-77
23013,1,1,157,1734,1577
23014,1,1,358,1735,1377
23015,1,1,292,1356,1064
23016,1,1,676,1608,932
23017,1,1,423,1242,819
23018,0,0,74,0,-74
23019,1,1,319,1732,1413
23020,1,0,6,0,-6
23021,1,0,13,0,-13
23022,1,0,28,0,-28
23023,0,0,41,0,-41
23024,1,1,311,1580,1269
23025,1,1,241,1475,1234
23026,1,1,215,1928,1713
23027,0,0,447,0,-447
23028,0,0,22,0,-22
23029,0,0,9,0,-9
23030,1,1,233,1394,1161
23031,0,0,123,0,-123
23032,0,0,10,0,-10
23033,1,0,2,0,-2
23034,1,0,86,0,-86
23035,1,1,649,1708,1059
23036,0,0,20,0,-20
23037,0,0,85,0,-85
23038,0,0,57,0,-57
23039,1,1,1333,1387,54
23040,0,0,17,0,-17
23041,0,0,138,0,-138
23042,0,0,176,0,-176
23043,1,1,486,1212,726
23044,0,0,2,0,-2
23045,0,0,12,0,-12
23046,0,0,0,0,0
23047,0,0,176,0,-176
23048,1,1,813,1473,660
23049,1,1,1346,3434,2088
23050,0,0,15,0,-15
23051,1,0,93,0,-93
23052,0,0,50,0,-50
23053,0,0,16,0,-16
23054,1,1,426,1235,809
23055,1,1,751,1416,665
23056,1,1,520,3775,3255
23057,0,0,20,0,-20
23058,1,1,199,1218,1019
23059,1,1,1317,2451,1134
23060,1,0,47,0,-47
23061,1,1,582,1939,1357
23062,0,0,8,0,-8
23063,1,0,24,0,-24
23064,0,0,13,0,-13
23065,1,1,690,1510,820
23066,1,1,488,1312,824
23067,1,0,19,0,-19
23068,1,1,98,1560,1462
23069,0,0,193,0,-193
23070,0,0,8,0,-8
23071,1,1,1530,1263,-267
23072,1,1,323,1484,1161
23073,0,0,34,0,-34
23074,1,1,223,1542,1319
23075,0,0,21,0,-21
23076,1,0,2,0,-2
23077,1,0,148,0,-148
23078,0,0,18,0,-18
23079,1,0,5,0,-5
23080,1,0,65,0,-65
23081,0,0,137,0,-137
23082,1,1,21,1308,1287
23083,1,1,201,1417,1216
23084,1,1,832,1206,374
23085,1,0,24,0,-24
23086,0,0,60,0,-60
23087,1,1,62,2084,2022
23088,1,0,3,0,-3
23089,0,0,66,0,-66
23090,1,1,1325,1430,105
23091,0,0,14,0,-14
23092,0,0,66,0,-66
23093,0,0,0,0,0
23094,1,1,324,1235,911
23095,1,1,116,1234,1118
23096,0,0,17,0,-17
23097,1,1,1700,1631,-69
23098,1,0,75,0,-75
23099,1,0,29,0,-29
23100,0,0,0,0,0
23101,1,1,575,2358,1783
23102,1,0,117,0,-117
23103,0,0,68,0,-68
23104,1,0,17,0,-17
23105,1,0,21,0,-21
23106,1,0,54,0,-54
23107,0,0,98,0,-98
23108,1,0,214,0,-214
23109,0,0,0,0,0
23110,0,0,105,0,-105
23111,0,0,44,0,-44
23112,0,0,24,0,-24
23113,1,1,779,2128,1349
23114,1,1,80,1272,1192
23115,0,0,133,0,-133
23116,1,1,603,1219,616
23117,1,1,1272,1380,108
23118,1,1,485,1677,1192
23119,0,0,11,0,-11
23120,1,1,52,1245,1193
23121,0,0,53,0,-53
23122,0,0,42,0,-42
23123,1,0,106,0,-106
23124,0,0,42,0,-42
23125,0,0,21,0,-21
23126,1,1,763,1774,1011
23127,1,1,826,1496,670
23128,1,1,400,1393,993
23129,1,0,175,0,-175
23130,1,0,64,0,-64
23131,1,0,10,0,-10
23132,0,0,6,0,-6
23133,0,0,23,0,-23
23134,0,0,18,0,-18
23135,1,0,46,0,-46
23136,1,1,573,1238,665
23137,0,0,20,0,-20
23138,0,0,1,0,-1
23139,1,1,149,1844,1695
23140,0,0,36,0,-36
23141,1,0,9,0,-9
23142,0,0,35,0,-35
23143,1,1,603,1414,811
23144,0,0,46,0,-46
23145,0,0,80,0,-80
23146,0,0,10,0,-10
23147,1,0,44,0,-44
23148,1,1,992,1438,446
23149,0,0,113,0,-113
23150,1,0,21,0,-21
23151,0,0,50,0,-50
23152,0,0,9,0,-9
23153,1,0,3,0,-3
23154,0,0,64,0,-64
23155,1,0,13,0,-13
23156,1,1,21,1326,1305
23157,1,1,287,2071,1784
23158,0,0,88,0,-88
23159,1,0,32,0,-32
23160,1,1,511,1375,864
23161,0,0,91,0,-91
23162,0,0,20,0,-20
23163,0,0,2,0,-2
23164,1,1,754,1558,804
23165,0,0,182,0,-182
23166,0,0,97,0,-97
23167,0,0,56,0,-56
23168,1,0,99,0,-99
23169,1,0,119,0,-119
23170,1,0,22,0,-22
23171,0,0,22,0,-22
23172,0,0,1,0,-1
23173,1,1,161,1309,1148
23174,0,0,5,0,-5
23175,0,0,55,0,-55
23176,1,1,71,1475,1404
23177,1,0,8,0,-8
23178,1,1,914,1492,578
23179,0,0,205,0,-205
23180,1,1,137,1648,1511
23181,0,0,79,0,-79
23182,1,0,1,0,-1
23183,0,0,120,0,-120
23184,0,0,50,0,-50
23185,0,0,89,0,-89
23186,0,0,1,0,-1
23187,1,1,545,1212,667
23188,1,0,18,0,-18
23189,1,0,25,0,-25
23190,1,1,482,1552,1070
23191,1,1,997,1200,203
23192,0,0,48,0,-48
23193,1,0,31,0,-31
23194,1,1,152,1206,1054
23195,1,0,88,0,-88
23196,1,1,61,1426,1365
23197,0,0,28,0,-28
23198,1,0,4,0,-4
23199,0,0,33,0,-33
23200,0,0,80,0,-80
23201,1,1,1616,4059,2443
23202,1,0,3,0,-3
23203,1,0,16,0,-16
23204,1,0,0,0,0
23205,1,0,7,0,-7
23206,0,0,70,0,-70
23207,1,0,43,0,-43
23208,0,0,41,0,-41
23209,1,0,66,0,-66
23210,0,0,94,0,-94
23211,1,0,80,0,-80
23212,1,0,5,0,-5
23213,0,0,55,0,-55
23214,1,1,1612,1766,154
23215,1,1,798,2286,1488
23216,1,0,63,0,-63
23217,1,0,30,0,-30
23218,1,0,79,0,-79
23219,1,0,21,0,-21
23220,0,0,15,0,-15
23221,0,0,51,0,-51
23222,1,0,0,0,0
23223,1,0,112,0,-112
23224,1,0,8,0,-8
23225,0,0,0,0,0
23226,1,1,1098,1648,550
23227,0,0,60,0,-60
23228,0,0,35,0,-35
23229,1,1,92,1267,1175
23230,0,0,46,0,-46
23231,0,0,16,0,-16
23232,1,0,104,0,-104
23233,0,0,30,0,-30
23234,1,1,379,1334,955
23235,1,1,339,1777,1438
23236,1,1,2766,1364,-1402
23237,1,0,6,0,-6
23238,1,0,29,0,-29
23239,1,1,600,1221,621
23240,0,0,79,0,-79
23241,1,0,45,0,-45
23242,1,0,11,0,-11
23243,1,0,14,0,-14
23244,0,0,1,0,-1
23245,1,1,2120,2507,387
23246,1,1,394,1282,888
23247,0,0,100,0,-100
23248,0,0,151,0,-151
23249,1,0,29,0,-29
23250,1,0,147,0,-147
23251,0,0,150,0,-150
23252,0,0,42,0,-42
23253,0,0,73,0,-73
23254,1,0,60,0,-60
23255,1,0,5,0,-5
23256,0,0,163,0,-163
23257,0,0,184,0,-184
23258,1,1,945,2057,1112
23259,0,0,2,0,-2
23260,0,0,45,0,-45
23261,0,0,6,0,-6
23262,0,0,76,0,-76
23263,1,0,171,0,-171
23264,1,1,360,1532,1172
23265,0,0,18,0,-18
23266,0,0,38,0,-38
23267,1,1,77,1201,1124
23268,0,0,18,0,-18
23269,1,1,270,1214,944
23270,1,0,35,0,-35
23271,1,0,22,0,-22
23272,1,0,11,0,-11
23273,0,0,64,0,-64
23274,1,0,14,0,-14
23275,0,0,108,0,-108
23276,1,0,55,0,-55
23277,1,0,11,0,-11
23278,0,0,260,0,-260
23279,1,1,677,3689,3012
23280,1,1,290,1580,1290
23281,1,1,180,1652,1472
23282,0,0,69,0,-69
23283,1,0,18,0,-18
23284,0,0,4,0,-4
23285,1,1,296,1887,1591
23286,0,0,16,0,-16
23287,1,0,6,0,-6
23288,0,0,45,0,-45
23289,1,0,39,0,-39
23290,1,0,107,0,-107
23291,1,1,205,1380,1175
23292,0,0,61,0,-61
23293,1,1,424,1462,1038
23294,0,0,12,0,-12
23295,1,1,900,1214,314
23296,0,0,109,0,-109
23297,1,0,45,0,-45
23298,1,0,42,0,-42
23299,0,0,18,0,-18
23300,1,0,24,0,-24
23301,1,0,60,0,-60
23302,1,0,83,0,-83
23303,0,0,37,0,-37
23304,1,1,580,2288,1708
23305,1,1,220,3495,3275
23306,1,1,759,1563,804
23307,1,1,278,1468,1190
23308,0,0,46,0,-46
23309,0,0,19,0,-19
23310,1,1,355,1730,1375
23311,0,0,52,0,-52
23312,0,0,5,0,-5
23313,1,0,33,0,-33
23314,1,1,159,1517,1358
23315,1,1,798,2038,1240
23316,1,1,54,1556,1502
23317,0,0,36,0,-36
23318,0,0,15,0,-15
23319,1,1,735,1435,700
23320,1,0,32,0,-32
23321,0,0,58,0,-58
23322,0,0,10,0,-10
23323,1,1,56,1507,1451
23324,1,1,474,1253,779
23325,1,0,12,0,-12
23326,1,1,97,1206,1109
23327,0,0,2,0,-2
23328,0,0,20,0,-20
23329,0,0,24,0,-24
23330,0,0,148,0,-148
23331,1,1,411,1748,1337
23332,1,1,1233,1218,-15
23333,0,0,22,0,-22
23334,1,0,32,0,-32
23335,0,0,140,0,-140
23336,1,1,405,2245,1840
23337,1,1,193,1306,1113
23338,1,0,182,0,-182
23339,0,0,21,0,-21
23340,0,0,6,0,-6
23341,1,0,13,0,-13
23342,0,0,133,0,-133
23343,1,1,1380,1339,-41
23344,0,0,7,0,-7
23345,0,0,17,0,-17
23346,1,0,11,0,-11
23347,1,1,969,4588,3619
23348,1,1,805,1411,606
23349,1,0,13,0,-13
23350,0,0,37,0,-37
23351,1,0,15,0,-15
23352,0,0,61,0,-61
23353,1,1,301,1282,981
23354,0,0,52,0,-52
23355,1,0,9,0,-9
23356,1,0,4,0,-4
23357,1,0,66,0,-66
23358,0,0,11,0,-11
23359,1,0,9,0,-9
23360,1,1,358,1480,1122
23361,1,0,48,0,-48
23362,1,0,11,0,-11
23363,1,0,25,0,-25
23364,1,0,15,0,-15
23365,1,0,62,0,-62
23366,0,0,4,0,-4
23367,1,1,836,1277,441
23368,1,0,66,0,-66
23369,1,0,30,0,-30
23370,0,0,238,0,-238
23371,0,0,117,0,-117
23372,1,1,242,1512,1270
23373,1,0,23,0,-23
23374,1,0,13,0,-13
23375,1,1,1056,1233,177
23376,1,1,333,1240,907
23377,1,0,85,0,-85
23378,1,1,271,1549,1278
23379,1,1,548,2244,1696
23380,0,0,13,0,-13
23381,0,0,48,0,-48
23382,1,0,68,0,-68
23383,0,0,53,0,-53
23384,1,1,2476,1382,-1094
23385,1,0,69,0,-69
23386,1,0,14,0,-14
23387,0,0,59,0,-59
23388,0,0,67,0,-67
23389,0,0,11,0,-11
23390,1,0,64,0,-64
23391,1,1,796,1221,425
23392,0,0,23,0,-23
23393,0,0,50,0,-50
23394,1,0,31,0,-31
23395,1,1,2149,1259,-890
23396,0,0,7,0,-7
23397,0,0,26,0,-26
23398,0,0,0,0,0
23399,0,0,10,0,-10
23400,0,0,15,0,-15
23401,0,0,14,0,-14
23402,0,0,23,0,-23
23403,1,1,274,1786,1512
23404,1,1,318,1335,1017
23405,1,1,127,1557,1430
23406,1,0,54,0,-54
23407,1,1,208,1988,1780
23408,0,0,31,0,-31
23409,1,0,122,0,-122
23410,1,0,172,0,-172
23411,1,1,328,1204,876
23412,0,0,35,0,-35
23413,1,1,438,1215,777
23414,0,0,15,0,-15
23415,1,1,1004,2454,1450
23416,1,0,64,0,-64
23417,0,0,12,0,-12
23418,1,1,995,1381,386
23419,1,0,45,0,-45
23420,0,0,34,0,-34
23421,0,0,86,0,-86
23422,0,0,150,0,-150
23423,0,0,76,0,-76
23424,0,0,33,0,-33
23425,1,0,157,0,-157
23426,1,1,389,1247,858
23427,0,0,33,0,-33
23428,0,0,95,0,-95
23429,0,0,36,0,-36
23430,1,1,1013,1357,344
23431,0,0,25,0,-25
23432,1,1,224,1347,1123
23433,0,0,13,0,-13
23434,0,0,13,0,-13
23435,0,0,262,0,-262
23436,1,0,21,0,-21
23437,1,0,72,0,-72
23438,1,0,66,0,-66
23439,1,1,43,1590,1547
23440,1,1,208,1295,1087
23441,0,0,207,0,-207
23442,1,0,65,0,-65
23443,0,0,53,0,-53
23444,1,1,446,1394,948
23445,0,0,23,0,-23
23446,1,0,11,0,-11
23447,0,0,5,0,-5
23448,0,0,54,0,-54
23449,0,0,60,0,-60
23450,1,0,0,0,0
23451,0,0,1,0,-1
23452,1,0,21,0,-21
23453,1,1,73,1214,1141
23454,0,0,17,0,-17
23455,1,0,41,0,-41
23456,1,0,88,0,-88
23457,0,0,6,0,-6
23458,1,0,21,0,-21
23459,0,0,46,0,-46
23460,0,0,5,0,-5
23461,0,0,0,0,0
23462,1,1,557,1421,864
23463,1,1,165,2032,1867
23464,1,1,290,1208,918
23465,1,0,0,0,0
23466,1,0,141,0,-141
23467,0,0,63,0,-63
23468,1,0,8,0,-8
23469,0,0,18,0,-18
23470,0,0,70,0,-70
23471,1,1,137,1236,1099
23472,1,1,1460,1870,410
23473,0,0,24,0,-24
23474,0,0,50,0,-50
23475,0,0,81,0,-81
23476,0,0,45,0,-45
23477,0,0,4,0,-4
23478,0,0,27,0,-27
23479,1,1,551,1218,667
23480,0,0,3,0,-3
23481,1,1,1012,1301,289
23482,1,0,11,0,-11
23483,1,0,54,0,-54
23484,0,0,11,0,-11
23485,1,1,225,1378,1153
23486,0,0,6,0,-6
23487,1,0,3,0,-3
23488,1,0,43,0,-43
23489,0,0,112,0,-112
23490,1,0,10,0,-10
23491,1,0,23,0,-23
23492,0,0,49,0,-49
23493,0,0,45,0,-45
23494,0,0,182,0,-182
23495,0,0,7,0,-7
23496,0,0,46,0,-46
23497,0,0,16,0,-16
23498,0,0,9,0,-9
23499,0,0,42,0,-42
23500,1,0,148,0,-148
23501,1,0,29,0,-29
23502,0,0,21,0,-21
23503,1,0,9,0,-9
23504,0,0,10,0,-10
23505,0,0,30,0,-30
23506,0,0,71,0,-71
23507,1,0,0,0,0
23508,1,1,448,1325,877
23509,1,1,606,1356,750
23510,1,0,63,0,-63
23511,1,0,31,0,-31
23512,0,0,4,0,-4
23513,1,1,1295,1205,-90
23514,0,0,4,0,-4
23515,0,0,66,0,-66
23516,0,0,77,0,-77
23517,0,0,8,0,-8
23518,1,0,164,0,-164
23519,1,0,38,0,-38
23520,0,0,36,0,-36
23521,1,0,19,0,-19
23522,0,0,5,0,-5
23523,1,1,267,2397,2130
23524,1,0,45,0,-45
23525,0,0,28,0,-28
23526,0,0,17,0,-17
23527,0,0,26,0,-26
23528,0,0,10,0,-10
23529,1,0,42,0,-42
23530,1,1,183,1465,1282
23531,0,0,28,0,-28
23532,0,0,19,0,-19
23533,0,0,4,0,-4
23534,1,0,1,0,-1
23535,0,0,32,0,-32
23536,0,0,109,0,-109
23537,1,1,464,1411,947
23538,1,0,170,0,-170
23539,1,1,59,1484,1425
23540,0,0,17,0,-17
23541,0,0,74,0,-74
23542,0,0,31,0,-31
23543,1,0,76,0,-76
23544,1,1,583,1928,1345
23545,0,0,43,0,-43
23546,1,1,725,1379,654
23547,0,0,26,0,-26
23548,0,0,21,0,-21
23549,0,0,21,0,-21
23550,1,0,65,0,-65
23551,1,0,31,0,-31
23552,0,0,3,0,-3
23553,1,1,312,1273,961
23554,1,1,650,1237,587
23555,1,1,814,1410,596
23556,1,0,5,0,-5
23557,1,1,45,1288,1243
23558,1,1,593,1222,629
23559,1,1,340,1364,1024
23560,1,1,158,2117,1959
23561,1,0,16,0,-16
23562,0,0,6,0,-6
23563,0,0,15,0,-15
23564,1,0,69,0,-69
23565,0,0,54,0,-54
23566,1,0,96,0,-96
23567,1,0,5,0,-5
23568,0,0,7,0,-7
23569,0,0,36,0,-36
23570,0,0,2,0,-2
23571,1,1,642,1231,589
23572,0,0,58,0,-58
23573,0,0,93,0,-93
23574,1,1,141,1234,1093
23575,0,0,158,0,-158
23576,1,1,312,1208,896
23577,1,0,248,0,-248
23578,1,0,13,0,-13
23579,0,0,34,0,-34
23580,1,0,27,0,-27
23581,1,1,186,1415,1229
23582,0,0,13,0,-13
23583,1,1,539,1200,661
23584,1,1,551,1271,720
23585,1,1,293,1288,995
23586,1,0,18,0,-18
23587,0,0,38,0,-38
23588,0,0,59,0,-59
23589,0,0,134,0,-134
23590,1,0,83,0,-83
23591,1,1,1303,1334,31
23592,1,1,667,3244,2577
23593,0,0,97,0,-97
23594,0,0,16,0,-16
23595,1,0,18,0,-18
23596,0,0,34,0,-34
23597,0,0,10,0,-10
23598,1,1,1343,2439,1096
23599,1,1,303,1289,986
23600,1,0,50,0,-50
23601,1,1,461,1407,946
23602,1,1,357,1227,870
23603,0,0,26,0,-26
23604,1,0,6,0,-6
23605,1,0,55,0,-55
23606,1,0,26,0,-26
23607,0,0,10,0,-10
23608,1,0,22,0,-22
23609,0,0,4,0,-4
23610,1,0,5,0,-5
23611,1,0,86,0,-86
23612,0,0,40,0,-40
23613,1,0,72,0,-72
23614,1,1,220,2436,2216
23615,1,1,768,1397,629
23616,1,1,14,1369,1355
23617,0,0,31,0,-31
23618,1,0,20,0,-20
23619,0,0,64,0,-64
23620,1,1,45,1419,1374
23621,0,0,59,0,-59
23622,0,0,201,0,-201
23623,1,0,106,0,-106
23624,1,1,357,1399,1042
23625,1,0,11,0,-11
23626,1,1,219,2171,1952
23627,0,0,2,0,-2
23628,0,0,6,0,-6
23629,0,0,78,0,-78
23630,1,1,311,1439,1128
23631,0,0,12,0,-12
23632,0,0,25,0,-25
23633,1,0,142,0,-142
23634,0,0,8,0,-8
23635,1,0,31,0,-31
23636,0,0,33,0,-33
23637,0,0,2,0,-2
23638,1,0,14,0,-14
23639,0,0,50,0,-50
23640,0,0,20,0,-20
23641,1,0,108,0,-108
23642,1,0,92,0,-92
23643,1,1,768,1269,501
23644,1,1,60,1244,1184
23645,0,0,2,0,-2
23646,0,0,2,0,-2
23647,0,0,6,0,-6
23648,1,0,87,0,-87
23649,1,1,355,1314,959
23650,0,0,29,0,-29
23651,1,1,1715,1417,-298
23652,1,1,1142,1517,375
23653,0,0,4,0,-4
23654,0,0,3,0,-3
23655,1,0,44,0,-44
23656,0,0,3,0,-3
23657,1,0,24,0,-24
23658,0,0,3,0,-3
23659,0,0,23,0,-23
23660,1,1,864,1612,748
23661,0,0,4,0,-4
23662,0,0,82,0,-82
23663,1,0,188,0,-188
23664,1,0,23,0,-23
23665,1,0,19,0,-19
23666,1,1,638,1267,629
23667,1,1,169,1349,1180
23668,1,1,364,1820,1456
23669,1,0,147,0,-147
23670,0,0,16,0,-16
23671,0,0,173,0,-173
23672,0,0,135,0,-135
23673,1,1,377,1688,1311
23674,0,0,19,0,-19
23675,0,0,97,0,-97
23676,1,1,461,1279,818
23677,1,0,72,0,-72
23678,1,1,243,1536,1293
23679,0,0,59,0,-59
23680,0,0,24,0,-24
23681,1,0,42,0,-42
23682,1,1,90,1752,1662
23683,1,0,94,0,-94
23684,1,1,611,1419,808
23685,1,1,2267,1923,-344
23686,1,0,118,0,-118
23687,1,0,39,0,-39
23688,1,0,38,0,-38
23689,1,1,286,1265,979
23690,0,0,8,0,-8
23691,0,0,46,0,-46
23692,1,1,267,1207,940
23693,0,0,3,0,-3
23694,1,1,313,1203,890
23695,1,1,201,1282,1081
23696,1,0,278,0,-278
23697,0,0,61,0,-61
23698,1,0,12,0,-12
23699,0,0,22,0,-22
23700,1,0,113,0,-113
23701,1,0,115,0,-115
23702,1,1,362,1236,874
23703,0,0,16,0,-16
23704,1,1,612,1566,954
23705,1,0,68,0,-68
23706,1,0,24,0,-24
23707,0,0,37,0,-37
23708,0,0,101,0,-101
23709,1,1,228,1276,1048
23710,1,0,49,0,-49
23711,0,0,24,0,-24
23712,0,0,37,0,-37
23713,0,0,22,0,-22
23714,0,0,157,0,-157
23715,0,0,46,0,-46
23716,0,0,75,0,-75
23717,1,1,1360,2351,991
23718,0,0,35,0,-35
23719,1,0,106,0,-106
23720,0,0,64,0,-64
23721,0,0,12,0,-12
23722,1,0,141,0,-141
23723,0,0,46,0,-46
23724,0,0,29,0,-29
23725,1,0,35,0,-35
23726,0,0,1,0,-1
23727,1,0,107,0,-107
23728,1,1,302,1990,1688
23729,0,0,3,0,-3
23730,0,0,187,0,-187
23731,0,0,14,0,-14
23732,1,1,195,1228,1033
23733,0,0,7,0,-7
23734,0,0,94,0,-94
23735,1,0,46,0,-46
23736,1,0,18,0,-18
23737,1,0,8,0,-8
23738,0,0,9,0,-9
23739,1,0,231,0,-231
23740,0,0,33,0,-33
23741,0,0,34,0,-34
23742,0,0,89,0,-89
23743,1,0,21,0,-21
23744,1,1,1062,1332,270
23745,1,0,16,0,-16
23746,1,0,77,0,-77
23747,1,1,647,1507,860
23748,1,0,48,0,-48
23749,1,0,7,0,-7
23750,1,1,42,1303,1261
23751,1,0,26,0,-26
23752,1,1,524,1360,836
23753,1,1,1074,1204,130
23754,1,0,58,0,-58
23755,1,1,676,1357,681
23756,1,1,823,2197,1374
23757,1,0,2,0,-2
23758,1,0,26,0,-26
23759,1,0,18,0,-18
23760,1,1,221,1974,1753
23761,0,0,190,0,-190
23762,1,0,47,0,-47
23763,0,0,28,0,-28
23764,0,0,32,0,-32
23765,0,0,142,0,-142
23766,1,1,481,1718,1237
23767,1,1,68,1278,1210
23768,1,0,1,0,-1
23769,1,0,31,0,-31
23770,1,0,26,0,-26
23771,0,0,20,0,-20
23772,1,1,773,1303,530
23773,1,1,239,1414,1175
23774,0,0,13,0,-13
23775,0,0,84,0,-84
23776,1,1,170,1900,1730
23777,0,0,58,0,-58
23778,0,0,58,0,-58
23779,1,1,678,1239,561
23780,1,0,37,0,-37
23781,1,0,94,0,-94
23782,1,0,4,0,-4
23783,1,1,410,1970,1560
23784,0,0,28,0,-28
23785,1,0,58,0,-58
23786,0,0,4,0,-4
23787,0,0,28,0,-28
23788,1,0,56,0,-56
23789,0,0,4,0,-4
23790,0,0,33,0,-33
23791,0,0,77,0,-77
23792,0,0,9,0,-9
23793,0,0,34,0,-34
23794,0,0,210,0,-210
23795,1,1,196,2324,2128
23796,0,0,94,0,-94
23797,0,0,2,0,-2
23798,0,0,19,0,-19
23799,0,0,59,0,-59
23800,0,0,20,0,-20
23801,1,0,9,0,-9
23802,1,0,98,0,-98
23803,0,0,72,0,-72
23804,0,0,4,0,-4
23805,0,0,34,0,-34
23806,0,0,9,0,-9
23807,1,0,30,0,-30
23808,0,0,113,0,-113
23809,0,0,27,0,-27
23810,0,0,15,0,-15
23811,0,0,3,0,-3
23812,1,1,253,1435,1182
23813,0,0,47,0,-47
23814,1,1,98,1457,1359
23815,0,0,15,0,-15
23816,1,0,30,0,-30
23817,1,0,69,0,-69
23818,1,0,21,0,-21
23819,1,0,18,0,-18
23820,1,0,51,0,-51
23821,0,0,68,0,-68
23822,1,1,1758,1611,-147
23823,1,0,22,0,-22
23824,1,0,42,0,-42
23825,1,1,44,1316,1272
23826,0,0,48,0,-48
23827,0,0,24,0,-24
23828,0,0,2,0,-2
23829,0,0,136,0,-136
23830,0,0,34,0,-34
23831,0,0,0,0,0
23832,1,1,124,1275,1151
23833,0,0,14,0,-14
23834,1,1,633,1230,597
23835,1,0,190,0,-190
23836,0,0,163,0,-163
23837,0,0,11,0,-11
23838,0,0,34,0,-34
23839,0,0,23,0,-23
23840,1,0,165,0,-165
23841,1,1,240,1498,1258
23842,1,0,130,0,-130
23843,1,1,1079,1258,179
23844,0,0,23,0,-23
23845,0,0,37,0,-37
23846,1,0,25,0,-25
23847,0,0,151,0,-151
23848,1,1,116,1758,1642
23849,0,0,23,0,-23
23850,0,0,93,0,-93
23851,1,1,175,1667,1492
23852,1,1,72,1766,1694
23853,0,0,77,0,-77
23854,0,0,4,0,-4
23855,1,0,70,0,-70
23856,1,0,83,0,-83
23857,0,0,2,0,-2
23858,1,1,110,1263,1153
23859,0,0,22,0,-22
23860,1,1,522,1307,785
23861,1,1,477,1273,796
23862,1,0,4,0,-4
23863,1,1,136,1339,1203
23864,0,0,26,0,-26
23865,1,1,254,1308,1054
23866,1,0,135,0,-135
23867,0,0,22,0,-22
23868,0,0,89,0,-89
23869,1,1,146,1332,1186
23870,0,0,32,0,-32
23871,0,0,69,0,-69
23872,1,0,46,0,-46
23873,1,1,495,1449,954
23874,1,0,35,0,-35
23875,1,1,926,1458,532
23876,1,1,688,1410,722
23877,0,0,12,0,-12
23878,0,0,93,0,-93
23879,0,0,79,0,-79
23880,0,0,13,0,-13
23881,0,0,7,0,-7
23882,0,0,8,0,-8
23883,1,1,525,3225,2700
23884,0,0,101,0,-101
23885,1,1,641,1451,810
23886,1,0,2,0,-2
23887,1,1,1097,1273,176
23888,1,0,0,0,0
23889,1,1,663,1225,562
23890,1,0,25,0,-25
23891,0,0,10,0,-10
23892,0,0,11,0,-11
23893,0,0,88,0,-88
23894,1,1,697,1215,518
23895,1,0,10,0,-10
23896,1,0,46,0,-46
23897,1,0,46,0,-46
23898,1,0,11,0,-11
23899,1,0,105,0,-105
23900,0,0,56,0,-56
23901,0,0,4,0,-4
23902,1,1,17,1705,1688
23903,0,0,61,0,-61
23904,1,1,420,2241,1821
23905,1,0,39,0,-39
23906,1,1,88,1221,1133
23907,1,1,47,1784,1737
23908,1,1,859,1273,414
23909,0,0,13,0,-13
23910,0,0,47,0,-47
23911,1,1,446,1220,774
23912,0,0,75,0,-75
23913,0,0,36,0,-36
23914,0,0,89,0,-89
23915,0,0,86,0,-86
23916,1,1,425,1277,852
23917,1,0,135,0,-135
23918,0,0,1,0,-1
23919,1,0,25,0,-25
23920,1,1,271,1379,1108
23921,1,0,11,0,-11
23922,1,0,46,0,-46
23923,1,0,50,0,-50
23924,0,0,81,0,-81
23925,1,1,1201,3152,1951
23926,1,1,214,1350,1136
23927,0,0,113,0,-113
23928,0,0,85,0,-85
23929,1,0,46,0,-46
23930,1,1,41,1434,1393
23931,0,0,28,0,-28
23932,0,0,150,0,-150
23933,1,0,30,0,-30
23934,0,0,108,0,-108
23935,0,0,22,0,-22
23936,1,0,69,0,-69
23937,1,1,903,1270,367
23938,1,0,68,0,-68
23939,1,1,1183,1787,604
23940,1,0,4,0,-4
23941,0,0,17,0,-17
23942,0,0,69,0,-69
23943,0,0,31,0,-31
23944,1,1,227,1442,1215
23945,1,1,530,1383,853
23946,1,1,545,1379,834
23947,0,0,13,0,-13
23948,0,0,73,0,-73
23949,0,0,102,0,-102
23950,1,1,321,1354,1033
23951,1,0,40,0,-40
23952,1,1,600,1476,876
23953,0,0,29,0,-29
23954,0,0,23,0,-23
23955,1,1,320,4503,4183
23956,0,0,35,0,-35
23957,1,1,755,1490,735
23958,0,0,33,0,-33
23959,1,0,39,0,-39
23960,1,0,1,0,-1
23961,1,1,904,1477,573
23962,1,1,580,1301,721
23963,1,1,287,1448,1161
23964,1,1,189,1347,1158
23965,1,0,27,0,-27
23966,1,0,75,0,-75
23967,1,0,53,0,-53
23968,1,1,1116,1299,183
23969,0,0,4,0,-4
23970,0,0,98,0,-98
23971,0,0,79,0,-79
23972,1,0,19,0,-19
23973,0,0,27,0,-27
23974,0,0,24,0,-24
23975,1,1,668,1369,701
23976,0,0,129,0,-129
23977,0,0,81,0,-81
23978,1,0,122,0,-122
23979,1,1,646,2989,2343
23980,0,0,52,0,-52
23981,1,0,17,0,-17
23982,1,1,796,1252,456
23983,1,0,12,0,-12
23984,1,1,690,1827,1137
23985,1,1,1068,1364,296
23986,1,1,736,1490,754
23987,1,0,189,0,-189
23988,0,0,64,0,-64
23989,0,0,11,0,-11
23990,1,1,593,1698,1105
23991,1,0,25,0,-25
23992,1,1,470,1497,1027
23993,1,0,24,0,-24
23994,0,0,64,0,-64
23995,1,0,82,0,-82
23996,1,1,496,1233,737
23997,1,1,57,2008,1951
23998,0,0,54,0,-54
23999,0,0,30,0,-30
24000,0,0,142,0,-142
24001,1,0,30,0,-30
24002,1,1,181,2692,2511
24003,0,0,48,0,-48
24004,1,0,21,0,-21
24005,0,0,67,0,-67
24006,0,0,54,0,-54
24007,1,0,25,0,-25
24008,0,0,29,0,-29
24009,0,0,15,0,-15
24010,0,0,15,0,-15
24011,0,0,54,0,-54
24012,0,0,34,0,-34
24013,0,0,29,0,-29
24014,1,0,32,0,-32
24015,1,0,13,0,-13
24016,1,1,276,1202,926
24017,1,0,138,0,-138
24018,1,0,13,0,-13
24019,1,0,2,0,-2
24020,0,0,34,0,-34
24021,0,0,32,0,-32
24022,1,1,171,1435,1264
24023,0,0,30,0,-30
24024,1,1,424,1288,864
24025,1,1,988,1302,314
24026,1,0,116,0,-116
24027,1,1,1193,1302,109
24028,0,0,91,0,-91
24029,0,0,18,0,-18
24030,0,0,15,0,-15
24031,1,1,469,1870,1401
24032,0,0,58,0,-58
24033,0,0,7,0,-7
24034,0,0,105,0,-105
24035,0,0,86,0,-86
24036,1,1,1573,1320,-253
24037,0,0,61,0,-61
24038,1,1,930,1356,426
24039,1,0,5,0,-5
24040,1,1,207,1581,1374
24041,1,0,35,0,-35
24042,1,0,7,0,-7
24043,1,0,5,0,-5
24044,0,0,3,0,-3
24045,0,0,73,0,-73
24046,1,1,211,1242,1031
24047,0,0,83,0,-83
24048,1,0,14,0,-14
24049,0,0,1,0,-1
24050,0,0,73,0,-73
24051,1,1,316,1405,1089
24052,0,0,11,0,-11
24053,1,0,192,0,-192
24054,1,0,168,0,-168
24055,1,0,152,0,-152
24056,1,1,242,1974,1732
24057,0,0,22,0,-22
24058,1,0,84,0,-84
24059,1,0,10,0,-10
24060,1,0,30,0,-30
24061,1,1,182,1483,1301
24062,0,0,76,0,-76
24063,1,0,49,0,-49
24064,0,0,58,0,-58
24065,0,0,117,0,-117
24066,1,0,71,0,-71
24067,1,0,10,0,-10
24068,1,1,520,1505,985
24069,1,0,18,0,-18
24070,1,0,116,0,-116
24071,0,0,10,0,-10
24072,1,0,8,0,-8
24073,0,0,15,0,-15
24074,1,0,128,0,-128
24075,1,0,55,0,-55
24076,1,0,43,0,-43
24077,1,1,521,2002,1481
24078,0,0,24,0,-24
24079,1,0,24,0,-24
24080,1,0,45,0,-45
24081,1,1,193,1599,1406
24082,1,0,13,0,-13
24083,1,1,767,1459,692
24084,1,1,127,1252,1125
24085,0,0,33,0,-33
24086,0,0,112,0,-112
24087,0,0,58,0,-58
24088,1,0,66,0,-66
24089,1,0,42,0,-42
24090,1,1,447,1281,834
24091,1,0,3,0,-3
24092,1,0,85,0,-85
24093,1,0,32,0,-32
24094,1,0,31,0,-31
24095,1,1,619,1391,772
24096,0,0,36,0,-36
24097,1,0,23,0,-23
24098,1,0,44,0,-44
24099,0,0,154,0,-154
24100,1,0,3,0,-3
24101,1,0,16,0,-16
24102,0,0,180,0,-180
24103,1,1,323,4176,3853
24104,1,0,1,0,-1
24105,1,1,1002,2454,1452
24106,1,1,1819,1391,-428
24107,1,1,43,1358,1315
24108,1,0,15,0,-15
24109,1,0,98,0,-98
24110,1,1,305,1239,934
24111,1,0,2,0,-2
24112,1,1,183,2201,2018
24113,1,1,679,1848,1169
24114,0,0,15,0,-15
24115,0,0,55,0,-55
24116,0,0,3,0,-3
24117,1,0,30,0,-30
24118,0,0,19,0,-19
24119,0,0,5,0,-5
24120,0,0,17,0,-17
24121,1,0,10,0,-10
24122,1,0,0,0,0
24123,1,1,461,1579,1118
24124,1,1,46,1203,1157
24125,1,1,313,1565,1252
24126,0,0,35,0,-35
24127,1,1,257,1523,1266
24128,1,1,366,1330,964
24129,1,1,1213,1286,73
24130,1,0,3,0,-3
24131,0,0,13,0,-13
24132,1,1,341,1870,1529
24133,0,0,52,0,-52
24134,0,0,13,0,-13
24135,0,0,58,0,-58
24136,1,1,1872,1335,-537
24137,1,1,488,1676,1188
24138,1,0,218,0,-218
24139,1,0,21,0,-21
24140,0,0,93,0,-93
24141,1,0,148,0,-148
24142,0,0,4,0,-4
24143,1,0,36,0,-36
24144,0,0,72,0,-72
24145,0,0,91,0,-91
24146,0,0,61,0,-61
24147,0,0,8,0,-8
24148,1,0,15,0,-15
24149,0,0,31,0,-31
24150,0,0,75,0,-75
24151,0,0,64,0,-64
24152,1,1,442,1246,804
24153,0,0,19,0,-19
24154,1,0,63,0,-63
24155,0,0,18,0,-18
24156,1,1,211,1211,1000
24157,0,0,36,0,-36
24158,1,0,47,0,-47
24159,1,1,1119,1325,206
24160,1,1,68,1902,1834
24161,0,0,43,0,-43
24162,1,0,38,0,-38
24163,1,1,191,1898,1707
24164,0,0,63,0,-63
24165,0,0,63,0,-63
24166,1,0,50,0,-50
24167,1,1,751,1556,805
24168,1,1,1212,1313,101
24169,0,0,14,0,-14
24170,1,1,624,1477,853
24171,1,1,145,1569,1424
24172,1,0,21,0,-21
24173,0,0,30,0,-30
24174,0,0,4,0,-4
24175,1,1,43,1253,1210
24176,1,0,28,0,-28
24177,1,0,29,0,-29
24178,1,0,215,0,-215
24179,1,1,160,1220,1060
24180,0,0,6,0,-6
24181,0,0,100,0,-100
24182,0,0,30,0,-30
24183,1,0,134,0,-134
24184,0,0,94,0,-94
24185,0,0,10,0,-10
24186,1,0,25,0,-25
24187,1,0,9,0,-9
24188,1,0,20,0,-20
24189,0,0,24,0,-24
24190,1,0,116,0,-116
24191,0,0,20,0,-20
24192,1,1,1091,1276,185
24193,1,1,114,1692,1578
24194,1,1,313,1621,1308
24195,1,1,56,1316,1260
24196,0,0,91,0,-91
24197,1,1,584,1421,837
24198,0,0,0,0,0
24199,0,0,131,0,-131
24200,1,0,2,0,-2
24201,1,0,32,0,-32
24202,0,0,6,0,-6
24203,0,0,45,0,-45
24204,0,0,25,0,-25
24205,0,0,3,0,-3
24206,0,0,10,0,-10
24207,0,0,71,0,-71
24208,1,0,66,0,-66
24209,0,0,7,0,-7
24210,1,0,22,0,-22
24211,0,0,87,0,-87
24212,1,0,115,0,-115
24213,1,1,475,1422,947
24214,1,1,349,2293,1944
24215,1,0,9,0,-9
24216,1,1,849,1946,1097
24217,0,0,4,0,-4
24218,0,0,16,0,-16
24219,1,0,35,0,-35
24220,1,0,61,0,-61
24221,1,0,47,0,-47
24222,0,0,21,0,-21
24223,1,0,11,0,-11
24224,1,1,153,1547,1394
24225,1,0,5,0,-5
24226,0,0,219,0,-219
24227,0,0,0,0,0
24228,1,0,124,0,-124
24229,1,0,134,0,-134
24230,1,0,149,0,-149
24231,1,1,355,1589,1234
24232,1,0,50,0,-50
24233,0,0,22,0,-22
24234,1,0,38,0,-38
24235,0,0,6,0,-6
24236,0,0,89,0,-89
24237,0,0,122,0,-122
24238,0,0,4,0,-4
24239,1,0,80,0,-80
24240,1,0,28,0,-28
24241,0,0,28,0,-28
24242,0,0,7,0,-7
24243,0,0,0,0,0
24244,1,1,206,1500,1294
24245,1,1,498,1990,1492
24246,0,0,110,0,-110
24247,0,0,30,0,-30
24248,0,0,50,0,-50
24249,1,0,31,0,-31
24250,1,0,0,0,0
24251,0,0,18,0,-18
24252,1,0,2,0,-2
24253,1,1,909,1203,294
24254,1,1,197,1337,1140
24255,1,0,19,0,-19
24256,0,0,107,0,-107
24257,1,0,6,0,-6
24258,1,1,343,1660,1317
24259,0,0,19,0,-19
24260,1,1,31,1443,1412
24261,1,0,51,0,-51
24262,1,0,16,0,-16
24263,0,0,4,0,-4
24264,0,0,6,0,-6
24265,0,0,18,0,-18
24266,1,1,255,1318,1063
24267,1,0,149,0,-149
24268,1,0,85,0,-85
24269,1,1,131,1330,1199
24270,1,0,7,0,-7
24271,1,0,77,0,-77
24272,0,0,52,0,-52
24273,0,0,184,0,-184
24274,0,0,38,0,-38
24275,0,0,26,0,-26
24276,0,0,73,0,-73
24277,1,0,74,0,-74
24278,0,0,35,0,-35
24279,1,0,36,0,-36
24280,1,0,12,0,-12
24281,1,1,533,1343,810
24282,1,1,314,2767,2453
24283,1,0,16,0,-16
24284,1,0,13,0,-13
24285,1,0,2,0,-2
24286,1,1,358,1230,872
24287,1,1,314,1808,1494
24288,0,0,44,0,-44
24289,1,1,1047,1229,182
24290,0,0,69,0,-69
24291,1,0,7,0,-7
24292,1,0,40,0,-40
24293,1,1,95,1210,1115
24294,1,0,14,0,-14
24295,1,1,296,1419,1123
24296,1,0,13,0,-13
24297,0,0,37,0,-37
24298,1,0,161,0,-161
24299,1,1,795,1437,642
24300,1,1,930,1220,290
24301,1,0,47,0,-47
24302,1,1,224,1502,1278
24303,1,1,1262,5311,4049
24304,0,0,28,0,-28
24305,1,0,18,0,-18
24306,1,1,378,1508,1130
24307,1,0,21,0,-21
24308,1,0,89,0,-89
24309,1,0,2,0,-2
24310,0,0,49,0,-49
24311,0,0,50,0,-50
24312,1,1,328,3010,2682
24313,1,1,256,2323,2067
24314,0,0,72,0,-72
24315,1,1,141,1584,1443
24316,1,0,46,0,-46
24317,0,0,46,0,-46
24318,1,1,598,1350,752
24319,0,0,12,0,-12
24320,0,0,81,0,-81
24321,0,0,15,0,-15
24322,1,0,32,0,-32
24323,1,1,1412,1387,-25
24324,1,0,5,0,-5
24325,1,1,594,1317,723
24326,1,1,693,1599,906
24327,1,1,344,1425,1081
24328,1,0,85,0,-85
24329,1,0,18,0,-18
24330,0,0,16,0,-16
24331,1,1,644,1383,739
24332,1,1,944,1420,476
24333,0,0,35,0,-35
24334,0,0,4,0,-4
24335,1,0,13,0,-13
24336,1,0,167,0,-167
24337,1,1,1139,1593,454
24338,0,0,42,0,-42
24339,1,1,1796,5683,3887
24340,1,0,14,0,-14
24341,1,1,370,1784,1414
24342,0,0,27,0,-27
24343,1,1,283,1367,1084
24344,0,0,54,0,-54
24345,1,1,144,1235,1091
24346,1,1,945,1897,952
24347,0,0,54,0,-54
24348,1,0,181,0,-181
24349,0,0,34,0,-34
24350,0,0,84,0,-84
24351,0,0,47,0,-47
24352,1,1,256,1337,1081
24353,1,0,4,0,-4
24354,1,0,196,0,-196
24355,0,0,57,0,-57
24356,0,0,93,0,-93
24357,1,1,184,1212,1028
24358,1,0,23,0,-23
24359,1,0,4,0,-4
24360,1,0,2,0,-2
24361,0,0,37,0,-37
24362,1,1,223,1551,1328
24363,1,0,13,0,-13
24364,1,0,41,0,-41
24365,0,0,28,0,-28
24366,1,1,294,1259,965
24367,0,0,25,0,-25
24368,0,0,36,0,-36
24369,1,1,1409,1348,-61
24370,1,0,50,0,-50
24371,0,0,5,0,-5
24372,1,1,112,1318,1206
24373,1,1,466,1396,930
24374,0,0,98,0,-98
24375,1,0,3,0,-3
24376,1,0,76,0,-76
24377,1,1,456,1493,1037
24378,1,0,81,0,-81
24379,0,0,122,0,-122
24380,1,1,81,1231,1150
24381,0,0,19,0,-19
24382,1,0,65,0,-65
24383,0,0,117,0,-117
24384,1,1,976,1257,281
24385,0,0,34,0,-34
24386,1,1,239,1202,963
24387,1,0,3,0,-3
24388,1,1,292,1731,1439
24389,0,0,10,0,-10
24390,1,1,1136,1297,161
24391,0,0,154,0,-154
24392,1,0,36,0,-36
24393,0,0,184,0,-184
24394,0,0,116,0,-116
24395,1,0,92,0,-92
24396,1,0,22,0,-22
24397,0,0,9,0,-9
24398,1,1,149,1212,1063
24399,1,1,609,1282,673
24400,1,0,1,0,-1
24401,1,1,840,1366,526
24402,0,0,125,0,-125
24403,1,0,76,0,-76
24404,0,0,26,0,-26
24405,1,1,537,1817,1280
24406,0,0,49,0,-49
24407,1,0,1,0,-1
24408,0,0,12,0,-12
24409,1,0,10,0,-10
24410,0,0,24,0,-24
24411,0,0,10,0,-10
24412,0,0,140,0,-140
24413,0,0,24,0,-24
24414,1,0,30,0,-30
24415,1,1,96,1617,1521
24416,1,0,19,0,-19
24417,1,0,55,0,-55
24418,1,1,534,1271,737
24419,1,1,278,1244,966
24420,1,0,125,0,-125
24421,1,1,328,2111,1783
24422,0,0,29,0,-29
24423,0,0,13,0,-13
24424,0,0,17,0,-17
24425,0,0,142,0,-142
24426,1,1,661,1453,792
24427,1,0,65,0,-65
24428,0,0,2,0,-2
24429,1,0,8,0,-8
24430,1,0,61,0,-61
24431,1,0,7,0,-7
24432,1,0,85,0,-85
24433,1,0,6,0,-6
24434,1,0,9,0,-9
24435,1,1,851,1796,945
24436,1,0,14,0,-14
24437,1,1,434,2003,1569
24438,1,0,22,0,-22
24439,0,0,48,0,-48
24440,0,0,16,0,-16
24441,1,1,226,1729,1503
24442,1,1,392,2400,2008
24443,0,0,7,0,-7
24444,0,0,14,0,-14
24445,0,0,24,0,-24
24446,0,0,64,0,-64
24447,1,0,10,0,-10
24448,0,0,47,0,-47
24449,0,0,126,0,-126
24450,0,0,92,0,-92
24451,0,0,29,0,-29
24452,0,0,124,0,-124
24453,1,0,106,0,-106
24454,1,1,448,1263,815
24455,0,0,2,0,-2
24456,1,0,7,0,-7
24457,1,1,43,2906,2863
24458,1,1,84,2177,2093
24459,1,1,131,1377,1246
24460,1,0,90,0,-90
24461,1,0,0,0,0
24462,1,0,165,0,-165
24463,1,0,39,0,-39
24464,0,0,7,0,-7
24465,1,1,613,1702,1089
24466,0,0,50,0,-50
24467,1,0,12,0,-12
24468,1,0,24,0,-24
24469,0,0,8,0,-8
24470,1,1,374,1275,901
24471,1,0,112,0,-112
24472,1,1,200,1551,1351
24473,0,0,26,0,-26
24474,0,0,51,0,-51
24475,0,0,7,0,-7
24476,1,1,742,1204,462
24477,0,0,140,0,-140
24478,0,0,44,0,-44
24479,0,0,4,0,-4
24480,1,0,15,0,-15
24481,0,0,97,0,-97
24482,0,0,58,0,-58
24483,0,0,161,0,-161
24484,0,0,49,0,-49
24485,1,0,126,0,-126
24486,0,0,30,0,-30
24487,1,1,994,1259,265
24488,1,0,27,0,-27
24489,1,1,274,1765,1491
24490,1,0,156,0,-156
24491,1,1,757,1335,578
24492,0,0,40,0,-40
24493,1,1,102,1316,1214
24494,0,0,20,0,-20
24495,1,1,541,1336,795
24496,1,0,33,0,-33
24497,1,1,213,1295,1082
24498,0,0,3,0,-3
24499,1,0,59,0,-59
24500,0,0,7,0,-7
24501,1,1,234,1457,1223
24502,1,1,807,1415,608
24503,1,1,508,1446,938
24504,1,0,25,0,-25
24505,1,1,222,1704,1482
24506,0,0,97,0,-97
24507,0,0,39,0,-39
24508,0,0,129,0,-129
24509,0,0,54,0,-54
24510,0,0,15,0,-15
24511,0,0,105,0,-105
24512,1,1,607,1579,972
24513,1,1,680,1452,772
24514,1,0,294,0,-294
24515,1,0,21,0,-21
24516,0,0,34,0,-34
24517,1,0,14,0,-14
24518,1,1,735,2001,1266
24519,1,0,66,0,-66
24520,0,0,22,0,-22
24521,0,0,105,0,-105
24522,0,0,52,0,-52
24523,0,0,0,0,0
24524,1,1,491,1420,929
24525,1,1,324,2118,1794
24526,1,1,630,1269,639
24527,0,0,92,0,-92
24528,1,1,146,2342,2196
24529,0,0,57,0,-57
24530,1,0,49,0,-49
24531,1,1,535,1339,804
24532,0,0,90,0,-90
24533,0,0,2,0,-2
24534,0,0,13,0,-13
24535,1,1,241,1566,1325
24536,0,0,7,0,-7
24537,0,0,254,0,-254
24538,0,0,97,0,-97
24539,1,0,12,0,-12
24540,0,0,63,0,-63
24541,1,0,11,0,-11
24542,0,0,44,0,-44
24543,1,1,157,4016,3859
24544,0,0,43,0,-43
24545,1,1,866,1332,466
24546,0,0,104,0,-104
24547,1,1,224,2741,2517
24548,1,1,74,1307,1233
24549,1,0,111,0,-111
24550,1,1,141,1541,1400
24551,1,1,59,7630,7571
24552,0,0,85,0,-85
24553,0,0,101,0,-101
24554,0,0,0,0,0
24555,1,0,4,0,-4
24556,1,1,159,1302,1143
24557,0,0,62,0,-62
24558,1,1,78,1363,1285
24559,0,0,6,0,-6
24560,0,0,36,0,-36
24561,0,0,58,0,-58
24562,1,1,539,1671,1132
24563,0,0,104,0,-104
24564,1,1,355,1674,1319
24565,1,1,1157,1327,170
24566,1,0,13,0,-13
24567,1,1,268,1273,1005
24568,1,1,1055,1860,805
24569,0,0,9,0,-9
24570,0,0,50,0,-50
24571,1,1,99,1283,1184
24572,0,0,7,0,-7
24573,1,1,171,1780,1609
24574,1,1,225,1652,1427
24575,1,1,526,1429,903
24576,0,0,35,0,-35
24577,1,1,1430,1655,225
24578,1,1,411,1327,916
24579,1,0,32,0,-32
24580,1,0,85,0,-85
24581,1,1,87,2518,2431
24582,1,0,3,0,-3
24583,1,0,24,0,-24
24584,1,0,5,0,-5
24585,1,1,78,2251,2173
24586,0,0,10,0,-10
24587,0,0,71,0,-71
24588,1,0,16,0,-16
24589,1,0,98,0,-98
24590,0,0,30,0,-30
24591,1,0,30,0,-30
24592,1,1,238,1585,1347
24593,0,0,18,0,-18
24594,1,0,11,0,-11
24595,0,0,86,0,-86
24596,1,1,396,1201,805
24597,1,0,52,0,-52
24598,0,0,78,0,-78
24599,1,1,993,1206,213
24600,1,0,22,0,-22
24601,0,0,54,0,-54
24602,0,0,3,0,-3
24603,0,0,38,0,-38
24604,0,0,141,0,-141
24605,1,1,45,1460,1415
24606,0,0,53,0,-53
24607,0,0,18,0,-18
24608,1,0,2,0,-2
24609,0,0,32,0,-32
24610,1,0,11,0,-11
24611,1,1,60,1457,1397
24612,1,0,14,0,-14
24613,0,0,78,0,-78
24614,1,0,51,0,-51
24615,0,0,14,0,-14
24616,1,0,37,0,-37
24617,0,0,2,0,-2
24618,1,1,90,1452,1362
24619,0,0,13,0,-13
24620,0,0,79,0,-79
24621,1,0,121,0,-121
24622,1,1,521,1214,693
24623,1,1,738,1239,501
24624,1,1,169,1207,1038
24625,0,0,10,0,-10
24626,1,1,1801,1383,-418
24627,0,0,63,0,-63
24628,1,1,538,1314,776
24629,1,1,254,1302,1048
24630,1,1,769,1385,616
24631,1,0,5,0,-5
24632,1,1,167,1464,1297
24633,1,0,38,0,-38
24634,0,0,5,0,-5
24635,1,0,14,0,-14
24636,1,1,451,1311,860
24637,0,0,119,0,-119
24638,0,0,14,0,-14
24639,0,0,5,0,-5
24640,1,1,34,1737,1703
24641,1,1,776,1268,492
24642,1,0,15,0,-15
24643,1,1,1927,1613,-314
24644,0,0,23,0,-23
24645,0,0,7,0,-7
24646,1,0,24,0,-24
24647,0,0,117,0,-117
24648,0,0,26,0,-26
24649,1,1,104,1285,1181
24650,0,0,27,0,-27
24651,0,0,101,0,-101
24652,1,1,1254,1250,-4
24653,1,0,16,0,-16
24654,1,1,604,1707,1103
24655,0,0,7,0,-7
24656,1,0,23,0,-23
24657,0,0,31,0,-31
24658,1,1,56,2246,2190
24659,1,1,841,1213,372
24660,1,1,769,1449,680
24661,0,0,14,0,-14
24662,1,1,928,1905,977
24663,1,0,17,0,-17
24664,1,1,470,1749,1279
24665,1,1,958,1601,643
24666,1,1,1171,2728,1557
24667,0,0,90,0,-90
24668,1,1,475,1234,759
24669,0,0,58,0,-58
24670,1,0,270,0,-270
24671,1,0,211,0,-211
24672,0,0,28,0,-28
24673,1,0,48,0,-48
24674,0,0,11,0,-11
24675,0,0,72,0,-72
24676,0,0,52,0,-52
24677,1,0,13,0,-13
24678,0,0,209,0,-209
24679,1,1,78,1444,1366
24680,0,0,63,0,-63
24681,1,0,55,0,-55
24682,1,1,612,1419,807
24683,0,0,2,0,-2
24684,1,1,321,1661,1340
24685,1,1,467,1289,822
24686,1,1,1688,1356,-332
24687,1,0,73,0,-73
24688,1,1,52,1276,1224
24689,1,0,78,0,-78
24690,1,1,1097,1275,178
24691,0,0,4,0,-4
24692,1,1,1124,1201,77
24693,1,1,771,1374,603
24694,0,0,171,0,-171
24695,1,1,1113,1958,845
24696,0,0,43,0,-43
24697,1,1,139,1253,1114
24698,1,1,229,1222,993
24699,1,1,605,1526,921
24700,1,0,86,0,-86
24701,0,0,15,0,-15
24702,1,0,13,0,-13
24703,0,0,62,0,-62
24704,1,0,2,0,-2
24705,1,1,248,1420,1172
24706,1,1,392,1279,887
24707,0,0,59,0,-59
24708,0,0,59,0,-59
24709,1,0,3,0,-3
24710,0,0,70,0,-70
24711,0,0,73,0,-73
24712,1,0,4,0,-4
24713,1,0,97,0,-97
24714,0,0,12,0,-12
24715,1,0,37,0,-37
24716,0,0,52,0,-52
24717,0,0,59,0,-59
24718,1,1,42,2708,2666
24719,1,0,42,0,-42
24720,0,0,25,0,-25
24721,1,0,37,0,-37
24722,0,0,99,0,-99
24723,1,1,7,1420,1413
24724,1,1,750,1480,730
24725,1,0,35,0,-35
24726,1,1,441,1349,908
24727,1,0,20,0,-20
24728,1,1,320,1361,1041
24729,0,0,25,0,-25
24730,0,0,40,0,-40
24731,1,1,719,1352,633
24732,0,0,46,0,-46
24733,1,0,135,0,-135
24734,0,0,39,0,-39
24735,1,1,385,1970,1585
24736,1,0,72,0,-72
24737,1,0,23,0,-23
24738,0,0,14,0,-14
24739,0,0,7,0,-7
24740,0,0,4,0,-4
24741,1,0,174,0,-174
24742,1,1,772,1710,938
24743,1,1,827,1295,468
24744,0,0,26,0,-26
24745,0,0,145,0,-145
24746,1,1,61,2002,1941
24747,1,0,6,0,-6
24748,0,0,35,0,-35
24749,1,1,112,1288,1176
24750,0,0,0,0,0
24751,0,0,57,0,-57
24752,1,0,12,0,-12
24753,1,1,218,1254,1036
24754,0,0,57,0,-57
24755,1,0,66,0,-66
24756,1,0,1,0,-1
24757,1,1,258,1545,1287
24758,1,0,9,0,-9
24759,1,0,22,0,-22
24760,0,0,61,0,-61
24761,0,0,4,0,-4
24762,1,0,58,0,-58
24763,1,1,346,1583,1237
24764,1,0,20,0,-20
24765,0,0,12,0,-12
24766,1,0,25,0,-25
24767,1,1,176,1652,1476
24768,1,0,3,0,-3
24769,0,0,13,0,-13
24770,1,0,36,0,-36
24771,0,0,16,0,-16
24772,1,1,218,3305,3087
24773,0,0,5,0,-5
24774,1,1,373,1259,886
24775,1,0,1,0,-1
24776,1,1,167,1394,1227
24777,0,0,45,0,-45
24778,1,1,907,1304,397
24779,1,0,98,0,-98
24780,1,1,16,2147,2131
24781,1,0,26,0,-26
24782,1,0,76,0,-76
24783,0,0,1,0,-1
24784,1,0,60,0,-60
24785,1,1,712,1326,614
24786,1,0,21,0,-21
24787,0,0,2,0,-2
24788,1,1,45,1405,1360
24789,0,0,57,0,-57
24790,0,0,91,0,-91
24791,1,1,70,1362,1292
24792,0,0,29,0,-29
24793,1,0,42,0,-42
24794,1,0,19,0,-19
24795,0,0,41,0,-41
24796,0,0,9,0,-9
24797,0,0,98,0,-98
24798,0,0,13,0,-13
24799,1,1,543,1349,806
24800,1,0,42,0,-42
24801,0,0,40,0,-40
24802,1,1,845,1269,424
24803,1,1,47,1207,1160
24804,0,0,71,0,-71
24805,0,0,71,0,-71
24806,0,0,8,0,-8
24807,1,0,72,0,-72
24808,0,0,20,0,-20
24809,1,1,563,1905,1342
24810,0,0,23,0,-23
24811,0,0,37,0,-37
24812,1,1,265,1725,1460
24813,0,0,6,0,-6
24814,1,1,292,1563,1271
24815,1,1,62,1597,1535
24816,1,0,13,0,-13
24817,1,1,1914,1595,-319
24818,1,0,17,0,-17
24819,0,0,8,0,-8
24820,1,1,269,1467,1198
24821,0,0,54,0,-54
24822,0,0,10,0,-10
24823,0,0,44,0,-44
24824,1,1,244,1393,1149
24825,1,0,17,0,-17
24826,1,0,21,0,-21
24827,0,0,69,0,-69
24828,0,0,18,0,-18
24829,1,0,12,0,-12
24830,0,0,82,0,-82
24831,0,0,11,0,-11
24832,1,0,6,0,-6
24833,0,0,176,0,-176
24834,1,0,26,0,-26
24835,0,0,59,0,-59
24836,1,0,54,0,-54
24837,1,1,705,1788,1083
24838,1,1,299,1801,1502
24839,1,0,7,0,-7
24840,1,0,7,0,-7
24841,1,0,16,0,-16
24842,0,0,68,0,-68
24843,1,1,76,1762,1686
24844,0,0,5,0,-5
24845,1,0,40,0,-40
24846,1,0,23,0,-23
24847,0,0,85,0,-85
24848,1,0,3,0,-3
24849,1,0,37,0,-37
24850,0,0,26,0,-26
24851,1,1,553,1372,819
24852,0,0,54,0,-54
24853,1,1,880,1261,381
24854,0,0,50,0,-50
24855,0,0,37,0,-37
24856,0,0,0,0,0
24857,0,0,45,0,-45
24858,1,1,183,1265,1082
24859,1,1,1763,2092,329
24860,1,0,87,0,-87
24861,1,0,31,0,-31
24862,0,0,49,0,-49
24863,0,0,121,0,-121
24864,1,0,101,0,-101
24865,1,1,481,1304,823
24866,1,1,1220,1296,76
24867,0,0,5,0,-5
24868,0,0,1,0,-1
24869,0,0,57,0,-57
24870,1,1,388,2794,2406
24871,0,0,23,0,-23
24872,0,0,77,0,-77
24873,1,1,513,1301,788
24874,0,0,88,0,-88
24875,1,1,423,1330,907
24876,1,1,2346,1283,-1063
24877,0,0,34,0,-34
24878,1,0,2,0,-2
24879,1,0,5,0,-5
24880,1,1,277,1435,1158
24881,1,0,11,0,-11
24882,0,0,18,0,-18
24883,1,0,38,0,-38
24884,1,0,78,0,-78
24885,1,1,155,1295,1140
24886,0,0,19,0,-19
24887,1,1,567,1221,654
24888,1,1,388,2611,2223
24889,1,1,675,1460,785
24890,1,1,777,1564,787
24891,1,1,691,1729,1038
24892,0,0,61,0,-61
24893,0,0,94,0,-94
24894,1,0,41,0,-41
24895,1,1,240,2614,2374
24896,1,0,6,0,-6
24897,1,1,856,1431,575
24898,1,0,78,0,-78
24899,0,0,48,0,-48
24900,1,0,125,0,-125
24901,0,0,13,0,-13
24902,0,0,53,0,-53
24903,1,0,18,0,-18
24904,0,0,5,0,-5
24905,1,0,63,0,-63
24906,0,0,80,0,-80
24907,1,1,181,1415,1234
24908,0,0,132,0,-132
24909,0,0,12,0,-12
24910,1,0,14,0,-14
24911,1,0,63,0,-63
24912,0,0,27,0,-27
24913,1,0,59,0,-59
24914,0,0,2,0,-2
24915,0,0,84,0,-84
24916,1,1,824,1678,854
24917,1,0,110,0,-110
24918,1,1,366,1247,881
24919,0,0,56,0,-56
24920,0,0,54,0,-54
24921,0,0,99,0,-99
24922,0,0,29,0,-29
24923,1,1,140,1260,1120
24924,1,0,0,0,0
24925,1,0,159,0,-159
24926,1,0,14,0,-14
24927,1,0,80,0,-80
24928,0,0,44,0,-44
24929,1,0,42,0,-42
24930,1,0,13,0,-13
24931,0,0,96,0,-96
24932,0,0,2,0,-2
24933,1,0,60,0,-60
24934,0,0,72,0,-72
24935,0,0,91,0,-91
24936,1,1,543,1981,1438
24937,1,0,16,0,-16
24938,1,1,360,2026,1666
24939,1,0,36,0,-36
24940,1,1,143,1391,1248
24941,0,0,97,0,-97
24942,1,1,111,1272,1161
24943,0,0,0,0,0
24944,1,0,43,0,-43
24945,0,0,69,0,-69
24946,1,0,100,0,-100
24947,0,0,15,0,-15
24948,1,1,224,3328,3104
24949,1,1,282,1289,1007
24950,1,1,115,1379,1264
24951,1,0,12,0,-12
24952,0,0,90,0,-90
24953,0,0,90,0,-90
24954,1,1,1395,1381,-14
24955,1,0,9,0,-9
24956,1,0,36,0,-36
24957,0,0,14,0,-14
24958,0,0,23,0,-23
24959,1,0,24,0,-24
24960,1,0,11,0,-11
24961,0,0,3,0,-3
24962,1,0,18,0,-18
24963,1,1,286,1644,1358
24964,0,0,15,0,-15
24965,0,0,27,0,-27
24966,1,1,43,2162,2119
24967,0,0,65,0,-65
24968,1,1,260,3444,3184
24969,0,0,161,0,-161
24970,0,0,30,0,-30
24971,1,1,945,2122,1177
24972,0,0,9,0,-9
24973,0,0,38,0,-38
24974,1,0,36,0,-36
24975,0,0,43,0,-43
24976,1,1,243,1375,1132
24977,0,0,11,0,-11
24978,0,0,10,0,-10
24979,0,0,53,0,-53
24980,1,0,100,0,-100
24981,1,0,54,0,-54
24982,1,0,19,0,-19
24983,0,0,10,0,-10
24984,1,1,347,1774,1427
24985,1,1,433,1540,1107
24986,0,0,19,0,-19
24987,0,0,37,0,-37
24988,1,1,783,1562,779
24989,1,1,52,1253,1201
24990,0,0,19,0,-19
24991,0,0,26,0,-26
24992,1,1,288,2305,2017
24993,1,1,537,1660,1123
24994,1,1,501,1398,897
24995,0,0,21,0,-21
24996,0,0,68,0,-68
24997,1,1,337,1449,1112
24998,1,0,48,0,-48
24999,0,0,12,0,-12
25000,0,0,43,0,-43
25001,1,1,216,1456,1240
25002,1,1,79,1309,1230
25003,1,1,683,1383,700
25004,1,0,5,0,-5
25005,0,0,189,0,-189
25006,1,1,286,1654,1368
25007,0,0,136,0,-136
25008,1,0,11,0,-11
25009,1,0,37,0,-37
25010,1,0,110,0,-110
25011,1,0,144,0,-144
25012,0,0,0,0,0
25013,1,1,520,1366,846
25014,0,0,52,0,-52
25015,1,1,433,2607,2174
25016,1,1,108,3013,2905
25017,0,0,14,0,-14
25018,1,0,40,0,-40
25019,0,0,6,0,-6
25020,1,0,48,0,-48
25021,1,1,1416,1304,-112
25022,1,0,20,0,-20
25023,1,0,20,0,-20
25024,0,0,0,0,0
25025,0,0,76,0,-76
25026,1,1,362,1361,999
25027,0,0,39,0,-39
25028,1,1,1173,1320,147
25029,1,0,53,0,-53
25030,0,0,18,0,-18
25031,1,1,391,2000,1609
25032,1,1,2525,1310,-1215
25033,1,0,4,0,-4
25034,1,1,184,1282,1098
25035,1,1,211,1376,1165
25036,1,1,67,1287,1220
25037,1,1,355,1371,1016
25038,1,1,297,1247,950
25039,1,0,67,0,-67
25040,0,0,49,0,-49
25041,0,0,4,0,-4
25042,0,0,15,0,-15
25043,1,0,64,0,-64
25044,1,0,8,0,-8
25045,1,0,16,0,-16
25046,1,1,288,1301,1013
25047,1,0,11,0,-11
25048,1,0,18,0,-18
25049,1,0,83,0,-83
25050,1,1,1370,1321,-49
25051,1,0,13,0,-13
25052,1,1,136,1604,1468
25053,1,0,2,0,-2
25054,1,0,59,0,-59
25055,1,0,63,0,-63
25056,0,0,113,0,-113
25057,1,1,88,1351,1263
25058,0,0,22,0,-22
25059,1,1,102,1939,1837
25060,0,0,86,0,-86
25061,1,1,1255,1268,13
25062,0,0,167,0,-167
25063,1,1,1020,1547,527
25064,1,1,85,1522,1437
25065,1,1,116,1328,1212
25066,1,1,506,1844,1338
25067,1,0,24,0,-24
25068,1,0,162,0,-162
25069,1,1,111,2726,2615
25070,0,0,9,0,-9
25071,1,0,8,0,-8
25072,0,0,18,0,-18
25073,1,1,87,1995,1908
25074,1,0,29,0,-29
25075,1,1,40,1236,1196
25076,1,1,86,1244,1158
25077,0,0,27,0,-27
25078,0,0,7,0,-7
25079,1,1,1212,1305,93
25080,0,0,93,0,-93
25081,1,0,57,0,-57
25082,1,0,42,0,-42
25083,1,1,113,1503,1390
25084,0,0,2,0,-2
25085,1,1,1359,1430,71
25086,1,1,442,2234,1792
25087,1,0,8,0,-8
25088,0,0,93,0,-93
25089,1,0,86,0,-86
25090,1,1,1133,1200,67
25091,1,0,278,0,-278
25092,1,0,92,0,-92
25093,0,0,49,0,-49
25094,0,0,96,0,-96
25095,1,1,551,1257,706
25096,1,1,1372,1917,545
25097,0,0,38,0,-38
25098,0,0,124,0,-124
25099,1,0,38,0,-38
25100,1,1,852,1334,482
25101,1,0,95,0,-95
25102,1,1,457,1395,938
25103,1,0,42,0,-42
25104,1,0,11,0,-11
25105,0,0,11,0,-11
25106,0,0,7,0,-7
25107,0,0,22,0,-22
25108,0,0,39,0,-39
25109,0,0,76,0,-76
25110,1,1,1827,1244,-583
25111,1,0,77,0,-77
25112,0,0,19,0,-19
25113,1,0,77,0,-77
25114,1,0,47,0,-47
25115,1,1,344,1202,858
25116,1,1,197,1402,1205
25117,1,1,254,1267,1013
25118,0,0,47,0,-47
25119,0,0,18,0,-18
25120,0,0,0,0,0
25121,0,0,22,0,-22
25122,1,1,334,1267,933
25123,1,0,28,0,-28
25124,0,0,118,0,-118
25125,0,0,48,0,-48
25126,0,0,37,0,-37
25127,1,1,414,1979,1565
25128,1,1,913,1360,447
25129,0,0,53,0,-53
25130,1,1,63,1225,1162
25131,1,0,244,0,-244
25132,0,0,30,0,-30
25133,0,0,28,0,-28
25134,1,0,37,0,-37
25135,0,0,7,0,-7
25136,1,0,108,0,-108
25137,1,0,15,0,-15
25138,1,0,24,0,-24
25139,0,0,81,0,-81
25140,0,0,78,0,-78
25141,1,0,11,0,-11
25142,1,1,319,1519,1200
25143,1,0,64,0,-64
25144,1,1,1375,1263,-112
25145,0,0,33,0,-33
25146,1,0,36,0,-36
25147,1,1,387,1235,848
25148,0,0,24,0,-24
25149,1,1,1105,1328,223
25150,0,0,0,0,0
25151,1,1,4,1384,1380
25152,0,0,12,0,-12
25153,1,0,51,0,-51
25154,1,1,97,1412,1315
25155,0,0,8,0,-8
25156,1,0,17,0,-17
25157,1,0,78,0,-78
25158,1,0,224,0,-224
25159,1,0,88,0,-88
25160,0,0,24,0,-24
25161,0,0,1,0,-1
25162,1,0,67,0,-67
25163,1,0,22,0,-22
25164,1,0,16,0,-16
25165,1,1,387,1295,908
25166,1,1,559,1575,1016
25167,1,1,157,1292,1135
25168,1,0,150,0,-150
25169,1,1,85,1203,1118
25170,0,0,79,0,-79
25171,0,0,46,0,-46
25172,0,0,187,0,-187
25173,1,0,104,0,-104
25174,1,1,438,1536,1098
25175,1,1,527,1452,925
25176,1,1,541,1499,958
25177,1,1,103,3217,3114
25178,0,0,17,0,-17
25179,1,0,4,0,-4
25180,1,1,845,1219,374
25181,1,0,25,0,-25
25182,0,0,31,0,-31
25183,1,1,107,1420,1313
25184,1,0,64,0,-64
25185,0,0,34,0,-34
25186,1,1,1140,1215,75
25187,1,0,43,0,-43
25188,1,0,106,0,-106
25189,0,0,10,0,-10
25190,1,1,266,1962,1696
25191,0,0,60,0,-60
25192,0,0,18,0,-18
25193,1,1,166,1287,1121
25194,1,1,1019,1384,365
25195,1,1,1081,1230,149
25196,1,1,222,1746,1524
25197,0,0,14,0,-14
25198,0,0,48,0,-48
25199,1,0,49,0,-49
25200,1,0,22,0,-22
25201,1,0,8,0,-8
25202,0,0,60,0,-60
25203,1,1,592,1302,710
25204,0,0,22,0,-22
25205,0,0,11,0,-11
25206,1,0,160,0,-160
25207,0,0,113,0,-113
25208,0,0,27,0,-27
25209,0,0,34,0,-34
25210,0,0,176,0,-176
25211,1,1,821,2408,1587
25212,1,1,1270,2683,1413
25213,1,0,3,0,-3
25214,0,0,38,0,-38
25215,1,0,8,0,-8
25216,0,0,56,0,-56
25217,1,0,53,0,-53
25218,0,0,79,0,-79
25219,1,1,100,1266,1166
25220,1,0,35,0,-35
25221,1,1,396,1615,1219
25222,0,0,14,0,-14
25223,0,0,0,0,0
25224,1,1,167,2596,2429
25225,1,0,16,0,-16
25226,1,1,558,1353,795
25227,1,1,713,1265,552
25228,1,0,4,0,-4
25229,1,0,237,0,-237
25230,0,0,33,0,-33
25231,1,1,908,1253,345
25232,1,1,748,2080,1332
25233,1,1,138,1903,1765
25234,0,0,18,0,-18
25235,1,0,88,0,-88
25236,0,0,20,0,-20
25237,1,0,46,0,-46
25238,1,0,51,0,-51
25239,1,1,548,1318,770
25240,1,1,178,2095,1917
25241,1,0,65,0,-65
25242,1,1,266,1866,1600
25243,1,1,1076,1595,519
25244,1,1,201,1430,1229
25245,1,1,71,2052,1981
25246,0,0,63,0,-63
25247,1,1,230,1688,1458
25248,0,0,5,0,-5
25249,1,1,448,1598,1150
25250,1,1,681,2181,1500
25251,1,0,55,0,-55
25252,1,0,20,0,-20
25253,0,0,11,0,-11
25254,1,1,1224,1352,128
25255,0,0,7,0,-7
25256,0,0,18,0,-18
25257,1,1,158,1211,1053
25258,1,0,30,0,-30
25259,0,0,66,0,-66
25260,0,0,160,0,-160
25261,1,0,109,0,-109
25262,1,1,269,1459,1190
25263,1,0,88,0,-88
25264,1,1,772,1247,475
25265,0,0,53,0,-53
25266,0,0,10,0,-10
25267,0,0,24,0,-24
25268,1,0,53,0,-53
25269,0,0,18,0,-18
25270,0,0,89,0,-89
25271,1,1,1101,1742,641
25272,0,0,56,0,-56
25273,0,0,11,0,-11
25274,1,1,784,1484,700
25275,0,0,77,0,-77
25276,1,1,1037,2176,1139
25277,1,0,20,0,-20
25278,1,0,44,0,-44
25279,1,0,34,0,-34
25280,1,1,479,1240,761
25281,1,0,95,0,-95
25282,1,1,581,1438,857
25283,0,0,107,0,-107
25284,1,1,188,1734,1546
25285,0,0,21,0,-21
25286,1,0,59,0,-59
25287,0,0,58,0,-58
25288,1,0,18,0,-18
25289,1,0,7,0,-7
25290,0,0,150,0,-150
25291,0,0,39,0,-39
25292,1,0,4,0,-4
25293,1,1,321,1721,1400
25294,0,0,26,0,-26
25295,1,1,1569,1499,-70
25296,0,0,156,0,-156
25297,1,1,81,1552,1471
25298,0,0,19,0,-19
25299,1,0,112,0,-112
25300,1,1,1803,1466,-337
25301,0,0,42,0,-42
25302,0,0,62,0,-62
25303,0,0,9,0,-9
25304,0,0,37,0,-37
25305,1,0,9,0,-9
25306,1,0,34,0,-34
25307,1,1,18,1277,1259
25308,1,0,96,0,-96
25309,1,1,664,2061,1397
25310,1,1,458,1235,777
25311,1,1,363,1463,1100
25312,1,0,9,0,-9
25313,1,0,64,0,-64
25314,1,1,189,1294,1105
25315,1,0,39,0,-39
25316,1,1,454,1721,1267
25317,0,0,24,0,-24
25318,1,1,1394,1430,36
25319,1,0,49,0,-49
25320,1,1,539,1508,969
25321,1,1,640,2033,1393
25322,1,1,588,1206,618
25323,1,1,1516,1743,227
25324,1,0,55,0,-55
25325,1,1,45,1606,1561
25326,1,0,31,0,-31
25327,1,1,290,1853,1563
25328,0,0,55,0,-55
25329,0,0,29,0,-29
25330,1,1,176,1342,1166
25331,0,0,43,0,-43
25332,0,0,27,0,-27
25333,1,1,217,1333,1116
25334,1,0,32,0,-32
25335,1,1,565,1685,1120
25336,1,0,52,0,-52
25337,1,0,65,0,-65
25338,1,0,4,0,-4
25339,1,0,88,0,-88
25340,1,1,328,2320,1992
25341,1,1,187,1282,1095
25342,1,1,539,2146,1607
25343,0,0,87,0,-87
25344,0,0,34,0,-34
25345,0,0,25,0,-25
25346,0,0,44,0,-44
25347,1,0,9,0,-9
25348,0,0,22,0,-22
25349,0,0,38,0,-38
25350,0,0,46,0,-46
25351,1,1,364,1314,950
25352,1,0,99,0,-99
25353,0,0,36,0,-36
25354,0,0,85,0,-85
25355,1,0,194,0,-194
25356,0,0,65,0,-65
25357,1,1,78,1239,1161
25358,1,1,84,1723,1639
25359,0,0,68,0,-68
25360,1,1,235,2057,1822
25361,1,1,590,1321,731
25362,1,1,1022,1671,649
25363,1,0,62,0,-62
25364,1,0,23,0,-23
25365,0,0,193,0,-193
25366,1,1,144,1564,1420
25367,0,0,71,0,-71
25368,1,0,11,0,-11
25369,1,0,21,0,-21
25370,0,0,25,0,-25
25371,1,1,118,1993,1875
25372,1,0,43,0,-43
25373,0,0,89,0,-89
25374,1,0,68,0,-68
25375,1,1,486,1284,798
25376,1,0,61,0,-61
25377,1,1,131,1204,1073
25378,1,1,76,1330,1254
25379,1,1,646,1200,554
25380,1,1,389,1647,1258
25381,0,0,22,0,-22
25382,0,0,4,0,-4
25383,0,0,41,0,-41
25384,1,0,2,0,-2
25385,1,0,18,0,-18
25386,0,0,140,0,-140
25387,1,0,102,0,-102
25388,1,1,367,2183,1816
25389,1,0,77,0,-77
25390,1,1,330,1377,1047
25391,1,1,899,1367,468
25392,1,1,348,1734,1386
25393,0,0,13,0,-13
25394,1,1,1213,2341,1128
25395,1,0,73,0,-73
25396,1,0,7,0,-7
25397,0,0,106,0,-106
25398,0,0,60,0,-60
25399,1,0,68,0,-68
25400,1,0,70,0,-70
25401,1,1,294,1217,923
25402,1,1,373,1288,915
25403,1,0,11,0,-11
25404,1,1,484,1248,764
25405,1,1,596,1469,873
25406,1,0,7,0,-7
25407,1,0,122,0,-122
25408,1,0,130,0,-130
25409,0,0,6,0,-6
25410,1,1,311,1992,1681
25411,1,1,626,1414,788
25412,1,0,7,0,-7
25413,0,0,59,0,-59
25414,1,0,81,0,-81
25415,1,1,208,1865,1657
25416,1,1,114,1214,1100
25417,0,0,44,0,-44
25418,0,0,27,0,-27
25419,1,0,62,0,-62
25420,1,0,71,0,-71
25421,0,0,45,0,-45
25422,0,0,4,0,-4
25423,1,1,2362,1808,-554
25424,0,0,124,0,-124
25425,1,0,245,0,-245
25426,0,0,25,0,-25
25427,1,0,55,0,-55
25428,1,1,214,1688,1474
25429,0,0,46,0,-46
25430,1,1,402,1433,1031
25431,1,0,16,0,-16
25432,1,1,193,1471,1278
25433,1,0,14,0,-14
25434,0,0,29,0,-29
25435,0,0,108,0,-108
25436,1,1,300,1572,1272
25437,1,0,6,0,-6
25438,1,0,35,0,-35
25439,1,0,62,0,-62
25440,0,0,12,0,-12
25441,0,0,44,0,-44
25442,1,1,1035,1324,289
25443,1,0,85,0,-85
25444,1,1,300,1244,944
25445,1,0,231,0,-231
25446,1,1,71,2190,2119
25447,1,1,765,1637,872
25448,1,1,290,1209,919
25449,1,0,229,0,-229
25450,0,0,14,0,-14
25451,0,0,21,0,-21
25452,1,0,23,0,-23
25453,0,0,1,0,-1
25454,1,1,63,1207,1144
25455,1,1,573,1200,627
25456,1,1,1213,1731,518
25457,1,0,6,0,-6
25458,0,0,12,0,-12
25459,1,1,1049,1341,292
25460,0,0,3,0,-3
25461,0,0,89,0,-89
25462,1,0,49,0,-49
25463,1,1,60,2821,2761
25464,1,0,41,0,-41
25465,0,0,3,0,-3
25466,0,0,21,0,-21
25467,1,0,26,0,-26
25468,0,0,3,0,-3
25469,1,0,5,0,-5
25470,1,1,685,1854,1169
25471,0,0,88,0,-88
25472,0,0,38,0,-38
25473,1,0,2,0,-2
25474,1,0,8,0,-8
25475,0,0,22,0,-22
25476,0,0,55,0,-55
25477,1,0,2,0,-2
25478,1,1,72,1365,1293
25479,0,0,3,0,-3
25480,1,1,212,1275,1063
25481,1,0,89,0,-89
25482,0,0,21,0,-21
25483,0,0,1,0,-1
25484,1,0,19,0,-19
25485,0,0,77,0,-77
25486,0,0,54,0,-54
25487,1,0,108,0,-108
25488,0,0,8,0,-8
25489,1,0,85,0,-85
25490,1,1,514,1256,742
25491,1,0,56,0,-56
25492,1,0,72,0,-72
25493,1,0,39,0,-39
25494,1,1,116,1284,1168
25495,0,0,58,0,-58
25496,0,0,80,0,-80
25497,0,0,51,0,-51
25498,0,0,108,0,-108
25499,0,0,131,0,-131
25500,0,0,2,0,-2
25501,0,0,12,0,-12
25502,1,0,6,0,-6
25503,1,1,697,2638,1941
25504,1,1,370,1477,1107
25505,1,1,1274,1256,-18
25506,0,0,58,0,-58
25507,1,0,5,0,-5
25508,0,0,20,0,-20
25509,0,0,22,0,-22
25510,1,0,12,0,-12
25511,0,0,53,0,-53
25512,0,0,76,0,-76
25513,1,0,87,0,-87
25514,0,0,26,0,-26
25515,1,1,1526,1413,-113
25516,1,0,23,0,-23
25517,1,0,3,0,-3
25518,0,0,40,0,-40
25519,1,1,108,1210,1102
25520,1,1,77,1909,1832
25521,0,0,184,0,-184
25522,0,0,33,0,-33
25523,1,1,320,1371,1051
25524,0,0,44,0,-44
25525,1,1,1448,2532,1084
25526,0,0,7,0,-7
25527,1,1,691,2024,1333
25528,0,0,85,0,-85
25529,1,0,49,0,-49
25530,0,0,2,0,-2
25531,1,0,3,0,-3
25532,1,1,341,1894,1553
25533,0,0,35,0,-35
25534,0,0,44,0,-44
25535,1,0,133,0,-133
25536,1,0,216,0,-216
25537,0,0,85,0,-85
25538,1,1,920,1329,409
25539,1,1,265,1308,1043
25540,0,0,19,0,-19
25541,0,0,42,0,-42
25542,1,1,772,1324,552
25543,0,0,109,0,-109
25544,1,1,292,1520,1228
25545,1,0,1,0,-1
25546,0,0,241,0,-241
25547,1,1,1309,1514,205
25548,0,0,8,0,-8
25549,1,1,219,1840,1621
25550,1,0,41,0,-41
25551,1,1,991,1634,643
25552,1,1,195,1712,1517
25553,1,1,110,1254,1144
25554,0,0,41,0,-41
25555,0,0,11,0,-11
25556,1,0,35,0,-35
25557,0,0,34,0,-34
25558,1,1,188,1223,1035
25559,1,1,1583,1225,-358
25560,0,0,37,0,-37
25561,0,0,82,0,-82
25562,1,1,120,1231,1111
25563,1,0,95,0,-95
25564,0,0,0,0,0
25565,1,1,1081,1258,177
25566,1,1,1155,1263,108
25567,1,0,63,0,-63
25568,0,0,55,0,-55
25569,1,1,49,1222,1173
25570,1,0,9,0,-9
25571,1,1,1181,1230,49
25572,1,0,70,0,-70
25573,1,1,632,1439,807
25574,1,1,123,1930,1807
25575,1,1,481,1481,1000
25576,1,0,138,0,-138
25577,1,1,816,4442,3626
25578,0,0,96,0,-96
25579,1,0,24,0,-24
25580,1,1,204,1346,1142
25581,1,1,1229,1398,169
25582,0,0,51,0,-51
25583,0,0,77,0,-77
25584,1,1,30,2093,2063
25585,1,1,1453,1659,206
25586,1,1,288,2143,1855
25587,1,0,32,0,-32
25588,1,1,844,1241,397
25589,1,1,337,1306,969
25590,1,0,7,0,-7
25591,1,0,5,0,-5
25592,1,1,468,1341,873
25593,0,0,0,0,0
25594,1,0,21,0,-21
25595,0,0,23,0,-23
25596,1,1,425,2593,2168
25597,1,0,60,0,-60
25598,0,0,49,0,-49
25599,1,1,229,1447,1218
25600,0,0,158,0,-158
25601,0,0,10,0,-10
25602,1,1,256,1635,1379
25603,0,0,25,0,-25
25604,1,0,52,0,-52
25605,1,0,138,0,-138
25606,0,0,43,0,-43
25607,1,1,60,1382,1322
25608,0,0,59,0,-59
25609,0,0,8,0,-8
25610,1,1,67,1462,1395
25611,1,0,0,0,0
25612,1,1,359,1382,1023
25613,0,0,45,0,-45
25614,1,1,276,2156,1880
25615,0,0,119,0,-119
25616,0,0,38,0,-38
25617,1,0,0,0,0
25618,0,0,36,0,-36
25619,1,1,1146,1254,108
25620,1,0,9,0,-9
25621,1,1,271,1436,1165
25622,0,0,45,0,-45
25623,1,1,1975,1453,-522
25624,1,0,167,0,-167
25625,0,0,17,0,-17
25626,0,0,38,0,-38
25627,0,0,17,0,-17
25628,1,0,25,0,-25
25629,1,1,102,1218,1116
25630,1,0,11,0,-11
25631,1,0,60,0,-60
25632,1,0,26,0,-26
25633,0,0,29,0,-29
25634,0,0,79,0,-79
25635,1,1,1337,1263,-74
25636,1,1,385,1503,1118
25637,0,0,7,0,-7
25638,1,1,746,2163,1417
25639,1,0,29,0,-29
25640,1,0,15,0,-15
25641,1,1,1128,1272,144
25642,1,1,411,1787,1376
25643,1,1,766,1618,852
25644,0,0,17,0,-17
25645,0,0,78,0,-78
25646,1,0,22,0,-22
25647,1,1,506,2082,1576
25648,1,0,28,0,-28
25649,0,0,21,0,-21
25650,1,0,6,0,-6
25651,0,0,0,0,0
25652,1,1,421,1770,1349
25653,1,1,1727,1436,-291
25654,0,0,37,0,-37
25655,1,0,48,0,-48
25656,0,0,107,0,-107
25657,1,0,103,0,-103
25658,0,0,31,0,-31
25659,1,0,3,0,-3
25660,1,1,535,2093,1558
25661,1,1,1085,1254,169
25662,0,0,42,0,-42
25663,0,0,63,0,-63
25664,1,0,101,0,-101
25665,0,0,72,0,-72
25666,1,0,6,0,-6
25667,1,0,6,0,-6
25668,1,1,130,1237,1107
25669,0,0,15,0,-15
25670,0,0,8,0,-8
25671,1,0,6,0,-6
25672,1,0,2,0,-2
25673,0,0,77,0,-77
25674,0,0,15,0,-15
25675,1,0,62,0,-62
25676,0,0,16,0,-16
25677,1,1,1123,1256,133
25678,1,1,56,1207,1151
25679,1,1,111,1330,1219
25680,1,0,11,0,-11
25681,1,0,61,0,-61
25682,1,1,488,1285,797
25683,1,0,21,0,-21
25684,1,0,10,0,-10
25685,1,1,339,2368,2029
25686,1,0,46,0,-46
25687,0,0,100,0,-100
25688,0,0,62,0,-62
25689,1,0,50,0,-50
25690,1,1,91,1461,1370
25691,0,0,10,0,-10
25692,1,0,14,0,-14
25693,0,0,9,0,-9
25694,1,1,146,1387,1241
25695,1,0,0,0,0
25696,1,0,6,0,-6
25697,1,0,50,0,-50
25698,1,0,20,0,-20
25699,0,0,4,0,-4
25700,0,0,135,0,-135
25701,1,0,68,0,-68
25702,0,0,11,0,-11
25703,1,0,59,0,-59
25704,1,0,5,0,-5
25705,1,1,99,1243,1144
25706,1,1,1103,1534,431
25707,1,1,299,1663,1364
25708,1,1,120,1797,1677
25709,1,1,1158,2989,1831
25710,0,0,97,0,-97
25711,0,0,72,0,-72
25712,1,1,887,1261,374
25713,0,0,47,0,-47
25714,1,0,52,0,-52
25715,0,0,60,0,-60
25716,0,0,8,0,-8
25717,0,0,30,0,-30
25718,0,0,16,0,-16
25719,1,0,5,0,-5
25720,1,1,313,1245,932
25721,1,1,421,1363,942
25722,1,1,870,1521,651
25723,1,0,17,0,-17
25724,0,0,30,0,-30
25725,0,0,208,0,-208
25726,0,0,139,0,-139
25727,0,0,80,0,-80
25728,0,0,100,0,-100
25729,0,0,13,0,-13
25730,1,1,91,1350,1259
25731,1,1,232,1418,1186
25732,0,0,77,0,-77
25733,0,0,154,0,-154
25734,0,0,45,0,-45
25735,0,0,375,0,-375
25736,1,1,752,1608,856
25737,1,1,387,1465,1078
25738,1,0,43,0,-43
25739,1,1,50,2503,2453
25740,1,0,1,0,-1
25741,1,1,982,1922,940
25742,1,1,34,1281,1247
25743,1,1,393,1383,990
25744,0,0,211,0,-211
25745,0,0,34,0,-34
25746,1,1,145,6258,6113
25747,0,0,32,0,-32
25748,1,1,544,1886,1342
25749,0,0,101,0,-101
25750,1,0,59,0,-59
25751,0,0,36,0,-36
25752,1,0,75,0,-75
25753,0,0,40,0,-40
25754,1,1,340,1435,1095
25755,0,0,72,0,-72
25756,0,0,111,0,-111
25757,0,0,62,0,-62
25758,1,0,125,0,-125
25759,0,0,70,0,-70
25760,0,0,27,0,-27
25761,1,0,71,0,-71
25762,1,0,59,0,-59
25763,0,0,162,0,-162
25764,1,0,43,0,-43
25765,1,1,12,1960,1948
25766,1,1,916,1787,871
25767,0,0,8,0,-8
25768,1,1,60,2200,2140
25769,1,1,415,1223,808
25770,1,1,69,1253,1184
25771,1,1,192,1351,1159
25772,1,1,257,1921,1664
25773,1,1,152,1294,1142
25774,1,1,546,1971,1425
25775,0,0,35,0,-35
25776,1,1,239,1422,1183
25777,0,0,28,0,-28
25778,1,0,54,0,-54
25779,1,0,5,0,-5
25780,1,1,458,1202,744
25781,1,0,45,0,-45
25782,1,1,1842,1614,-228
25783,0,0,9,0,-9
25784,1,1,361,1246,885
25785,0,0,7,0,-7
25786,0,0,10,0,-10
25787,1,1,788,1238,450
25788,0,0,48,0,-48
25789,0,0,20,0,-20
25790,1,1,1227,1328,101
25791,1,0,27,0,-27
25792,0,0,17,0,-17
25793,1,1,979,1258,279
25794,1,1,103,1297,1194
25795,1,1,277,1259,982
25796,1,1,187,1771,1584
25797,1,0,59,0,-59
25798,1,0,105,0,-105
25799,1,0,51,0,-51
25800,1,0,15,0,-15
25801,1,0,199,0,-199
25802,1,0,51,0,-51
25803,1,1,256,1266,1010
25804,0,0,3,0,-3
25805,1,0,47,0,-47
25806,1,0,11,0,-11
25807,0,0,4,0,-4
25808,0,0,87,0,-87
25809,0,0,3,0,-3
25810,0,0,111,0,-111
25811,1,1,109,1646,1537
25812,0,0,8,0,-8
25813,0,0,5,0,-5
25814,0,0,28,0,-28
25815,1,0,76,0,-76
25816,1,1,320,1689,1369
25817,0,0,6,0,-6
25818,0,0,1,0,-1
25819,1,1,1097,1592,495
25820,1,1,306,1583,1277
25821,1,1,63,1520,1457
25822,1,1,719,1877,1158
25823,1,0,82,0,-82
25824,0,0,7,0,-7
25825,0,0,91,0,-91
25826,1,0,324,0,-324
25827,1,0,59,0,-59
25828,1,0,53,0,-53
25829,1,1,500,1580,1080
25830,1,1,1459,1605,146
25831,0,0,48,0,-48
25832,0,0,30,0,-30
25833,0,0,47,0,-47
25834,1,1,277,1345,1068
25835,1,1,146,1664,1518
25836,1,1,278,1376,1098
25837,1,0,97,0,-97
25838,1,1,234,1311,1077
25839,1,1,166,1641,1475
25840,1,0,72,0,-72
25841,1,1,793,2392,1599
25842,1,0,26,0,-26
25843,0,0,41,0,-41
25844,1,0,49,0,-49
25845,0,0,32,0,-32
25846,0,0,16,0,-16
25847,1,1,909,3582,2673
25848,1,0,3,0,-3
25849,0,0,42,0,-42
25850,0,0,19,0,-19
25851,0,0,215,0,-215
25852,1,0,119,0,-119
25853,1,1,544,1401,857
25854,1,1,743,1422,679
25855,1,1,85,1635,1550
25856,1,1,45,1374,1329
25857,0,0,77,0,-77
25858,0,0,15,0,-15
25859,1,1,157,1555,1398
25860,1,0,71,0,-71
25861,1,0,60,0,-60
25862,0,0,1,0,-1
25863,0,0,83,0,-83
25864,1,1,852,1455,603
25865,1,0,43,0,-43
25866,0,0,31,0,-31
25867,0,0,63,0,-63
25868,1,1,786,1315,529
25869,0,0,151,0,-151
25870,1,1,349,2654,2305
25871,1,0,115,0,-115
25872,0,0,26,0,-26
25873,0,0,1,0,-1
25874,1,1,64,1353,1289
25875,1,1,201,1287,1086
25876,0,0,56,0,-56
25877,0,0,36,0,-36
25878,0,0,81,0,-81
25879,0,0,57,0,-57
25880,1,0,28,0,-28
25881,0,0,40,0,-40
25882,0,0,29,0,-29
25883,1,0,142,0,-142
25884,1,0,48,0,-48
25885,1,0,56,0,-56
25886,1,0,65,0,-65
25887,1,1,613,1204,591
25888,1,1,230,1798,1568
25889,0,0,159,0,-159
25890,1,1,105,1656,1551
25891,0,0,1,0,-1
25892,1,1,22,4316,4294
25893,1,1,300,1574,1274
25894,0,0,48,0,-48
25895,1,1,1554,1538,-16
25896,0,0,7,0,-7
25897,0,0,47,0,-47
25898,1,1,660,1661,1001
25899,1,0,22,0,-22
25900,1,1,409,1694,1285
25901,1,0,14,0,-14
25902,1,0,4,0,-4
25903,0,0,13,0,-13
25904,0,0,5,0,-5
25905,0,0,37,0,-37
25906,0,0,74,0,-74
25907,1,0,65,0,-65
25908,0,0,37,0,-37
25909,1,1,1077,3099,2022
25910,1,1,579,2140,1561
25911,1,1,1602,1203,-399
25912,1,1,203,1306,1103
25913,0,0,110,0,-110
25914,1,0,2,0,-2
25915,0,0,3,0,-3
25916,1,1,374,1280,906
25917,0,0,0,0,0
25918,1,1,5,1246,1241
25919,1,1,171,1336,1165
25920,0,0,18,0,-18
25921,1,0,41,0,-41
25922,0,0,36,0,-36
25923,0,0,74,0,-74
25924,1,1,559,1250,691
25925,1,1,119,2096,1977
25926,0,0,121,0,-121
25927,1,1,341,1234,893
25928,1,1,1368,2210,842
25929,0,0,11,0,-11
25930,1,0,43,0,-43
25931,1,1,1123,1454,331
25932,1,1,185,2803,2618
25933,0,0,27,0,-27
25934,1,1,399,1210,811
25935,0,0,67,0,-67
25936,1,1,266,1858,1592
25937,1,1,763,1831,1068
25938,0,0,19,0,-19
25939,0,0,104,0,-104
25940,1,0,79,0,-79
25941,0,0,14,0,-14
25942,1,0,60,0,-60
25943,1,1,760,2311,1551
25944,1,1,181,1797,1616
25945,1,1,20,1376,1356
25946,1,0,99,0,-99
25947,1,1,242,3342,3100
25948,1,0,158,0,-158
25949,1,0,2,0,-2
25950,1,0,16,0,-16
25951,0,0,45,0,-45
25952,0,0,3,0,-3
25953,0,0,32,0,-32
25954,0,0,77,0,-77
25955,1,0,14,0,-14
25956,0,0,5,0,-5
25957,0,0,137,0,-137
25958,1,0,0,0,0
25959,1,0,105,0,-105
25960,1,1,201,1361,1160
25961,0,0,26,0,-26
25962,1,0,176,0,-176
25963,0,0,182,0,-182
25964,1,1,330,1832,1502
25965,0,0,120,0,-120
25966,0,0,84,0,-84
25967,1,0,7,0,-7
25968,1,1,535,1301,766
25969,0,0,113,0,-113
25970,0,0,165,0,-165
25971,1,0,9,0,-9
25972,1,1,257,1308,1051
25973,1,1,944,1398,454
25974,1,1,599,1247,648
25975,0,0,1,0,-1
25976,1,0,57,0,-57
25977,1,1,120,2872,2752
25978,1,0,18,0,-18
25979,1,0,36,0,-36
25980,0,0,13,0,-13
25981,0,0,13,0,-13
25982,1,1,335,1255,920
25983,1,0,12,0,-12
25984,0,0,24,0,-24
25985,1,0,31,0,-31
25986,1,0,106,0,-106
25987,1,1,268,1361,1093
25988,0,0,50,0,-50
25989,0,0,104,0,-104
25990,0,0,21,0,-21
25991,0,0,46,0,-46
25992,1,0,32,0,-32
25993,1,0,0,0,0
25994,0,0,381,0,-381
25995,1,0,186,0,-186
25996,0,0,40,0,-40
25997,1,0,37,0,-37
25998,1,1,138,1874,1736
25999,0,0,63,0,-63
26000,0,0,56,0,-56
26001,0,0,21,0,-21
26002,0,0,26,0,-26
26003,1,1,219,1496,1277
26004,0,0,18,0,-18
26005,0,0,167,0,-167
26006,0,0,163,0,-163
26007,0,0,2,0,-2
26008,1,1,393,1353,960
26009,0,0,55,0,-55
26010,1,1,214,2026,1812
26011,1,1,161,1332,1171
26012,0,0,35,0,-35
26013,1,0,27,0,-27
26014,0,0,25,0,-25
26015,1,0,38,0,-38
26016,1,0,37,0,-37
26017,1,0,69,0,-69
26018,0,0,8,0,-8
26019,1,0,43,0,-43
26020,0,0,121,0,-121
26021,0,0,121,0,-121
26022,1,0,165,0,-165
26023,0,0,64,0,-64
26024,1,0,19,0,-19
26025,0,0,11,0,-11
26026,1,1,306,1221,915
26027,0,0,77,0,-77
26028,0,0,30,0,-30
26029,1,1,293,1497,1204
26030,1,0,130,0,-130
26031,1,1,2219,1728,-491
26032,0,0,2,0,-2
26033,0,0,27,0,-27
26034,1,1,855,1494,639
26035,1,0,15,0,-15
26036,1,1,518,1983,1465
26037,0,0,5,0,-5
26038,0,0,29,0,-29
26039,1,0,83,0,-83
26040,1,1,1665,1503,-162
26041,1,0,89,0,-89
26042,1,1,505,1235,730
26043,1,0,3,0,-3
26044,0,0,16,0,-16
26045,0,0,61,0,-61
26046,1,0,2,0,-2
26047,1,0,8,0,-8
26048,1,0,145,0,-145
26049,1,1,550,1223,673
26050,0,0,179,0,-179
26051,1,1,1093,1638,545
26052,1,1,2626,1753,-873
26053,1,1,367,1348,981
26054,1,1,1242,2334,1092
26055,0,0,46,0,-46
26056,1,0,72,0,-72
26057,1,1,365,1266,901
26058,1,1,103,1532,1429
26059,0,0,40,0,-40
26060,1,0,25,0,-25
26061,1,0,21,0,-21
26062,1,0,9,0,-9
26063,0,0,52,0,-52
26064,0,0,29,0,-29
26065,1,1,199,1296,1097
26066,1,0,77,0,-77
26067,0,0,153,0,-153
26068,1,0,11,0,-11
26069,1,1,559,1409,850
26070,1,1,631,1314,683
26071,1,0,28,0,-28
26072,1,0,4,0,-4
26073,0,0,3,0,-3
26074,0,0,69,0,-69
26075,1,1,240,1297,1057
26076,1,0,79,0,-79
26077,1,0,7,0,-7
26078,1,0,57,0,-57
26079,1,0,36,0,-36
26080,1,1,514,1493,979
26081,1,1,338,1413,1075
26082,1,1,39,1312,1273
26083,0,0,5,0,-5
26084,0,0,12,0,-12
26085,0,0,26,0,-26
26086,0,0,75,0,-75
26087,1,1,217,1565,1348
26088,0,0,12,0,-12
26089,1,1,519,1395,876
26090,1,1,443,1358,915
26091,1,0,4,0,-4
26092,1,1,1395,1707,312
26093,1,0,6,0,-6
26094,0,0,43,0,-43
26095,0,0,132,0,-132
26096,1,0,26,0,-26
26097,1,0,1,0,-1
26098,1,0,101,0,-101
26099,0,0,48,0,-48
26100,0,0,47,0,-47
26101,0,0,5,0,-5
26102,1,0,22,0,-22
26103,1,0,79,0,-79
26104,0,0,84,0,-84
26105,0,0,162,0,-162
26106,1,0,51,0,-51
26107,1,0,12,0,-12
26108,1,1,176,1636,1460
26109,0,0,50,0,-50
26110,1,0,7,0,-7
26111,0,0,15,0,-15
26112,1,0,54,0,-54
26113,1,0,100,0,-100
26114,1,1,670,1410,740
26115,1,1,1019,1366,347
26116,0,0,65,0,-65
26117,1,0,32,0,-32
26118,0,0,148,0,-148
26119,1,1,306,1891,1585
26120,0,0,33,0,-33
26121,1,0,23,0,-23
26122,0,0,64,0,-64
26123,0,0,46,0,-46
26124,1,0,22,0,-22
26125,1,1,869,1456,587
26126,1,0,128,0,-128
26127,1,0,137,0,-137
26128,0,0,100,0,-100
26129,1,0,45,0,-45
26130,0,0,39,0,-39
26131,0,0,12,0,-12
26132,0,0,80,0,-80
26133,0,0,17,0,-17
26134,1,1,177,2357,2180
26135,0,0,6,0,-6
26136,1,1,1349,1238,-111
26137,1,1,140,1343,1203
26138,0,0,26,0,-26
26139,1,0,119,0,-119
26140,1,1,686,1456,770
26141,0,0,143,0,-143
26142,1,0,19,0,-19
26143,1,1,340,1217,877
26144,0,0,95,0,-95
26145,0,0,27,0,-27
26146,1,1,290,2977,2687
26147,1,0,44,0,-44
26148,1,1,1933,1202,-731
26149,1,0,78,0,-78
26150,1,1,828,1705,877
26151,0,0,16,0,-16
26152,0,0,54,0,-54
26153,0,0,54,0,-54
26154,1,1,44,1256,1212
26155,1,1,92,1675,1583
26156,0,0,109,0,-109
26157,1,0,17,0,-17
26158,1,0,38,0,-38
26159,1,0,24,0,-24
26160,0,0,135,0,-135
26161,0,0,21,0,-21
26162,1,0,3,0,-3
26163,1,0,2,0,-2
26164,1,1,769,1392,623
26165,0,0,2,0,-2
26166,0,0,137,0,-137
26167,1,0,73,0,-73
26168,1,0,38,0,-38
26169,0,0,42,0,-42
26170,0,0,26,0,-26
26171,0,0,1,0,-1
26172,1,0,30,0,-30
26173,0,0,2,0,-2
26174,0,0,119,0,-119
26175,1,0,1,0,-1
26176,1,0,124,0,-124
26177,1,1,375,1445,1070
26178,1,1,271,1298,1027
26179,0,0,12,0,-12
26180,1,0,9,0,-9
26181,0,0,295,0,-295
26182,0,0,97,0,-97
26183,1,0,161,0,-161
26184,0,0,67,0,-67
26185,0,0,31,0,-31
26186,1,1,545,1354,809
26187,0,0,38,0,-38
26188,1,0,80,0,-80
26189,1,1,67,2511,2444
26190,0,0,13,0,-13
26191,1,0,123,0,-123
26192,1,0,55,0,-55
26193,0,0,165,0,-165
26194,1,1,598,1807,1209
26195,1,0,57,0,-57
26196,1,1,230,1752,1522
26197,0,0,24,0,-24
26198,1,1,19,1326,1307
26199,0,0,14,0,-14
26200,1,1,81,1725,1644
26201,1,0,56,0,-56
26202,0,0,228,0,-228
26203,1,0,32,0,-32
26204,1,1,355,1210,855
26205,1,1,255,1965,1710
26206,1,0,71,0,-71
26207,0,0,82,0,-82
26208,1,1,433,1229,796
26209,1,1,444,1396,952
26210,1,1,105,1399,1294
26211,1,0,9,0,-9
26212,1,0,128,0,-128
26213,1,0,4,0,-4
26214,1,1,352,1278,926
26215,1,0,4,0,-4
26216,1,1,34,1520,1486
26217,1,0,6,0,-6
26218,0,0,95,0,-95
26219,1,1,820,2299,1479
26220,0,0,184,0,-184
26221,1,0,15,0,-15
26222,1,0,70,0,-70
26223,1,0,63,0,-63
26224,0,0,5,0,-5
26225,1,1,201,2131,1930
26226,1,0,41,0,-41
26227,1,0,7,0,-7
26228,0,0,5,0,-5
26229,0,0,3,0,-3
26230,0,0,57,0,-57
26231,1,1,778,2026,1248
26232,1,0,97,0,-97
26233,0,0,43,0,-43
26234,0,0,2,0,-2
26235,0,0,242,0,-242
26236,1,0,19,0,-19
26237,0,0,99,0,-99
26238,1,0,21,0,-21
26239,1,1,57,1346,1289
26240,1,1,462,1270,808
26241,1,0,20,0,-20
26242,0,0,36,0,-36
26243,0,0,2,0,-2
26244,1,1,264,1654,1390
26245,0,0,122,0,-122
26246,0,0,12,0,-12
26247,1,1,202,1300,1098
26248,1,0,14,0,-14
26249,1,0,60,0,-60
26250,0,0,47,0,-47
26251,1,1,1790,1293,-497
26252,0,0,0,0,0
26253,0,0,11,0,-11
26254,0,0,2,0,-2
26255,1,0,67,0,-67
26256,1,0,14,0,-14
26257,0,0,27,0,-27
26258,1,1,22,2014,1992
26259,1,0,14,0,-14
26260,1,1,872,1297,425
26261,0,0,32,0,-32
26262,1,0,17,0,-17
26263,0,0,167,0,-167
26264,1,1,599,1878,1279
26265,0,0,28,0,-28
26266,0,0,45,0,-45
26267,0,0,23,0,-23
26268,0,0,14,0,-14
26269,0,0,10,0,-10
26270,0,0,13,0,-13
26271,1,1,335,1476,1141
26272,1,1,707,1685,978
26273,0,0,61,0,-61
26274,0,0,57,0,-57
26275,0,0,24,0,-24
26276,1,0,2,0,-2
26277,0,0,25,0,-25
26278,0,0,26,0,-26
26279,1,1,842,1485,643
26280,0,0,3,0,-3
26281,1,0,1,0,-1
26282,0,0,21,0,-21
26283,1,1,298,1378,1080
26284,1,0,20,0,-20
26285,1,0,10,0,-10
26286,1,1,72,1301,1229
26287,1,1,556,1205,649
26288,1,1,218,1281,1063
26289,1,0,108,0,-108
26290,1,0,161,0,-161
26291,1,0,115,0,-115
26292,1,1,1212,1247,35
26293,0,0,15,0,-15
26294,1,1,469,2071,1602
26295,0,0,2,0,-2
26296,1,1,428,1424,996
26297,0,0,19,0,-19
26298,1,1,829,1681,852
26299,0,0,52,0,-52
26300,0,0,72,0,-72
26301,0,0,76,0,-76
26302,0,0,34,0,-34
26303,1,1,596,1368,772
26304,0,0,2,0,-2
26305,1,1,196,1241,1045
26306,1,1,559,1329,770
26307,0,0,103,0,-103
26308,1,1,179,1449,1270
26309,0,0,20,0,-20
26310,1,0,11,0,-11
26311,1,0,75,0,-75
26312,1,1,349,39894,39545
26313,1,0,57,0,-57
26314,1,0,7,0,-7
26315,0,0,22,0,-22
26316,1,1,695,1328,633
26317,1,1,87,4395,4308
26318,0,0,26,0,-26
26319,1,1,173,1782,1609
26320,0,0,140,0,-140
26321,0,0,72,0,-72
26322,0,0,14,0,-14
26323,0,0,34,0,-34
26324,0,0,25,0,-25
26325,1,0,27,0,-27
26326,0,0,64,0,-64
26327,1,0,73,0,-73
26328,0,0,10,0,-10
26329,0,0,15,0,-15
26330,1,0,29,0,-29
26331,1,0,112,0,-112
26332,1,1,393,1215,822
26333,0,0,26,0,-26
26334,0,0,26,0,-26
26335,0,0,78,0,-78
26336,1,0,0,0,0
26337,1,1,133,2121,1988
26338,0,0,55,0,-55
26339,1,0,0,0,0
26340,0,0,57,0,-57
26341,1,1,86,1913,1827
26342,0,0,27,0,-27
26343,0,0,43,0,-43
26344,1,0,7,0,-7
26345,1,1,582,1820,1238
26346,0,0,26,0,-26
26347,0,0,55,0,-55
26348,1,0,32,0,-32
26349,1,0,39,0,-39
26350,1,1,1157,1435,278
26351,0,0,108,0,-108
26352,0,0,70,0,-70
26353,0,0,6,0,-6
26354,0,0,15,0,-15
26355,1,0,10,0,-10
26356,1,0,5,0,-5
26357,1,1,65,1542,1477
26358,1,1,207,1465,1258
26359,0,0,18,0,-18
26360,1,1,1087,1299,212
26361,0,0,42,0,-42
26362,0,0,4,0,-4
26363,0,0,0,0,0
26364,1,0,11,0,-11
26365,1,0,126,0,-126
26366,0,0,46,0,-46
26367,1,0,52,0,-52
26368,1,1,31,2365,2334
26369,0,0,11,0,-11
26370,1,0,15,0,-15
26371,1,0,0,0,0
26372,1,1,1699,2141,442
26373,1,1,226,2073,1847
26374,1,1,787,1313,526
26375,0,0,92,0,-92
26376,0,0,7,0,-7
26377,0,0,13,0,-13
26378,1,0,114,0,-114
26379,0,0,88,0,-88
26380,0,0,13,0,-13
26381,1,1,147,2302,2155
26382,1,0,8,0,-8
26383,0,0,33,0,-33
26384,1,1,521,1351,830
26385,1,0,93,0,-93
26386,0,0,55,0,-55
26387,1,1,1157,1929,772
26388,0,0,33,0,-33
26389,1,0,65,0,-65
26390,0,0,144,0,-144
26391,1,0,100,0,-100
26392,0,0,82,0,-82
26393,1,0,67,0,-67
26394,0,0,129,0,-129
26395,1,1,2254,1663,-591
26396,0,0,32,0,-32
26397,1,1,647,1758,1111
26398,1,1,761,1469,708
26399,1,0,15,0,-15
26400,0,0,87,0,-87
26401,0,0,29,0,-29
26402,0,0,24,0,-24
26403,0,0,135,0,-135
26404,1,1,2842,3962,1120
26405,0,0,20,0,-20
26406,1,1,857,1338,481
26407,0,0,23,0,-23
26408,1,0,135,0,-135
26409,1,1,57,1222,1165
26410,1,1,977,1286,309
26411,1,1,499,1231,732
26412,1,1,195,1289,1094
26413,1,0,40,0,-40
26414,1,1,961,1228,267
26415,1,1,468,1603,1135
26416,0,0,44,0,-44
26417,0,0,60,0,-60
26418,1,1,369,1794,1425
26419,0,0,113,0,-113
26420,1,1,1347,2127,780
26421,1,1,282,1434,1152
26422,1,1,549,1514,965
26423,1,0,163,0,-163
26424,1,0,24,0,-24
26425,0,0,94,0,-94
26426,1,1,110,1648,1538
26427,1,1,683,1599,916
26428,1,0,0,0,0
26429,0,0,1,0,-1
26430,0,0,16,0,-16
26431,0,0,57,0,-57
26432,0,0,4,0,-4
26433,1,1,88,2768,2680
26434,0,0,44,0,-44
26435,0,0,32,0,-32
26436,1,1,722,1221,499
26437,1,0,8,0,-8
26438,1,0,54,0,-54
26439,0,0,25,0,-25
26440,1,0,176,0,-176
26441,1,0,90,0,-90
26442,1,0,11,0,-11
26443,1,1,165,1268,1103
26444,0,0,104,0,-104
26445,0,0,65,0,-65
26446,1,1,215,1363,1148
26447,1,0,34,0,-34
26448,1,1,542,1467,925
26449,1,1,422,1974,1552
26450,1,0,29,0,-29
26451,1,1,447,1992,1545
26452,1,0,57,0,-57
26453,1,0,17,0,-17
26454,1,0,38,0,-38
26455,0,0,76,0,-76
26456,1,0,14,0,-14
26457,1,1,705,1461,756
26458,1,1,101,1815,1714
26459,0,0,22,0,-22
26460,1,0,74,0,-74
26461,1,1,716,1952,1236
26462,0,0,15,0,-15
26463,1,0,19,0,-19
26464,1,0,219,0,-219
26465,0,0,10,0,-10
26466,0,0,26,0,-26
26467,0,0,40,0,-40
26468,0,0,71,0,-71
26469,1,0,0,0,0
26470,0,0,48,0,-48
26471,1,0,18,0,-18
26472,0,0,27,0,-27
26473,1,0,43,0,-43
26474,0,0,26,0,-26
26475,1,1,676,1433,757
26476,1,0,30,0,-30
26477,1,0,2,0,-2
26478,0,0,2,0,-2
26479,0,0,70,0,-70
26480,1,1,171,1488,1317
26481,0,0,96,0,-96
26482,1,1,248,1292,1044
26483,1,0,22,0,-22
26484,1,0,3,0,-3
26485,1,0,62,0,-62
26486,1,0,33,0,-33
26487,0,0,8,0,-8
26488,1,0,33,0,-33
26489,0,0,55,0,-55
26490,0,0,104,0,-104
26491,1,0,64,0,-64
26492,1,0,25,0,-25
26493,1,0,1,0,-1
26494,0,0,47,0,-47
26495,1,1,682,1277,595
26496,1,1,228,1302,1074
26497,1,0,16,0,-16
26498,1,0,65,0,-65
26499,0,0,183,0,-183
26500,1,0,62,0,-62
26501,0,0,22,0,-22
26502,0,0,46,0,-46
26503,1,0,31,0,-31
26504,1,0,42,0,-42
26505,1,0,48,0,-48
26506,1,0,56,0,-56
26507,0,0,92,0,-92
26508,1,0,28,0,-28
26509,0,0,3,0,-3
26510,0,0,1,0,-1
26511,0,0,15,0,-15
26512,1,1,745,1682,937
26513,1,1,374,1397,1023
26514,0,0,68,0,-68
26515,0,0,11,0,-11
26516,1,0,53,0,-53
26517,0,0,197,0,-197
26518,1,0,57,0,-57
26519,0,0,34,0,-34
26520,1,1,1531,1628,97
26521,1,0,31,0,-31
26522,1,1,1798,1923,125
26523,1,0,0,0,0
26524,1,0,67,0,-67
26525,1,1,829,1228,399
26526,1,0,29,0,-29
26527,0,0,73,0,-73
26528,1,0,40,0,-40
26529,1,0,18,0,-18
26530,0,0,167,0,-167
26531,1,1,507,1208,701
26532,0,0,38,0,-38
26533,0,0,25,0,-25
26534,0,0,103,0,-103
26535,1,0,34,0,-34
26536,0,0,0,0,0
26537,1,1,684,1430,746
26538,0,0,19,0,-19
26539,1,0,5,0,-5
26540,0,0,70,0,-70
26541,1,0,13,0,-13
26542,0,0,75,0,-75
26543,0,0,36,0,-36
26544,1,1,313,1326,1013
26545,1,0,102,0,-102
26546,1,0,15,0,-15
26547,1,1,1597,1328,-269
26548,1,1,72,1547,1475
26549,1,0,42,0,-42
26550,1,0,112,0,-112
26551,0,0,292,0,-292
26552,1,1,509,1421,912
26553,0,0,59,0,-59
26554,1,1,1012,1357,345
26555,1,0,31,0,-31
26556,0,0,65,0,-65
26557,0,0,199,0,-199
26558,1,1,696,1254,558
26559,1,1,2793,2321,-472
26560,1,0,18,0,-18
26561,0,0,1,0,-1
26562,0,0,31,0,-31
26563,0,0,12,0,-12
26564,0,0,27,0,-27
26565,0,0,34,0,-34
26566,1,0,92,0,-92
26567,0,0,123,0,-123
26568,0,0,82,0,-82
26569,0,0,5,0,-5
26570,1,1,861,1370,509
26571,1,0,71,0,-71
26572,0,0,17,0,-17
26573,1,0,6,0,-6
26574,1,1,207,1288,1081
26575,1,0,7,0,-7
26576,1,0,85,0,-85
26577,0,0,28,0,-28
26578,1,1,783,1467,684
26579,1,0,80,0,-80
26580,1,0,66,0,-66
26581,0,0,45,0,-45
26582,0,0,0,0,0
26583,0,0,197,0,-197
26584,0,0,132,0,-132
26585,1,0,40,0,-40
26586,1,0,26,0,-26
26587,1,1,779,1268,489
26588,1,0,22,0,-22
26589,1,1,613,1335,722
26590,0,0,23,0,-23
26591,1,1,626,1822,1196
26592,1,0,8,0,-8
26593,1,0,40,0,-40
26594,1,0,27,0,-27
26595,0,0,219,0,-219
26596,1,0,178,0,-178
26597,1,1,51,1571,1520
26598,1,0,28,0,-28
26599,0,0,1,0,-1
26600,1,0,82,0,-82
26601,0,0,49,0,-49
26602,1,1,63,1608,1545
26603,0,0,44,0,-44
26604,1,0,28,0,-28
26605,1,0,31,0,-31
26606,1,1,30,1360,1330
26607,0,0,23,0,-23
26608,0,0,23,0,-23
26609,1,1,1247,1349,102
26610,1,0,10,0,-10
26611,1,1,124,1326,1202
26612,1,1,651,2044,1393
26613,0,0,4,0,-4
26614,0,0,44,0,-44
26615,1,0,55,0,-55
26616,1,0,7,0,-7
26617,1,0,97,0,-97
26618,1,0,52,0,-52
26619,0,0,10,0,-10
26620,1,1,259,1369,1110
26621,1,0,11,0,-11
26622,0,0,1,0,-1
26623,1,0,9,0,-9
26624,1,0,5,0,-5
26625,1,0,25,0,-25
26626,1,1,277,1221,944
26627,1,1,44,1775,1731
26628,0,0,140,0,-140
26629,1,1,244,1356,1112
26630,0,0,7,0,-7
26631,1,1,635,2969,2334
26632,1,0,26,0,-26
26633,1,0,29,0,-29
26634,0,0,1,0,-1
26635,0,0,36,0,-36
26636,0,0,2,0,-2
26637,0,0,34,0,-34
26638,0,0,96,0,-96
26639,1,0,205,0,-205
26640,0,0,11,0,-11
26641,1,0,206,0,-206
26642,0,0,71,0,-71
26643,1,1,168,1412,1244
26644,0,0,24,0,-24
26645,0,0,205,0,-205
26646,1,0,64,0,-64
26647,0,0,51,0,-51
26648,1,0,4,0,-4
26649,1,0,41,0,-41
26650,1,1,38,1216,1178
26651,0,0,126,0,-126
26652,1,0,6,0,-6
26653,1,1,1486,1274,-212
26654,1,0,22,0,-22
26655,1,0,10,0,-10
26656,0,0,136,0,-136
26657,1,0,41,0,-41
26658,1,1,251,1663,1412
26659,1,0,190,0,-190
26660,0,0,89,0,-89
26661,1,0,5,0,-5
26662,1,1,69,1794,1725
26663,0,0,55,0,-55
26664,0,0,30,0,-30
26665,0,0,10,0,-10
26666,0,0,16,0,-16
26667,1,1,329,1325,996
26668,1,1,1022,2083,1061
26669,1,1,925,1383,458
26670,1,1,138,2031,1893
26671,0,0,23,0,-23
26672,0,0,13,0,-13
26673,1,1,1840,1273,-567
26674,1,1,110,1989,1879
26675,1,1,430,1590,1160
26676,1,1,222,2138,1916
26677,1,0,67,0,-67
26678,0,0,20,0,-20
26679,0,0,57,0,-57
26680,1,1,13,1663,1650
26681,0,0,76,0,-76
26682,1,1,439,1439,1000
26683,0,0,67,0,-67
26684,1,0,63,0,-63
26685,1,1,100,2312,2212
26686,1,0,39,0,-39
26687,1,0,12,0,-12
26688,0,0,10,0,-10
26689,1,0,0,0,0
26690,1,1,524,1333,809
26691,0,0,38,0,-38
26692,0,0,8,0,-8
26693,1,1,402,1440,1038
26694,1,1,295,1667,1372
26695,0,0,7,0,-7
26696,1,0,66,0,-66
26697,1,1,965,1209,244
26698,1,1,121,1568,1447
26699,1,1,214,1676,1462
26700,1,1,255,1418,1163
26701,1,0,33,0,-33
26702,1,1,163,1206,1043
26703,1,0,2,0,-2
26704,1,0,35,0,-35
26705,0,0,31,0,-31
26706,1,1,333,1339,1006
26707,1,1,166,2108,1942
26708,0,0,4,0,-4
26709,0,0,200,0,-200
26710,0,0,49,0,-49
26711,1,0,12,0,-12
26712,1,0,95,0,-95
26713,1,1,813,1990,1177
26714,0,0,153,0,-153
26715,0,0,2,0,-2
26716,0,0,16,0,-16
26717,0,0,313,0,-313
26718,1,0,18,0,-18
26719,1,0,57,0,-57
26720,0,0,36,0,-36
26721,1,1,778,2351,1573
26722,1,1,703,1672,969
26723,1,1,91,1505,1414
26724,0,0,43,0,-43
26725,1,1,66,1228,1162
26726,1,1,860,1361,501
26727,0,0,9,0,-9
26728,0,0,8,0,-8
26729,1,0,32,0,-32
26730,0,0,12,0,-12
26731,1,0,57,0,-57
26732,1,1,1500,1769,269
26733,0,0,29,0,-29
26734,1,0,6,0,-6
26735,1,0,26,0,-26
26736,0,0,37,0,-37
26737,1,1,633,1383,750
26738,1,1,288,1659,1371
26739,1,0,29,0,-29
26740,0,0,76,0,-76
26741,1,1,571,1387,816
26742,0,0,97,0,-97
26743,0,0,18,0,-18
26744,0,0,45,0,-45
26745,1,1,43,2095,2052
26746,0,0,78,0,-78
26747,0,0,73,0,-73
26748,1,0,29,0,-29
26749,1,1,33,1581,1548
26750,0,0,29,0,-29
26751,0,0,40,0,-40
26752,0,0,35,0,-35
26753,0,0,32,0,-32
26754,1,0,37,0,-37
26755,0,0,49,0,-49
26756,0,0,9,0,-9
26757,0,0,5,0,-5
26758,1,1,680,2076,1396
26759,1,1,455,1436,981
26760,1,1,767,1426,659
26761,0,0,13,0,-13
26762,1,0,4,0,-4
26763,1,1,1006,1333,327
26764,0,0,12,0,-12
26765,1,1,824,1204,380
26766,0,0,182,0,-182
26767,1,1,19,2471,2452
26768,1,1,193,1320,1127
26769,0,0,82,0,-82
26770,1,1,212,1646,1434
26771,0,0,5,0,-5
26772,0,0,6,0,-6
26773,1,1,181,1630,1449
26774,0,0,22,0,-22
26775,0,0,23,0,-23
26776,0,0,93,0,-93
26777,0,0,13,0,-13
26778,1,1,68,1202,1134
26779,1,1,431,1234,803
26780,1,1,905,2046,1141
26781,1,1,14,1203,1189
26782,1,1,26,1362,1336
26783,1,1,448,1296,848
26784,1,0,15,0,-15
26785,1,1,143,1287,1144
26786,1,0,12,0,-12
26787,1,0,70,0,-70
26788,1,0,74,0,-74
26789,0,0,5,0,-5
26790,0,0,25,0,-25
26791,1,1,618,1347,729
26792,1,1,113,1733,1620
26793,1,0,10,0,-10
26794,1,0,19,0,-19
26795,1,1,401,1736,1335
26796,1,1,1247,1260,13
26797,1,1,1042,1605,563
26798,1,1,1139,1728,589
26799,1,1,114,2021,1907
26800,0,0,16,0,-16
26801,0,0,49,0,-49
26802,0,0,25,0,-25
26803,1,0,55,0,-55
26804,1,1,290,1592,1302
26805,1,0,13,0,-13
26806,1,0,96,0,-96
26807,0,0,16,0,-16
26808,0,0,26,0,-26
26809,1,0,7,0,-7
26810,1,1,260,1905,1645
26811,1,0,1,0,-1
26812,0,0,13,0,-13
26813,1,0,168,0,-168
26814,0,0,13,0,-13
26815,0,0,19,0,-19
26816,1,1,301,1232,931
26817,1,0,70,0,-70
26818,0,0,91,0,-91
26819,0,0,131,0,-131
26820,1,0,44,0,-44
26821,1,1,483,1383,900
26822,1,1,1394,1434,40
26823,0,0,13,0,-13
26824,1,1,421,1369,948
26825,1,0,20,0,-20
26826,1,0,0,0,0
26827,0,0,74,0,-74
26828,1,0,125,0,-125
26829,1,0,11,0,-11
26830,1,0,3,0,-3
26831,1,0,34,0,-34
26832,0,0,26,0,-26
26833,1,0,4,0,-4
26834,1,1,25,1412,1387
26835,0,0,5,0,-5
26836,0,0,23,0,-23
26837,1,1,294,1819,1525
26838,0,0,6,0,-6
26839,0,0,127,0,-127
26840,1,1,87,1657,1570
26841,1,1,164,1425,1261
26842,1,1,2164,1203,-961
26843,0,0,45,0,-45
26844,1,0,93,0,-93
26845,0,0,9,0,-9
26846,1,0,12,0,-12
26847,1,0,36,0,-36
26848,0,0,0,0,0
26849,1,0,24,0,-24
26850,1,1,1393,1284,-109
26851,1,0,52,0,-52
26852,0,0,15,0,-15
26853,1,1,256,1465,1209
26854,0,0,157,0,-157
26855,0,0,28,0,-28
26856,0,0,202,0,-202
26857,0,0,55,0,-55
26858,0,0,37,0,-37
26859,1,1,238,1807,1569
26860,1,0,108,0,-108
26861,0,0,89,0,-89
26862,0,0,29,0,-29
26863,1,1,730,1988,1258
26864,0,0,74,0,-74
26865,1,0,10,0,-10
26866,1,0,2,0,-2
26867,1,1,611,1854,1243
26868,0,0,108,0,-108
26869,1,0,10,0,-10
26870,1,1,44,1832,1788
26871,1,0,0,0,0
26872,1,1,239,1489,1250
26873,0,0,2,0,-2
26874,1,1,357,1378,1021
26875,0,0,45,0,-45
26876,1,0,41,0,-41
26877,0,0,41,0,-41
26878,1,0,20,0,-20
26879,0,0,247,0,-247
26880,1,0,58,0,-58
26881,0,0,115,0,-115
26882,1,1,1590,1289,-301
26883,1,1,184,1755,1571
26884,1,0,9,0,-9
26885,0,0,84,0,-84
26886,0,0,45,0,-45
26887,1,0,12,0,-12
26888,1,1,679,1379,700
26889,0,0,289,0,-289
26890,1,0,0,0,0
26891,1,0,161,0,-161
26892,1,1,504,1380,876
26893,0,0,150,0,-150
26894,0,0,19,0,-19
26895,1,1,1181,1697,516
26896,0,0,18,0,-18
26897,1,1,72,1280,1208
26898,1,1,137,1812,1675
26899,0,0,23,0,-23
26900,1,1,255,1307,1052
26901,0,0,20,0,-20
26902,1,0,86,0,-86
26903,0,0,15,0,-15
26904,0,0,106,0,-106
26905,1,1,520,1331,811
26906,1,0,54,0,-54
26907,1,0,7,0,-7
26908,0,0,0,0,0
26909,1,0,20,0,-20
26910,0,0,89,0,-89
26911,1,1,1479,1212,-267
26912,1,1,81,2720,2639
26913,1,1,642,1215,573
26914,1,1,136,3141,3005
26915,1,1,908,2722,1814
26916,1,1,816,1330,514
26917,1,0,111,0,-111
26918,0,0,85,0,-85
26919,1,1,1086,1319,233
26920,1,0,86,0,-86
26921,1,1,625,1577,952
26922,1,0,39,0,-39
26923,1,0,110,0,-110
26924,1,1,944,1201,257
26925,1,1,107,1222,1115
26926,1,1,577,1339,762
26927,0,0,56,0,-56
26928,0,0,3,0,-3
26929,1,0,53,0,-53
26930,1,1,573,1269,696
26931,0,0,5,0,-5
26932,1,0,77,0,-77
26933,1,1,737,2064,1327
26934,1,0,6,0,-6
26935,1,0,50,0,-50
26936,0,0,30,0,-30
26937,1,1,141,1230,1089
26938,0,0,86,0,-86
26939,0,0,21,0,-21
26940,0,0,14,0,-14
26941,0,0,30,0,-30
26942,0,0,81,0,-81
26943,1,1,384,1487,1103
26944,1,1,660,1570,910
26945,1,0,12,0,-12
26946,0,0,12,0,-12
26947,1,1,613,1306,693
26948,1,1,254,1333,1079
26949,1,1,708,1541,833
26950,1,1,357,1322,965
26951,0,0,74,0,-74
26952,1,0,9,0,-9
26953,1,0,113,0,-113
26954,1,1,196,1549,1353
26955,0,0,13,0,-13
26956,0,0,5,0,-5
26957,0,0,39,0,-39
26958,1,1,468,1423,955
26959,1,0,72,0,-72
26960,1,1,1291,1770,479
26961,1,0,12,0,-12
26962,0,0,30,0,-30
26963,1,1,205,2109,1904
26964,1,1,610,1409,799
26965,1,0,12,0,-12
26966,1,0,23,0,-23
26967,0,0,50,0,-50
26968,1,1,76,1505,1429
26969,1,0,80,0,-80
26970,0,0,4,0,-4
26971,1,1,659,1309,650
26972,1,1,382,2150,1768
26973,1,0,58,0,-58
26974,1,0,36,0,-36
26975,0,0,16,0,-16
26976,1,1,391,1384,993
26977,1,1,1022,1670,648
26978,0,0,4,0,-4
26979,1,0,63,0,-63
26980,1,0,1,0,-1
26981,1,0,141,0,-141
26982,0,0,146,0,-146
26983,1,0,2,0,-2
26984,1,0,6,0,-6
26985,1,1,830,1237,407
26986,1,1,682,1446,764
26987,0,0,50,0,-50
26988,0,0,175,0,-175
26989,1,0,21,0,-21
26990,0,0,2,0,-2
26991,1,0,12,0,-12
26992,0,0,103,0,-103
26993,1,1,706,1499,793
26994,1,0,23,0,-23
26995,1,0,5,0,-5
26996,0,0,19,0,-19
26997,1,1,553,1589,1036
26998,1,1,1281,1768,487
26999,1,1,871,2419,1548
27000,0,0,69,0,-69
27001,1,0,95,0,-95
27002,0,0,62,0,-62
27003,1,1,362,1336,974
27004,1,1,225,1449,1224
27005,1,1,405,1548,1143
27006,1,0,1,0,-1
27007,1,1,238,3456,3218
27008,1,1,1263,1221,-42
27009,1,1,1195,1203,8
27010,1,1,1161,1401,240
27011,1,1,172,2153,1981
27012,1,0,82,0,-82
27013,0,0,1,0,-1
27014,0,0,45,0,-45
27015,1,1,682,1234,552
27016,1,1,292,1564,1272
27017,1,0,4,0,-4
27018,1,1,307,1224,917
27019,1,1,20,1325,1305
27020,0,0,32,0,-32
27021,1,0,27,0,-27
27022,1,0,24,0,-24
27023,1,0,26,0,-26
27024,0,0,82,0,-82
27025,0,0,10,0,-10
27026,1,0,3,0,-3
27027,1,1,467,1883,1416
27028,1,1,77,1264,1187
27029,1,1,766,1216,450
27030,1,1,55,1309,1254
27031,1,1,223,1519,1296
27032,1,0,17,0,-17
27033,0,0,119,0,-119
27034,0,0,20,0,-20
27035,0,0,18,0,-18
27036,0,0,36,0,-36
27037,0,0,27,0,-27
27038,0,0,95,0,-95
27039,1,0,11,0,-11
27040,0,0,74,0,-74
27041,1,1,174,1479,1305
27042,1,0,91,0,-91
27043,1,1,440,2020,1580
27044,0,0,2,0,-2
27045,0,0,4,0,-4
27046,1,1,498,1539,1041
27047,1,0,39,0,-39
27048,1,1,821,1468,647
27049,0,0,10,0,-10
27050,0,0,111,0,-111
27051,1,1,459,1213,754
27052,0,0,133,0,-133
27053,1,1,742,1627,885
27054,0,0,1,0,-1
27055,0,0,13,0,-13
27056,0,0,12,0,-12
27057,1,1,895,1465,570
27058,0,0,91,0,-91
27059,1,0,61,0,-61
27060,1,1,614,1336,722
27061,0,0,18,0,-18
27062,1,0,7,0,-7
27063,1,1,497,1209,712
27064,1,0,11,0,-11
27065,1,0,31,0,-31
27066,0,0,22,0,-22
27067,1,0,0,0,0
27068,1,1,713,1326,613
27069,0,0,43,0,-43
27070,1,0,24,0,-24
27071,1,0,37,0,-37
27072,1,0,20,0,-20
27073,1,0,5,0,-5
27074,0,0,75,0,-75
27075,0,0,42,0,-42
27076,0,0,41,0,-41
27077,0,0,34,0,-34
27078,0,0,41,0,-41
27079,1,1,1003,1232,229
27080,1,0,1,0,-1
27081,1,0,145,0,-145
27082,1,0,19,0,-19
27083,1,1,318,1311,993
27084,1,0,1,0,-1
27085,1,0,41,0,-41
27086,1,0,39,0,-39
27087,1,1,804,1223,419
27088,1,0,17,0,-17
27089,1,0,22,0,-22
27090,1,0,22,0,-22
27091,1,1,156,1287,1131
27092,0,0,17,0,-17
27093,1,0,7,0,-7
27094,1,0,45,0,-45
27095,0,0,2,0,-2
27096,0,0,10,0,-10
27097,1,0,46,0,-46
27098,1,0,78,0,-78
27099,1,1,1368,1278,-90
27100,1,1,1294,2074,780
27101,1,1,170,1753,1583
27102,0,0,57,0,-57
27103,0,0,108,0,-108
27104,0,0,9,0,-9
27105,0,0,73,0,-73
27106,1,0,2,0,-2
27107,0,0,8,0,-8
27108,1,1,594,1309,715
27109,0,0,81,0,-81
27110,1,1,162,1342,1180
27111,1,0,8,0,-8
27112,1,1,480,1865,1385
27113,1,1,921,1218,297
27114,1,0,18,0,-18
27115,0,0,26,0,-26
27116,1,0,4,0,-4
27117,0,0,22,0,-22
27118,0,0,76,0,-76
27119,0,0,73,0,-73
27120,0,0,69,0,-69
27121,1,0,102,0,-102
27122,1,1,1785,1421,-364
27123,1,1,1036,1388,352
27124,0,0,6,0,-6
27125,1,1,265,1347,1082
27126,1,1,269,1626,1357
27127,0,0,22,0,-22
27128,1,0,39,0,-39
27129,1,1,190,1668,1478
27130,0,0,43,0,-43
27131,1,0,38,0,-38
27132,1,0,39,0,-39
27133,0,0,76,0,-76
27134,1,0,71,0,-71
27135,1,0,99,0,-99
27136,0,0,50,0,-50
27137,0,0,20,0,-20
27138,1,0,62,0,-62
27139,0,0,55,0,-55
27140,1,0,53,0,-53
27141,1,0,77,0,-77
27142,1,0,47,0,-47
27143,1,1,454,1201,747
27144,1,1,229,1299,1070
27145,1,0,11,0,-11
27146,1,1,49,1436,1387
27147,0,0,54,0,-54
27148,0,0,58,0,-58
27149,0,0,9,0,-9
27150,0,0,55,0,-55
27151,1,1,284,1218,934
27152,1,1,1130,1273,143
27153,0,0,35,0,-35
27154,0,0,103,0,-103
27155,0,0,131,0,-131
27156,0,0,91,0,-91
27157,0,0,44,0,-44
27158,1,0,27,0,-27
27159,1,1,1130,1289,159
27160,1,1,289,1507,1218
27161,1,0,120,0,-120
27162,0,0,92,0,-92
27163,1,1,1400,1232,-168
27164,0,0,5,0,-5
27165,0,0,44,0,-44
27166,0,0,5,0,-5
27167,1,0,21,0,-21
27168,1,1,713,1397,684
27169,0,0,142,0,-142
27170,1,0,17,0,-17
27171,0,0,17,0,-17
27172,1,0,13,0,-13
27173,0,0,67,0,-67
27174,0,0,18,0,-18
27175,1,1,231,1610,1379
27176,0,0,7,0,-7
27177,0,0,40,0,-40
27178,1,0,18,0,-18
27179,1,0,49,0,-49
27180,0,0,155,0,-155
27181,0,0,25,0,-25
27182,0,0,12,0,-12
27183,0,0,9,0,-9
27184,1,1,384,1306,922
27185,1,1,54,2464,2410
27186,0,0,24,0,-24
27187,0,0,22,0,-22
27188,0,0,9,0,-9
27189,0,0,57,0,-57
27190,0,0,1,0,-1
27191,1,0,63,0,-63
27192,1,1,52,1547,1495
27193,1,0,18,0,-18
27194,0,0,76,0,-76
27195,1,1,55,1203,1148
27196,0,0,0,0,0
27197,1,1,98,1439,1341
27198,1,0,2,0,-2
27199,0,0,18,0,-18
27200,0,0,29,0,-29
27201,0,0,37,0,-37
27202,0,0,3,0,-3
27203,0,0,47,0,-47
27204,1,1,488,1260,772
27205,1,1,710,1221,511
27206,1,0,42,0,-42
27207,1,1,164,1599,1435
27208,0,0,43,0,-43
27209,0,0,31,0,-31
27210,1,0,20,0,-20
27211,0,0,16,0,-16
27212,1,1,355,1600,1245
27213,0,0,9,0,-9
27214,0,0,47,0,-47
27215,1,1,454,2159,1705
27216,1,1,824,2711,1887
27217,0,0,2,0,-2
27218,1,0,216,0,-216
27219,1,0,47,0,-47
27220,1,0,93,0,-93
27221,1,1,579,1220,641
27222,1,1,363,2698,2335
27223,0,0,59,0,-59
27224,1,1,283,1651,1368
27225,1,0,93,0,-93
27226,1,1,221,1688,1467
27227,0,0,18,0,-18
27228,1,0,5,0,-5
27229,1,1,513,1278,765
27230,1,1,490,1201,711
27231,1,1,193,1267,1074
27232,1,1,132,1517,1385
27233,1,0,9,0,-9
27234,1,1,1393,1328,-65
27235,1,0,92,0,-92
27236,1,0,7,0,-7
27237,1,1,977,2070,1093
27238,1,0,14,0,-14
27239,0,0,62,0,-62
27240,0,0,46,0,-46
27241,0,0,17,0,-17
27242,1,1,438,1300,862
27243,0,0,221,0,-221
27244,0,0,76,0,-76
27245,0,0,172,0,-172
27246,1,0,23,0,-23
27247,1,0,5,0,-5
27248,1,0,158,0,-158
27249,1,0,156,0,-156
27250,0,0,17,0,-17
27251,1,0,84,0,-84
27252,0,0,10,0,-10
27253,1,1,678,2054,1376
27254,0,0,85,0,-85
27255,0,0,112,0,-112
27256,1,1,1318,1258,-60
27257,0,0,5,0,-5
27258,1,0,43,0,-43
27259,0,0,10,0,-10
27260,0,0,118,0,-118
27261,0,0,22,0,-22
27262,1,0,105,0,-105
27263,1,1,184,1850,1666
27264,0,0,17,0,-17
27265,1,1,49,1842,1793
27266,1,0,41,0,-41
27267,1,0,93,0,-93
27268,1,1,414,1270,856
27269,0,0,8,0,-8
27270,0,0,101,0,-101
27271,0,0,17,0,-17
27272,1,1,172,1597,1425
27273,0,0,24,0,-24
27274,0,0,185,0,-185
27275,1,0,201,0,-201
27276,1,0,54,0,-54
27277,0,0,19,0,-19
27278,1,1,1300,2331,1031
27279,1,1,274,1344,1070
27280,1,0,21,0,-21
27281,1,1,467,1375,908
27282,0,0,63,0,-63
27283,1,1,827,1797,970
27284,0,0,85,0,-85
27285,1,0,52,0,-52
27286,0,0,166,0,-166
27287,1,0,21,0,-21
27288,0,0,4,0,-4
27289,1,0,37,0,-37
27290,1,1,400,1268,868
27291,0,0,52,0,-52
27292,1,1,1296,1378,82
27293,1,1,90,1576,1486
27294,0,0,22,0,-22
27295,1,0,64,0,-64
27296,0,0,3,0,-3
27297,0,0,79,0,-79
27298,1,0,57,0,-57
27299,1,0,37,0,-37
27300,0,0,4,0,-4
27301,1,1,702,2211,1509
27302,1,1,746,2131,1385
27303,1,0,58,0,-58
27304,0,0,2,0,-2
27305,1,0,48,0,-48
27306,1,1,361,1219,858
27307,1,1,980,1244,264
27308,1,1,222,1266,1044
27309,0,0,10,0,-10
27310,0,0,143,0,-143
27311,0,0,92,0,-92
27312,0,0,10,0,-10
27313,1,1,1056,1780,724
27314,1,0,124,0,-124
27315,1,1,447,1654,1207
27316,1,1,969,2561,1592
27317,1,1,290,1711,1421
27318,0,0,11,0,-11
27319,1,0,122,0,-122
27320,1,0,23,0,-23
27321,1,0,77,0,-77
27322,0,0,7,0,-7
27323,1,0,10,0,-10
27324,1,0,30,0,-30
27325,1,1,566,3806,3240
27326,1,1,383,1222,839
27327,1,0,110,0,-110
27328,0,0,6,0,-6
27329,1,1,150,2650,2500
27330,1,1,577,1409,832
27331,0,0,47,0,-47
27332,1,1,1776,1264,-512
27333,1,0,31,0,-31
27334,1,1,1900,1575,-325
27335,0,0,39,0,-39
27336,1,1,220,1277,1057
27337,0,0,7,0,-7
27338,0,0,6,0,-6
27339,1,0,45,0,-45
27340,1,0,87,0,-87
27341,1,0,62,0,-62
27342,0,0,38,0,-38
27343,1,0,116,0,-116
27344,0,0,47,0,-47
27345,1,0,28,0,-28
27346,0,0,19,0,-19
27347,0,0,96,0,-96
27348,0,0,37,0,-37
27349,0,0,136,0,-136
27350,0,0,3,0,-3
27351,0,0,103,0,-103
27352,1,0,17,0,-17
27353,0,0,18,0,-18
27354,1,0,171,0,-171
27355,1,1,598,1812,1214
27356,1,0,33,0,-33
27357,0,0,49,0,-49
27358,1,0,44,0,-44
27359,1,0,20,0,-20
27360,1,1,52,1222,1170
27361,1,0,36,0,-36
27362,0,0,110,0,-110
27363,1,1,493,1613,1120
27364,0,0,10,0,-10
27365,0,0,49,0,-49
27366,0,0,38,0,-38
27367,0,0,33,0,-33
27368,1,1,95,2656,2561
27369,1,0,5,0,-5
27370,0,0,12,0,-12
27371,1,0,26,0,-26
27372,0,0,76,0,-76
27373,1,0,17,0,-17
27374,1,0,66,0,-66
27375,0,0,113,0,-113
27376,1,0,24,0,-24
27377,0,0,56,0,-56
27378,0,0,111,0,-111
27379,0,0,8,0,-8
27380,0,0,55,0,-55
27381,0,0,66,0,-66
27382,1,0,47,0,-47
27383,1,0,97,0,-97
27384,1,0,82,0,-82
27385,0,0,37,0,-37
27386,0,0,57,0,-57
27387,0,0,22,0,-22
27388,0,0,174,0,-174
27389,0,0,0,0,0
27390,0,0,31,0,-31
27391,1,1,246,1984,1738
27392,1,1,404,1341,937
27393,0,0,45,0,-45
27394,0,0,28,0,-28
27395,1,0,1,0,-1
27396,1,1,208,1213,1005
27397,1,0,60,0,-60
27398,0,0,26,0,-26
27399,1,0,55,0,-55
27400,1,1,40,1348,1308
27401,1,0,75,0,-75
27402,0,0,61,0,-61
27403,1,0,89,0,-89
27404,1,0,87,0,-87
27405,0,0,15,0,-15
27406,1,1,522,1413,891
27407,1,1,115,1379,1264
27408,1,0,47,0,-47
27409,0,0,117,0,-117
27410,0,0,13,0,-13
27411,0,0,21,0,-21
27412,1,0,3,0,-3
27413,0,0,32,0,-32
27414,1,1,1194,1408,214
27415,1,0,55,0,-55
27416,0,0,38,0,-38
27417,1,1,1594,1264,-330
27418,0,0,118,0,-118
27419,0,0,50,0,-50
27420,0,0,67,0,-67
27421,0,0,40,0,-40
27422,1,1,1385,1367,-18
27423,1,1,536,1234,698
27424,1,1,890,2051,1161
27425,1,0,73,0,-73
27426,1,1,462,1690,1228
27427,1,0,104,0,-104
27428,1,0,40,0,-40
27429,1,0,77,0,-77
27430,1,0,76,0,-76
27431,1,1,834,1365,531
27432,1,0,30,0,-30
27433,1,1,660,1221,561
27434,1,1,405,1349,944
27435,1,0,41,0,-41
27436,1,1,39,1806,1767
27437,1,1,178,1834,1656
27438,1,1,224,2193,1969
27439,0,0,5,0,-5
27440,1,1,42,2183,2141
27441,1,0,0,0,0
27442,1,0,53,0,-53
27443,0,0,2,0,-2
27444,0,0,32,0,-32
27445,0,0,38,0,-38
27446,0,0,150,0,-150
27447,1,0,8,0,-8
27448,1,0,50,0,-50
27449,0,0,12,0,-12
27450,1,1,159,1279,1120
27451,0,0,3,0,-3
27452,1,0,66,0,-66
27453,1,0,5,0,-5
27454,1,0,21,0,-21
27455,0,0,17,0,-17
27456,0,0,0,0,0
27457,0,0,92,0,-92
27458,1,0,20,0,-20
27459,0,0,11,0,-11
27460,1,0,124,0,-124
27461,0,0,142,0,-142
27462,1,0,100,0,-100
27463,1,1,553,1470,917
27464,0,0,121,0,-121
27465,1,0,186,0,-186
27466,0,0,70,0,-70
27467,1,0,87,0,-87
27468,0,0,59,0,-59
27469,1,1,0,1938,1938
27470,1,1,674,1407,733
27471,1,1,69,1432,1363
27472,1,1,50,1412,1362
27473,0,0,13,0,-13
27474,0,0,15,0,-15
27475,1,1,83,1302,1219
27476,0,0,78,0,-78
27477,1,1,101,1256,1155
27478,1,1,758,1441,683
27479,1,0,105,0,-105
27480,1,0,7,0,-7
27481,1,0,13,0,-13
27482,1,1,542,1469,927
27483,1,0,8,0,-8
27484,1,1,113,1299,1186
27485,1,0,21,0,-21
27486,1,0,9,0,-9
27487,1,1,975,1692,717
27488,1,1,289,1355,1066
27489,1,0,3,0,-3
27490,0,0,15,0,-15
27491,1,0,27,0,-27
27492,1,0,31,0,-31
27493,1,0,33,0,-33
27494,1,1,825,2823,1998
27495,1,0,30,0,-30
27496,1,1,311,5559,5248
27497,1,0,0,0,0
27498,0,0,6,0,-6
27499,1,1,648,2664,2016
27500,0,0,61,0,-61
27501,0,0,7,0,-7
27502,0,0,6,0,-6
27503,1,1,237,1224,987
27504,1,1,84,2141,2057
27505,1,1,224,1310,1086
27506,0,0,313,0,-313
27507,1,0,44,0,-44
27508,1,1,246,1403,1157
27509,1,0,87,0,-87
27510,1,1,93,1247,1154
27511,0,0,113,0,-113
27512,1,1,334,1289,955
27513,0,0,18,0,-18
27514,0,0,25,0,-25
27515,0,0,7,0,-7
27516,1,1,389,1594,1205
27517,0,0,146,0,-146
27518,0,0,12,0,-12
27519,1,0,25,0,-25
27520,1,0,17,0,-17
27521,0,0,34,0,-34
27522,0,0,31,0,-31
27523,0,0,7,0,-7
27524,1,1,584,1391,807
27525,1,1,1331,1998,667
27526,1,0,39,0,-39
27527,0,0,29,0,-29
27528,1,0,2,0,-2
27529,1,1,184,2018,1834
27530,1,1,376,2667,2291
27531,0,0,110,0,-110
27532,1,1,964,2018,1054
27533,1,0,2,0,-2
27534,0,0,13,0,-13
27535,0,0,58,0,-58
27536,1,1,53,1338,1285
27537,1,0,53,0,-53
27538,1,1,190,1756,1566
27539,0,0,31,0,-31
27540,1,0,66,0,-66
27541,1,1,642,3177,2535
27542,1,1,165,1406,1241
27543,1,1,365,1897,1532
27544,1,1,180,1301,1121
27545,1,1,73,1208,1135
27546,0,0,26,0,-26
27547,1,1,1162,1353,191
27548,1,1,272,1337,1065
27549,0,0,37,0,-37
27550,0,0,4,0,-4
27551,1,0,83,0,-83
27552,1,0,40,0,-40
27553,1,1,365,2749,2384
27554,1,0,37,0,-37
27555,0,0,28,0,-28
27556,0,0,52,0,-52
27557,0,0,98,0,-98
27558,1,1,96,1379,1283
27559,1,1,1090,1630,540
27560,1,1,172,1201,1029
27561,0,0,30,0,-30
27562,0,0,7,0,-7
27563,1,1,254,1392,1138
27564,0,0,11,0,-11
27565,0,0,55,0,-55
27566,1,1,498,1747,1249
27567,1,1,2179,1706,-473
27568,0,0,12,0,-12
27569,1,0,13,0,-13
27570,1,1,83,1262,1179
27571,0,0,91,0,-91
27572,1,0,79,0,-79
27573,1,1,315,1578,1263
27574,1,1,235,2069,1834
27575,1,1,741,1202,461
27576,1,1,272,2977,2705
27577,1,0,17,0,-17
27578,1,1,364,1675,1311
27579,0,0,43,0,-43
27580,1,0,163,0,-163
27581,1,0,27,0,-27
27582,0,0,41,0,-41
27583,1,0,99,0,-99
27584,0,0,91,0,-91
27585,1,0,34,0,-34
27586,0,0,37,0,-37
27587,1,1,1023,1565,542
27588,1,0,47,0,-47
27589,0,0,118,0,-118
27590,1,0,103,0,-103
27591,1,1,43,1941,1898
27592,0,0,15,0,-15
27593,0,0,22,0,-22
27594,1,0,54,0,-54
27595,0,0,73,0,-73
27596,1,0,6,0,-6
27597,1,1,239,1368,1129
27598,0,0,55,0,-55
27599,1,0,20,0,-20
27600,1,0,146,0,-146
27601,0,0,31,0,-31
27602,1,0,11,0,-11
27603,1,1,1734,1374,-360
27604,0,0,49,0,-49
27605,0,0,43,0,-43
27606,1,1,510,1376,866
27607,0,0,25,0,-25
27608,1,0,41,0,-41
27609,1,1,462,1236,774
27610,0,0,144,0,-144
27611,1,0,5,0,-5
27612,0,0,76,0,-76
27613,0,0,9,0,-9
27614,1,1,488,1487,999
27615,0,0,13,0,-13
27616,0,0,146,0,-146
27617,1,0,92,0,-92
27618,0,0,17,0,-17
27619,0,0,60,0,-60
27620,0,0,22,0,-22
27621,1,1,284,3345,3061
27622,1,1,1899,1854,-45
27623,0,0,119,0,-119
27624,0,0,70,0,-70
27625,0,0,86,0,-86
27626,0,0,60,0,-60
27627,1,0,7,0,-7
27628,0,0,17,0,-17
27629,1,1,86,1514,1428
27630,0,0,62,0,-62
27631,0,0,28,0,-28
27632,1,0,60,0,-60
27633,1,0,39,0,-39
27634,1,0,31,0,-31
27635,0,0,15,0,-15
27636,0,0,15,0,-15
27637,1,0,95,0,-95
27638,1,0,69,0,-69
27639,1,1,511,1209,698
27640,1,0,20,0,-20
27641,1,1,1773,1743,-30
27642,1,1,1431,1633,202
27643,1,0,32,0,-32
27644,0,0,9,0,-9
