ID,Флаг дозвона,Флаг продажи,Расходы,PV,NPV
0,0,0,27,0,-27
1,1,0,44,0,-44
2,0,0,109,0,-109
3,1,0,7,0,-7
4,1,1,252,1469,1217
5,0,0,2,0,-2
6,1,0,4,0,-4
7,1,0,35,0,-35
8,1,1,616,1377,761
9,0,0,46,0,-46
10,1,1,422,1314,892
11,1,1,235,2993,2758
12,0,0,13,0,-13
13,0,0,4,0,-4
14,1,1,89,1491,1402
15,0,0,76,0,-76
16,0,0,223,0,-223
17,1,1,20,1528,1508
18,0,0,13,0,-13
19,0,0,27,0,-27
20,0,0,12,0,-12
21,1,1,1247,1760,513
22,1,0,17,0,-17
23,1,1,269,2141,1872
24,0,0,25,0,-25
25,1,0,18,0,-18
26,0,0,8,0,-8
27,1,1,1129,1552,423
28,1,0,0,0,0
29,1,0,10,0,-10
30,0,0,60,0,-60
31,1,1,1004,2023,1019
32,0,0,55,0,-55
33,0,0,56,0,-56
34,1,1,75,1616,1541
35,1,1,1442,1583,141
36,1,0,10,0,-10
37,0,0,30,0,-30
38,1,1,135,2166,2031
39,0,0,36,0,-36
40,1,1,293,1621,1328
41,0,0,15,0,-15
42,1,0,46,0,-46
43,1,1,295,1320,1025
44,0,0,27,0,-27
45,1,0,30,0,-30
46,1,0,26,0,-26
47,1,0,0,0,0
48,0,0,12,0,-12
49,1,0,190,0,-190
50,0,0,25,0,-25
51,1,0,48,0,-48
52,1,1,530,1292,762
53,0,0,2,0,-2
54,0,0,98,0,-98
55,0,0,10,0,-10
56,1,1,1258,1402,144
57,0,0,10,0,-10
58,1,1,276,4244,3968
59,1,1,212,1876,1664
60,1,0,11,0,-11
61,1,0,1,0,-1
62,1,1,71,1252,1181
63,1,0,17,0,-17
64,1,0,34,0,-34
65,1,0,18,0,-18
66,0,0,47,0,-47
67,0,0,52,0,-52
68,1,0,103,0,-103
69,0,0,165,0,-165
70,0,0,138,0,-138
71,1,0,51,0,-51
72,1,0,69,0,-69
73,0,0,15,0,-15
74,1,1,536,1525,989
75,0,0,31,0,-31
76,1,0,25,0,-25
77,1,1,531,2107,1576
78,0,0,116,0,-116
79,1,0,77,0,-77
80,1,0,89,0,-89
81,1,0,17,0,-17
82,1,1,230,1640,1410
83,1,0,61,0,-61
84,1,0,37,0,-37
85,1,1,741,1301,560
86,0,0,21,0,-21
87,1,1,1219,1231,12
88,1,1,652,1401,749
89,1,1,3692,1617,-2075
90,0,0,16,0,-16
91,1,1,1192,1597,405
92,1,0,33,0,-33
93,0,0,49,0,-49
94,1,0,56,0,-56
95,0,0,76,0,-76
96,1,0,6,0,-6
97,0,0,51,0,-51
98,0,0,46,0,-46
99,1,0,53,0,-53
100,0,0,15,0,-15
101,1,0,2,0,-2
102,1,0,2,0,-2
103,0,0,11,0,-11
104,1,0,99,0,-99
105,0,0,34,0,-34
106,1,0,53,0,-53
107,1,0,50,0,-50
108,1,0,5,0,-5
109,0,0,9,0,-9
110,0,0,11,0,-11
111,0,0,100,0,-100
112,1,1,159,1331,1172
113,1,0,55,0,-55
114,0,0,61,0,-61
115,1,1,337,1415,1078
116,0,0,42,0,-42
117,0,0,74,0,-74
118,1,0,132,0,-132
119,1,0,42,0,-42
120,0,0,273,0,-273
121,1,0,30,0,-30
122,0,0,46,0,-46
123,1,0,83,0,-83
124,0,0,57,0,-57
125,1,0,57,0,-57
126,1,1,506,2331,1825
127,1,1,73,1569,1496
128,1,0,1,0,-1
129,0,0,26,0,-26
130,1,1,2010,1438,-572
131,1,0,12,0,-12
132,0,0,57,0,-57
133,1,0,51,0,-51
134,1,0,25,0,-25
135,1,0,22,0,-22
136,1,1,561,1302,741
137,0,0,65,0,-65
138,1,1,406,1266,860
139,1,1,665,1218,553
140,1,0,97,0,-97
141,1,1,1040,2128,1088
142,1,1,191,1957,1766
143,1,1,201,1300,1099
144,0,0,7,0,-7
145,1,1,297,2298,2001
146,1,0,41,0,-41
147,1,1,1212,2359,1147
148,0,0,6,0,-6
149,0,0,23,0,-23
150,1,0,17,0,-17
151,1,0,30,0,-30
152,0,0,69,0,-69
153,0,0,101,0,-101
154,1,1,175,1235,1060
155,1,1,593,1375,782
156,0,0,27,0,-27
157,1,1,55,1328,1273
158,0,0,113,0,-113
159,1,1,1295,1341,46
160,1,1,610,1268,658
161,1,0,14,0,-14
162,1,0,233,0,-233
163,1,0,8,0,-8
164,1,0,26,0,-26
165,1,1,39,1304,1265
166,0,0,45,0,-45
167,0,0,20,0,-20
168,1,0,21,0,-21
169,1,0,14,0,-14
170,0,0,46,0,-46
171,1,1,279,1326,1047
172,1,0,77,0,-77
173,1,1,1022,1420,398
174,1,0,10,0,-10
175,0,0,32,0,-32
176,1,1,517,1370,853
177,0,0,2,0,-2
178,1,0,57,0,-57
179,1,1,675,1718,1043
180,1,0,6,0,-6
181,1,0,59,0,-59
182,0,0,78,0,-78
183,1,1,1419,1554,135
184,1,1,364,1314,950
185,0,0,0,0,0
186,0,0,11,0,-11
187,0,0,96,0,-96
188,0,0,155,0,-155
189,1,0,56,0,-56
190,1,1,1272,1227,-45
191,1,0,3,0,-3
192,0,0,40,0,-40
193,1,1,714,1242,528
194,1,0,56,0,-56
195,1,1,384,2064,1680
196,0,0,22,0,-22
197,0,0,17,0,-17
198,1,1,212,2130,1918
199,0,0,35,0,-35
200,1,1,21,1330,1309
201,0,0,18,0,-18
202,1,0,33,0,-33
203,1,0,211,0,-211
204,0,0,73,0,-73
205,1,1,306,1235,929
206,0,0,32,0,-32
207,0,0,28,0,-28
208,0,0,38,0,-38
209,0,0,34,0,-34
210,0,0,122,0,-122
211,0,0,43,0,-43
212,0,0,79,0,-79
213,0,0,233,0,-233
214,1,0,104,0,-104
215,1,0,56,0,-56
216,1,1,419,1512,1093
217,0,0,24,0,-24
218,0,0,25,0,-25
219,0,0,58,0,-58
220,0,0,67,0,-67
221,1,1,432,2010,1578
222,1,1,295,1630,1335
223,1,0,0,0,0
224,1,0,17,0,-17
225,0,0,13,0,-13
226,1,1,642,1353,711
227,0,0,12,0,-12
228,1,1,191,1249,1058
229,1,1,471,1611,1140
230,0,0,11,0,-11
231,1,1,484,1239,755
232,0,0,0,0,0
233,1,0,46,0,-46
234,1,1,482,1883,1401
235,0,0,68,0,-68
236,1,0,24,0,-24
237,1,0,1,0,-1
238,1,1,260,1518,1258
239,0,0,170,0,-170
240,0,0,15,0,-15
241,1,0,43,0,-43
242,1,1,596,1262,666
243,1,0,209,0,-209
244,0,0,159,0,-159
245,0,0,25,0,-25
246,1,1,217,1200,983
247,0,0,0,0,0
248,1,1,770,1324,554
249,0,0,11,0,-11
250,0,0,16,0,-16
251,1,0,11,0,-11
252,0,0,3,0,-3
253,1,1,126,2028,1902
254,0,0,51,0,-51
255,1,0,24,0,-24
256,0,0,19,0,-19
257,0,0,0,0,0
258,0,0,58,0,-58
259,0,0,17,0,-17
260,1,1,1654,1489,-165
261,1,1,1263,1715,452
262,0,0,7,0,-7
263,1,1,64,1478,1414
264,1,0,4,0,-4
265,0,0,24,0,-24
266,0,0,23,0,-23
267,1,1,364,1675,1311
268,1,1,751,1484,733
269,1,1,274,1428,1154
270,0,0,89,0,-89
271,1,0,61,0,-61
272,1,0,8,0,-8
273,1,0,30,0,-30
274,0,0,52,0,-52
275,1,0,23,0,-23
276,0,0,129,0,-129
277,0,0,106,0,-106
278,1,1,831,1298,467
279,0,0,62,0,-62
280,0,0,48,0,-48
281,0,0,2,0,-2
282,1,0,26,0,-26
283,0,0,149,0,-149
284,1,0,37,0,-37
285,0,0,10,0,-10
286,1,0,55,0,-55
287,1,0,4,0,-4
288,1,0,31,0,-31
289,1,0,186,0,-186
290,1,1,43,1462,1419
291,0,0,69,0,-69
292,0,0,55,0,-55
293,0,0,0,0,0
294,0,0,17,0,-17
295,0,0,88,0,-88
296,1,0,21,0,-21
297,0,0,150,0,-150
298,1,1,876,1940,1064
299,1,1,141,1232,1091
300,0,0,34,0,-34
301,0,0,4,0,-4
302,1,0,28,0,-28
303,0,0,51,0,-51
304,1,0,62,0,-62
305,0,0,16,0,-16
306,1,1,225,1236,1011
307,1,1,1004,1222,218
308,1,0,24,0,-24
309,1,0,8,0,-8
310,1,1,875,1401,526
311,0,0,36,0,-36
312,1,0,72,0,-72
313,1,1,233,1229,996
314,1,1,79,1526,1447
315,0,0,19,0,-19
316,1,0,18,0,-18
317,0,0,80,0,-80
318,1,0,29,0,-29
319,1,0,54,0,-54
320,0,0,6,0,-6
321,1,1,1059,1378,319
322,1,1,399,1262,863
323,0,0,33,0,-33
324,0,0,121,0,-121
325,1,0,8,0,-8
326,0,0,50,0,-50
327,1,1,298,1253,955
328,1,1,72,1445,1373
329,1,1,1137,1390,253
330,1,0,25,0,-25
331,1,0,51,0,-51
332,0,0,90,0,-90
333,0,0,15,0,-15
334,1,0,35,0,-35
335,1,0,27,0,-27
336,0,0,29,0,-29
337,1,0,21,0,-21
338,1,1,65,1306,1241
339,1,0,25,0,-25
340,1,0,25,0,-25
341,1,0,30,0,-30
342,0,0,26,0,-26
343,0,0,13,0,-13
344,1,1,48,1382,1334
345,0,0,44,0,-44
346,0,0,0,0,0
347,1,1,622,1427,805
348,1,0,143,0,-143
349,1,1,106,1529,1423
350,0,0,382,0,-382
351,1,0,34,0,-34
352,1,1,244,1317,1073
353,0,0,57,0,-57
354,1,1,60,2944,2884
355,1,1,514,1350,836
356,1,1,448,1556,1108
357,0,0,28,0,-28
358,1,0,35,0,-35
359,0,0,61,0,-61
360,0,0,113,0,-113
361,1,0,28,0,-28
362,1,0,75,0,-75
363,1,1,512,1937,1425
364,1,1,229,1317,1088
365,1,0,20,0,-20
366,1,0,14,0,-14
367,1,1,120,1401,1281
368,1,1,83,1894,1811
369,1,1,298,2017,1719
370,1,0,43,0,-43
371,1,0,182,0,-182
372,0,0,56,0,-56
373,1,0,8,0,-8
374,1,1,169,1328,1159
375,1,1,270,1656,1386
376,1,0,4,0,-4
377,0,0,4,0,-4
378,1,1,460,2037,1577
379,1,1,1444,1450,6
380,0,0,37,0,-37
381,0,0,38,0,-38
382,0,0,35,0,-35
383,1,1,407,1358,951
384,1,0,108,0,-108
385,1,1,130,1322,1192
386,1,1,1186,1479,293
387,1,0,8,0,-8
388,1,0,13,0,-13
389,0,0,12,0,-12
390,1,1,306,1211,905
391,1,0,35,0,-35
392,0,0,11,0,-11
393,1,0,30,0,-30
394,1,1,789,1780,991
395,1,1,109,1752,1643
396,0,0,6,0,-6
397,0,0,33,0,-33
398,1,0,82,0,-82
399,0,0,5,0,-5
400,1,1,355,1705,1350
401,1,1,49,1576,1527
402,1,0,24,0,-24
403,0,0,0,0,0
404,1,0,46,0,-46
405,0,0,94,0,-94
406,1,0,3,0,-3
407,1,0,18,0,-18
408,0,0,74,0,-74
409,0,0,9,0,-9
410,0,0,12,0,-12
411,1,0,66,0,-66
412,1,0,6,0,-6
413,0,0,128,0,-128
414,1,1,719,1352,633
415,1,1,493,1623,1130
416,1,0,24,0,-24
417,0,0,5,0,-5
418,0,0,64,0,-64
419,1,0,16,0,-16
420,0,0,19,0,-19
421,1,1,886,3879,2993
422,1,1,800,1464,664
423,1,1,486,1250,764
424,1,1,1909,1213,-696
425,1,0,20,0,-20
426,0,0,25,0,-25
427,1,1,132,1301,1169
428,0,0,22,0,-22
429,1,0,0,0,0
430,0,0,3,0,-3
431,1,1,427,1362,935
432,1,1,808,1250,442
433,0,0,16,0,-16
434,0,0,40,0,-40
435,1,1,934,1213,279
436,1,0,18,0,-18
437,0,0,11,0,-11
438,1,1,425,1311,886
439,0,0,24,0,-24
440,0,0,21,0,-21
441,1,0,49,0,-49
442,1,0,9,0,-9
443,0,0,20,0,-20
444,0,0,28,0,-28
445,1,1,59,1328,1269
446,0,0,13,0,-13
447,0,0,2,0,-2
448,1,1,410,1214,804
449,1,0,98,0,-98
450,0,0,119,0,-119
451,0,0,55,0,-55
452,0,0,151,0,-151
453,1,1,22,1234,1212
454,1,0,18,0,-18
455,1,0,26,0,-26
456,1,0,35,0,-35
457,0,0,13,0,-13
458,1,1,1277,1401,124
459,0,0,43,0,-43
460,1,0,20,0,-20
461,0,0,1,0,-1
462,1,0,33,0,-33
463,1,1,20,1356,1336
464,1,1,349,1238,889
465,1,0,8,0,-8
466,1,1,919,1466,547
467,1,1,1852,1804,-48
468,1,1,206,1396,1190
469,1,1,311,1231,920
470,1,0,6,0,-6
471,0,0,2,0,-2
472,0,0,55,0,-55
473,0,0,14,0,-14
474,0,0,79,0,-79
475,1,1,437,1428,991
476,0,0,54,0,-54
477,0,0,35,0,-35
478,1,1,612,1563,951
479,1,0,266,0,-266
480,1,1,59,1261,1202
481,0,0,78,0,-78
482,0,0,61,0,-61
483,1,1,20,1634,1614
484,0,0,14,0,-14
485,1,1,943,1325,382
486,0,0,85,0,-85
487,1,0,9,0,-9
488,1,1,1032,1556,524
489,1,0,35,0,-35
490,1,0,1,0,-1
491,1,1,988,1364,376
492,0,0,0,0,0
493,1,1,73,1312,1239
494,0,0,1,0,-1
495,1,1,949,1222,273
496,1,1,614,1483,869
497,0,0,32,0,-32
498,0,0,59,0,-59
499,1,0,7,0,-7
500,1,0,83,0,-83
501,1,1,700,1855,1155
502,1,0,11,0,-11
503,1,0,74,0,-74
504,0,0,22,0,-22
505,1,1,344,1354,1010
506,1,1,1473,1249,-224
507,1,1,313,1219,906
508,0,0,26,0,-26
509,0,0,4,0,-4
510,1,1,554,2651,2097
511,0,0,102,0,-102
512,1,0,69,0,-69
513,1,1,39,1599,1560
514,0,0,2,0,-2
515,0,0,65,0,-65
516,1,0,7,0,-7
517,0,0,15,0,-15
518,1,0,0,0,0
519,1,1,133,1976,1843
520,0,0,45,0,-45
521,1,0,36,0,-36
522,1,1,96,1477,1381
523,1,1,269,2377,2108
524,1,1,617,1558,941
525,0,0,167,0,-167
526,0,0,94,0,-94
527,1,1,265,2025,1760
528,0,0,198,0,-198
529,1,1,431,1248,817
530,1,0,16,0,-16
531,0,0,16,0,-16
532,1,1,505,1813,1308
533,1,0,0,0,0
534,1,0,16,0,-16
535,1,0,27,0,-27
536,1,1,322,1564,1242
537,0,0,104,0,-104
538,0,0,55,0,-55
539,0,0,36,0,-36
540,0,0,46,0,-46
541,1,1,1503,2695,1192
542,0,0,235,0,-235
543,1,0,20,0,-20
544,1,1,663,3424,2761
545,0,0,12,0,-12
546,0,0,1,0,-1
547,0,0,31,0,-31
548,0,0,6,0,-6
549,1,0,146,0,-146
550,0,0,54,0,-54
551,0,0,12,0,-12
552,1,0,17,0,-17
553,1,0,5,0,-5
554,1,1,156,1210,1054
555,0,0,1,0,-1
556,1,1,1173,1271,98
557,0,0,61,0,-61
558,1,0,32,0,-32
559,1,0,70,0,-70
560,0,0,37,0,-37
561,1,1,27,1558,1531
562,1,0,143,0,-143
563,1,1,514,1291,777
564,1,0,5,0,-5
565,1,0,21,0,-21
566,1,1,1051,1480,429
567,1,0,83,0,-83
568,0,0,31,0,-31
569,1,0,45,0,-45
570,1,0,48,0,-48
571,1,0,27,0,-27
572,0,0,6,0,-6
573,0,0,5,0,-5
574,1,0,7,0,-7
575,0,0,25,0,-25
576,1,0,10,0,-10
577,0,0,36,0,-36
578,0,0,69,0,-69
579,1,1,172,1904,1732
580,0,0,118,0,-118
581,1,1,639,1283,644
582,1,1,1075,1397,322
583,0,0,103,0,-103
584,1,1,1705,1239,-466
585,1,1,204,1510,1306
586,0,0,17,0,-17
587,1,0,35,0,-35
588,1,1,190,1299,1109
589,1,0,30,0,-30
590,1,0,16,0,-16
591,0,0,70,0,-70
592,0,0,49,0,-49
593,0,0,95,0,-95
594,0,0,19,0,-19
595,0,0,59,0,-59
596,1,0,12,0,-12
597,1,0,15,0,-15
598,0,0,14,0,-14
599,1,0,18,0,-18
600,0,0,30,0,-30
601,1,0,48,0,-48
602,1,0,105,0,-105
603,0,0,18,0,-18
604,0,0,63,0,-63
605,1,1,410,1208,798
606,0,0,7,0,-7
607,1,0,8,0,-8
608,0,0,75,0,-75
609,0,0,6,0,-6
610,1,1,85,1677,1592
611,1,0,45,0,-45
612,0,0,9,0,-9
613,1,0,82,0,-82
614,0,0,12,0,-12
615,1,1,520,1256,736
616,1,0,123,0,-123
617,1,0,90,0,-90
618,1,0,56,0,-56
619,1,0,41,0,-41
620,1,0,27,0,-27
621,0,0,57,0,-57
622,1,0,55,0,-55
623,0,0,47,0,-47
624,1,1,557,1564,1007
625,0,0,6,0,-6
626,0,0,13,0,-13
627,0,0,12,0,-12
628,1,1,397,1378,981
629,1,1,268,1459,1191
630,1,1,350,1232,882
631,0,0,47,0,-47
632,1,1,165,1868,1703
633,0,0,71,0,-71
634,0,0,10,0,-10
635,1,1,865,1269,404
636,1,1,215,1298,1083
637,0,0,71,0,-71
638,1,1,452,1767,1315
639,0,0,73,0,-73
640,0,0,34,0,-34
641,0,0,50,0,-50
642,0,0,361,0,-361
643,1,1,1305,1206,-99
644,0,0,123,0,-123
645,0,0,24,0,-24
646,1,0,124,0,-124
647,1,1,930,1938,1008
648,0,0,16,0,-16
649,0,0,1,0,-1
650,1,1,408,1225,817
651,1,1,995,1327,332
652,0,0,180,0,-180
653,1,0,3,0,-3
654,1,0,17,0,-17
655,1,1,231,1254,1023
656,0,0,5,0,-5
657,1,1,430,1247,817
658,1,0,45,0,-45
659,1,0,1,0,-1
660,0,0,62,0,-62
661,0,0,35,0,-35
662,0,0,65,0,-65
663,1,1,430,2374,1944
664,1,1,236,1670,1434
665,1,0,75,0,-75
666,1,0,18,0,-18
667,1,0,7,0,-7
668,0,0,31,0,-31
669,1,0,15,0,-15
670,1,0,28,0,-28
671,1,0,79,0,-79
672,0,0,7,0,-7
673,0,0,13,0,-13
674,1,0,17,0,-17
675,1,0,96,0,-96
676,1,0,32,0,-32
677,0,0,132,0,-132
678,0,0,10,0,-10
679,1,0,43,0,-43
680,0,0,34,0,-34
681,1,0,19,0,-19
682,0,0,61,0,-61
683,1,1,1143,1422,279
684,1,0,171,0,-171
685,0,0,52,0,-52
686,1,1,268,1524,1256
687,1,1,529,1839,1310
688,0,0,21,0,-21
689,1,1,1273,1533,260
690,0,0,26,0,-26
691,1,0,8,0,-8
692,1,1,845,1297,452
693,0,0,0,0,0
694,0,0,148,0,-148
695,0,0,44,0,-44
696,1,1,133,1817,1684
697,0,0,116,0,-116
698,0,0,26,0,-26
699,1,0,5,0,-5
700,1,0,3,0,-3
701,0,0,3,0,-3
702,0,0,27,0,-27
703,0,0,26,0,-26
704,1,0,120,0,-120
705,1,1,475,1229,754
706,0,0,33,0,-33
707,1,1,182,2968,2786
708,0,0,97,0,-97
709,1,1,111,1213,1102
710,1,0,266,0,-266
711,1,1,1045,1485,440
712,0,0,32,0,-32
713,0,0,72,0,-72
714,0,0,19,0,-19
715,0,0,15,0,-15
716,1,1,1785,1854,69
717,1,1,169,1324,1155
718,0,0,16,0,-16
719,1,0,53,0,-53
720,0,0,25,0,-25
721,0,0,5,0,-5
722,1,0,29,0,-29
723,1,0,16,0,-16
724,1,1,1984,1200,-784
725,1,0,1,0,-1
726,0,0,11,0,-11
727,1,1,437,1972,1535
728,0,0,51,0,-51
729,1,0,1,0,-1
730,1,1,289,1555,1266
731,1,1,984,1816,832
732,1,1,162,1246,1084
733,1,1,486,1550,1064
734,1,0,79,0,-79
735,1,1,112,1201,1089
736,0,0,140,0,-140
737,1,1,631,1214,583
738,1,1,668,2200,1532
739,0,0,43,0,-43
740,1,1,454,1437,983
741,0,0,11,0,-11
742,0,0,45,0,-45
743,0,0,4,0,-4
744,1,1,496,2075,1579
745,0,0,92,0,-92
746,0,0,19,0,-19
747,1,1,1078,2136,1058
748,0,0,5,0,-5
749,0,0,150,0,-150
750,0,0,13,0,-13
751,0,0,24,0,-24
752,1,1,1592,1410,-182
753,1,1,394,1762,1368
754,0,0,32,0,-32
755,1,1,1212,1329,117
756,0,0,27,0,-27
757,1,0,21,0,-21
758,1,1,486,1668,1182
759,1,0,71,0,-71
760,1,1,207,1317,1110
761,1,0,16,0,-16
762,0,0,86,0,-86
763,0,0,130,0,-130
764,1,0,121,0,-121
765,1,0,57,0,-57
766,1,0,70,0,-70
767,0,0,180,0,-180
768,1,0,49,0,-49
769,0,0,60,0,-60
770,1,1,176,1218,1042
771,1,1,251,1613,1362
772,0,0,30,0,-30
773,1,1,2023,1291,-732
774,0,0,170,0,-170
775,0,0,66,0,-66
776,0,0,60,0,-60
777,1,0,3,0,-3
778,1,1,337,1934,1597
779,0,0,15,0,-15
780,1,1,294,1572,1278
781,0,0,68,0,-68
782,1,1,266,1401,1135
783,1,0,8,0,-8
784,1,1,30,1750,1720
785,0,0,122,0,-122
786,0,0,50,0,-50
787,1,1,196,1400,1204
788,0,0,21,0,-21
789,0,0,16,0,-16
790,1,1,421,1448,1027
791,1,0,27,0,-27
792,0,0,59,0,-59
793,1,0,32,0,-32
794,0,0,151,0,-151
795,1,0,9,0,-9
796,1,0,129,0,-129
797,1,1,384,1475,1091
798,1,0,100,0,-100
799,1,0,12,0,-12
800,0,0,52,0,-52
801,0,0,168,0,-168
802,1,1,355,2430,2075
803,1,0,5,0,-5
804,0,0,101,0,-101
805,1,0,17,0,-17
806,1,1,71,1681,1610
807,1,1,352,1224,872
808,1,0,1,0,-1
809,1,0,165,0,-165
810,1,1,174,1648,1474
811,1,0,81,0,-81
812,1,1,502,1310,808
813,0,0,8,0,-8
814,1,0,0,0,0
815,1,0,4,0,-4
816,1,1,507,1379,872
817,1,1,242,2830,2588
818,1,1,474,1767,1293
819,0,0,12,0,-12
820,1,1,166,1564,1398
821,1,1,3009,1358,-1651
822,1,0,190,0,-190
823,0,0,4,0,-4
824,1,1,973,1297,324
825,1,1,94,1388,1294
826,0,0,23,0,-23
827,1,1,740,1875,1135
828,1,0,50,0,-50
829,0,0,11,0,-11
830,1,1,856,1243,387
831,0,0,7,0,-7
832,0,0,59,0,-59
833,0,0,9,0,-9
834,1,1,377,1276,899
835,1,1,106,1446,1340
836,1,0,230,0,-230
837,1,1,359,1269,910
838,1,1,315,1805,1490
839,0,0,34,0,-34
840,1,0,105,0,-105
841,0,0,2,0,-2
842,0,0,44,0,-44
843,0,0,36,0,-36
844,0,0,128,0,-128
845,0,0,26,0,-26
846,0,0,4,0,-4
847,1,1,835,2256,1421
848,1,1,148,1599,1451
849,0,0,12,0,-12
850,0,0,19,0,-19
851,1,0,92,0,-92
852,1,1,114,2199,2085
853,0,0,21,0,-21
854,0,0,99,0,-99
855,1,0,9,0,-9
856,0,0,21,0,-21
857,1,0,82,0,-82
858,0,0,17,0,-17
859,0,0,65,0,-65
860,1,0,31,0,-31
861,0,0,15,0,-15
862,0,0,70,0,-70
863,1,0,13,0,-13
864,1,1,1010,1818,808
865,1,0,82,0,-82
866,1,0,75,0,-75
867,1,0,38,0,-38
868,1,1,488,1565,1077
869,1,1,238,1298,1060
870,0,0,72,0,-72
871,1,0,10,0,-10
872,1,1,536,2103,1567
873,0,0,55,0,-55
874,0,0,69,0,-69
875,1,1,130,2053,1923
876,1,1,288,1385,1097
877,1,0,23,0,-23
878,1,1,1116,1203,87
879,1,0,49,0,-49
880,0,0,274,0,-274
881,1,0,9,0,-9
882,1,1,358,1202,844
883,1,1,879,1521,642
884,1,1,693,1669,976
885,1,1,1080,1445,365
886,1,1,199,1394,1195
887,0,0,27,0,-27
888,1,0,59,0,-59
889,0,0,56,0,-56
890,1,0,36,0,-36
891,1,0,176,0,-176
892,1,0,148,0,-148
893,1,1,234,1235,1001
894,1,0,220,0,-220
895,1,0,84,0,-84
896,0,0,14,0,-14
897,1,1,232,1522,1290
898,0,0,48,0,-48
899,0,0,44,0,-44
900,0,0,122,0,-122
901,1,1,318,1216,898
902,1,1,324,1905,1581
903,1,0,291,0,-291
904,0,0,8,0,-8
905,1,0,57,0,-57
906,0,0,131,0,-131
907,1,1,396,2140,1744
908,1,1,264,1471,1207
909,0,0,53,0,-53
910,1,0,71,0,-71
911,0,0,0,0,0
912,1,1,109,1434,1325
913,0,0,182,0,-182
914,0,0,62,0,-62
915,1,0,44,0,-44
916,0,0,26,0,-26
917,1,1,1046,1212,166
918,1,1,1330,1216,-114
919,1,1,76,1468,1392
920,1,1,76,1736,1660
921,1,1,638,1411,773
922,1,0,46,0,-46
923,1,1,501,1203,702
924,1,0,14,0,-14
925,1,0,53,0,-53
926,1,1,1059,1587,528
927,1,0,11,0,-11
928,0,0,136,0,-136
929,1,1,561,1392,831
930,1,0,71,0,-71
931,0,0,12,0,-12
932,1,0,7,0,-7
933,1,1,1520,1544,24
934,0,0,59,0,-59
935,1,1,31,1734,1703
936,1,0,65,0,-65
937,0,0,65,0,-65
938,1,1,369,2394,2025
939,1,1,37,1284,1247
940,0,0,47,0,-47
941,0,0,208,0,-208
942,1,1,271,1708,1437
943,1,1,1260,1350,90
944,1,0,31,0,-31
945,0,0,40,0,-40
946,0,0,61,0,-61
947,1,0,93,0,-93
948,0,0,2,0,-2
949,0,0,42,0,-42
950,0,0,22,0,-22
951,1,1,1382,1261,-121
952,0,0,13,0,-13
953,0,0,129,0,-129
954,1,1,780,1387,607
955,0,0,14,0,-14
956,1,0,9,0,-9
957,1,0,49,0,-49
958,0,0,81,0,-81
959,0,0,165,0,-165
960,0,0,0,0,0
961,1,1,155,1301,1146
962,0,0,40,0,-40
963,1,1,283,1223,940
964,1,0,31,0,-31
965,1,0,1,0,-1
966,0,0,63,0,-63
967,0,0,27,0,-27
968,1,0,148,0,-148
969,0,0,75,0,-75
970,1,1,443,1270,827
971,1,0,129,0,-129
972,0,0,11,0,-11
973,0,0,46,0,-46
974,1,1,274,1722,1448
975,1,0,0,0,0
976,0,0,109,0,-109
977,0,0,143,0,-143
978,0,0,29,0,-29
979,1,0,48,0,-48
980,1,1,210,1364,1154
981,1,1,2306,1429,-877
982,1,0,1,0,-1
983,0,0,2,0,-2
984,1,1,171,1305,1134
985,1,0,115,0,-115
986,1,1,116,1211,1095
987,0,0,334,0,-334
988,1,0,43,0,-43
989,0,0,129,0,-129
990,1,0,33,0,-33
991,0,0,1,0,-1
992,1,0,27,0,-27
993,1,1,222,1551,1329
994,0,0,24,0,-24
995,1,0,85,0,-85
996,0,0,46,0,-46
997,1,1,514,1693,1179
998,0,0,174,0,-174
999,0,0,14,0,-14
1000,0,0,14,0,-14
1001,0,0,0,0,0
1002,1,0,33,0,-33
1003,1,0,67,0,-67
1004,0,0,166,0,-166
1005,1,1,320,1882,1562
1006,1,1,1947,3020,1073
1007,1,0,118,0,-118
1008,0,0,19,0,-19
1009,1,1,1359,1457,98
1010,0,0,18,0,-18
1011,1,0,61,0,-61
1012,1,0,24,0,-24
1013,1,0,122,0,-122
1014,0,0,5,0,-5
1015,1,1,539,1756,1217
1016,1,0,196,0,-196
1017,0,0,30,0,-30
1018,1,0,20,0,-20
1019,1,0,72,0,-72
1020,0,0,16,0,-16
1021,0,0,66,0,-66
1022,1,1,930,1368,438
1023,1,0,37,0,-37
1024,1,1,43,1833,1790
1025,0,0,42,0,-42
1026,1,0,66,0,-66
1027,1,0,58,0,-58
1028,1,0,58,0,-58
1029,1,0,51,0,-51
1030,0,0,23,0,-23
1031,0,0,16,0,-16
1032,0,0,33,0,-33
1033,1,0,3,0,-3
1034,1,1,432,1509,1077
1035,1,1,1307,1824,517
1036,1,0,106,0,-106
1037,1,1,113,1352,1239
1038,1,1,310,1270,960
1039,0,0,6,0,-6
1040,1,0,115,0,-115
1041,0,0,32,0,-32
1042,1,1,1646,1576,-70
1043,0,0,38,0,-38
1044,1,0,4,0,-4
1045,1,0,4,0,-4
1046,0,0,7,0,-7
1047,1,0,11,0,-11
1048,1,0,21,0,-21
1049,1,0,32,0,-32
1050,0,0,12,0,-12
1051,0,0,75,0,-75
1052,1,0,41,0,-41
1053,0,0,6,0,-6
1054,1,1,652,1428,776
1055,1,0,32,0,-32
1056,0,0,95,0,-95
1057,1,0,19,0,-19
1058,0,0,18,0,-18
1059,1,0,78,0,-78
1060,0,0,151,0,-151
1061,0,0,172,0,-172
1062,1,0,125,0,-125
1063,1,1,286,1763,1477
1064,0,0,43,0,-43
1065,0,0,20,0,-20
1066,1,1,185,1347,1162
1067,1,1,972,1761,789
1068,1,0,4,0,-4
1069,0,0,52,0,-52
1070,0,0,30,0,-30
1071,0,0,65,0,-65
1072,1,0,102,0,-102
1073,1,1,179,1991,1812
1074,1,1,197,3477,3280
1075,1,0,52,0,-52
1076,1,0,95,0,-95
1077,1,1,765,1209,444
1078,1,0,4,0,-4
1079,0,0,78,0,-78
1080,1,1,81,1538,1457
1081,1,1,123,1211,1088
1082,0,0,10,0,-10
1083,1,0,61,0,-61
1084,1,0,4,0,-4
1085,0,0,76,0,-76
1086,1,0,16,0,-16
1087,1,0,12,0,-12
1088,1,0,197,0,-197
1089,1,0,92,0,-92
1090,0,0,23,0,-23
1091,1,0,40,0,-40
1092,1,1,334,1841,1507
1093,0,0,38,0,-38
1094,0,0,109,0,-109
1095,0,0,25,0,-25
1096,1,1,198,2246,2048
1097,1,0,27,0,-27
1098,1,0,33,0,-33
1099,1,0,61,0,-61
1100,1,0,71,0,-71
1101,0,0,68,0,-68
1102,0,0,47,0,-47
1103,1,1,124,1266,1142
1104,1,0,198,0,-198
1105,0,0,91,0,-91
1106,1,0,242,0,-242
1107,1,1,329,1344,1015
1108,0,0,123,0,-123
1109,0,0,64,0,-64
1110,1,0,68,0,-68
1111,1,1,818,1248,430
1112,1,0,78,0,-78
1113,1,0,99,0,-99
1114,1,0,18,0,-18
1115,1,0,31,0,-31
1116,1,1,860,1637,777
1117,0,0,14,0,-14
1118,0,0,9,0,-9
1119,1,1,1304,1418,114
1120,1,1,250,1307,1057
1121,1,0,14,0,-14
1122,0,0,27,0,-27
1123,1,1,239,1687,1448
1124,0,0,21,0,-21
1125,1,1,447,1200,753
1126,1,0,139,0,-139
1127,1,0,38,0,-38
1128,1,1,1656,2318,662
1129,0,0,42,0,-42
1130,0,0,15,0,-15
1131,0,0,19,0,-19
1132,1,0,185,0,-185
1133,1,0,36,0,-36
1134,0,0,42,0,-42
1135,0,0,88,0,-88
1136,0,0,4,0,-4
1137,1,0,100,0,-100
1138,0,0,17,0,-17
1139,0,0,29,0,-29
1140,0,0,45,0,-45
1141,1,0,123,0,-123
1142,1,0,76,0,-76
1143,1,0,5,0,-5
1144,0,0,116,0,-116
1145,0,0,68,0,-68
1146,1,1,151,1316,1165
1147,0,0,37,0,-37
1148,1,1,68,1200,1132
1149,1,0,4,0,-4
1150,1,1,305,1468,1163
1151,0,0,28,0,-28
1152,0,0,54,0,-54
1153,0,0,231,0,-231
1154,1,1,406,1242,836
1155,1,0,33,0,-33
1156,1,0,25,0,-25
1157,0,0,69,0,-69
1158,0,0,40,0,-40
1159,0,0,15,0,-15
1160,1,0,102,0,-102
1161,0,0,68,0,-68
1162,1,0,12,0,-12
1163,0,0,83,0,-83
1164,1,1,126,1434,1308
1165,0,0,25,0,-25
1166,1,0,41,0,-41
1167,1,0,5,0,-5
1168,0,0,4,0,-4
1169,1,1,395,1538,1143
1170,1,1,723,1473,750
1171,0,0,2,0,-2
1172,0,0,32,0,-32
1173,1,0,48,0,-48
1174,1,0,23,0,-23
1175,1,1,1121,3547,2426
1176,1,1,312,1325,1013
1177,0,0,58,0,-58
1178,1,0,62,0,-62
1179,1,0,5,0,-5
1180,0,0,220,0,-220
1181,1,1,269,1286,1017
1182,1,1,107,1284,1177
1183,1,1,1221,1803,582
1184,0,0,135,0,-135
1185,1,1,196,1291,1095
1186,0,0,163,0,-163
1187,0,0,90,0,-90
1188,1,1,443,1480,1037
1189,1,1,78,1335,1257
1190,0,0,16,0,-16
1191,0,0,67,0,-67
1192,0,0,56,0,-56
1193,0,0,40,0,-40
1194,1,1,546,1236,690
1195,0,0,9,0,-9
1196,0,0,56,0,-56
1197,1,0,17,0,-17
1198,1,0,43,0,-43
1199,1,1,136,1317,1181
1200,1,1,450,3385,2935
1201,0,0,2,0,-2
1202,1,1,170,1491,1321
1203,0,0,38,0,-38
1204,1,1,161,1394,1233
1205,1,1,333,1992,1659
1206,1,0,40,0,-40
1207,1,1,1010,1327,317
1208,1,0,40,0,-40
1209,0,0,107,0,-107
1210,1,1,198,1767,1569
1211,1,0,78,0,-78
1212,1,0,30,0,-30
1213,0,0,41,0,-41
1214,1,0,54,0,-54
1215,1,1,507,1213,706
1216,1,0,18,0,-18
1217,1,0,64,0,-64
1218,1,0,16,0,-16
1219,1,1,678,2193,1515
1220,1,1,361,1627,1266
1221,0,0,87,0,-87
1222,0,0,45,0,-45
1223,1,1,446,1247,801
1224,1,1,923,1236,313
1225,0,0,0,0,0
1226,1,0,23,0,-23
1227,1,0,7,0,-7
1228,0,0,54,0,-54
1229,0,0,65,0,-65
1230,1,1,249,1515,1266
1231,0,0,44,0,-44
1232,1,0,66,0,-66
1233,0,0,68,0,-68
1234,1,0,18,0,-18
1235,1,1,867,1360,493
1236,0,0,27,0,-27
1237,1,0,35,0,-35
1238,0,0,24,0,-24
1239,0,0,188,0,-188
1240,1,1,634,1611,977
1241,1,0,64,0,-64
1242,0,0,51,0,-51
1243,0,0,1,0,-1
1244,0,0,0,0,0
1245,0,0,36,0,-36
1246,1,1,258,1755,1497
1247,0,0,20,0,-20
1248,0,0,78,0,-78
1249,1,1,108,1356,1248
1250,1,1,66,1252,1186
1251,1,1,870,1443,573
1252,0,0,34,0,-34
1253,1,0,129,0,-129
1254,0,0,138,0,-138
1255,1,1,246,1515,1269
1256,0,0,16,0,-16
1257,1,1,788,1437,649
1258,1,1,62,1296,1234
1259,0,0,42,0,-42
1260,0,0,62,0,-62
1261,1,0,26,0,-26
1262,0,0,21,0,-21
1263,1,0,74,0,-74
1264,1,0,7,0,-7
1265,1,0,37,0,-37
1266,1,0,1,0,-1
1267,1,1,157,1441,1284
1268,1,0,8,0,-8
1269,0,0,65,0,-65
1270,1,1,172,1217,1045
1271,0,0,62,0,-62
1272,0,0,8,0,-8
1273,0,0,18,0,-18
1274,1,1,525,1749,1224
1275,1,1,54,1621,1567
1276,1,0,52,0,-52
1277,0,0,6,0,-6
1278,0,0,1,0,-1
1279,1,0,14,0,-14
1280,1,0,52,0,-52
1281,1,0,17,0,-17
1282,0,0,1,0,-1
1283,1,0,23,0,-23
1284,1,1,1389,1231,-158
1285,1,1,992,1311,319
1286,1,0,47,0,-47
1287,0,0,39,0,-39
1288,1,1,188,1633,1445
1289,1,1,347,1492,1145
1290,0,0,10,0,-10
1291,0,0,41,0,-41
1292,0,0,1,0,-1
1293,0,0,70,0,-70
1294,0,0,92,0,-92
1295,0,0,8,0,-8
1296,1,1,149,1364,1215
1297,1,1,707,1337,630
1298,1,1,666,1247,581
1299,1,0,15,0,-15
1300,0,0,34,0,-34
1301,1,0,15,0,-15
1302,0,0,30,0,-30
1303,1,0,103,0,-103
1304,1,0,49,0,-49
1305,0,0,56,0,-56
1306,1,0,3,0,-3
1307,1,0,20,0,-20
1308,0,0,43,0,-43
1309,0,0,14,0,-14
1310,1,0,63,0,-63
1311,1,0,63,0,-63
1312,1,1,152,1253,1101
1313,0,0,62,0,-62
1314,0,0,7,0,-7
1315,0,0,26,0,-26
1316,0,0,22,0,-22
1317,1,1,81,1480,1399
1318,1,0,14,0,-14
1319,1,0,113,0,-113
1320,0,0,30,0,-30
1321,0,0,4,0,-4
1322,0,0,13,0,-13
1323,0,0,30,0,-30
1324,1,0,1,0,-1
1325,0,0,97,0,-97
1326,1,1,167,1371,1204
1327,1,0,8,0,-8
1328,0,0,89,0,-89
1329,1,0,19,0,-19
1330,1,1,1078,1367,289
1331,1,1,888,1348,460
1332,1,0,17,0,-17
1333,1,0,78,0,-78
1334,0,0,33,0,-33
1335,0,0,29,0,-29
1336,1,0,1,0,-1
1337,0,0,54,0,-54
1338,0,0,40,0,-40
1339,1,1,302,1745,1443
1340,1,1,430,1757,1327
1341,0,0,19,0,-19
1342,1,1,522,1241,719
1343,0,0,30,0,-30
1344,0,0,19,0,-19
1345,1,0,7,0,-7
1346,1,1,440,1308,868
1347,1,1,541,1880,1339
1348,0,0,37,0,-37
1349,1,0,19,0,-19
1350,1,1,921,1665,744
1351,0,0,176,0,-176
1352,0,0,76,0,-76
1353,0,0,11,0,-11
1354,1,1,391,1948,1557
1355,1,0,52,0,-52
1356,1,1,690,1418,728
1357,1,0,24,0,-24
1358,0,0,15,0,-15
1359,0,0,17,0,-17
1360,1,1,378,1686,1308
1361,0,0,0,0,0
1362,0,0,53,0,-53
1363,0,0,20,0,-20
1364,0,0,97,0,-97
1365,0,0,98,0,-98
1366,1,0,21,0,-21
1367,0,0,108,0,-108
1368,1,0,15,0,-15
1369,1,0,74,0,-74
1370,1,1,41,2129,2088
1371,0,0,17,0,-17
1372,1,1,89,1474,1385
1373,1,1,1008,1258,250
1374,1,0,12,0,-12
1375,1,1,676,1485,809
1376,1,1,210,1314,1104
1377,1,1,125,1942,1817
1378,1,0,42,0,-42
1379,0,0,115,0,-115
1380,1,1,722,1699,977
1381,0,0,56,0,-56
1382,0,0,1,0,-1
1383,0,0,10,0,-10
1384,1,1,192,1201,1009
1385,0,0,77,0,-77
1386,1,1,479,1274,795
1387,1,0,21,0,-21
1388,1,0,60,0,-60
1389,1,1,303,1214,911
1390,0,0,37,0,-37
1391,1,1,1527,1773,246
1392,1,0,10,0,-10
1393,1,1,1044,1204,160
1394,0,0,33,0,-33
1395,1,1,293,1242,949
1396,0,0,57,0,-57
1397,0,0,8,0,-8
1398,0,0,68,0,-68
1399,1,0,57,0,-57
1400,1,1,448,1496,1048
1401,1,0,94,0,-94
1402,0,0,75,0,-75
1403,1,0,201,0,-201
1404,1,0,81,0,-81
1405,0,0,24,0,-24
1406,1,1,603,2719,2116
1407,1,0,85,0,-85
1408,1,1,217,1330,1113
1409,0,0,48,0,-48
1410,1,0,43,0,-43
1411,1,0,130,0,-130
1412,0,0,32,0,-32
1413,1,1,623,1231,608
1414,1,1,544,1264,720
1415,0,0,2,0,-2
1416,0,0,31,0,-31
1417,1,1,1192,1710,518
1418,0,0,0,0,0
1419,1,1,435,1309,874
1420,1,0,28,0,-28
1421,0,0,48,0,-48
1422,0,0,23,0,-23
1423,0,0,1,0,-1
1424,1,0,109,0,-109
1425,1,1,1006,1305,299
1426,0,0,153,0,-153
1427,1,0,28,0,-28
1428,0,0,23,0,-23
1429,1,0,55,0,-55
1430,1,0,15,0,-15
1431,0,0,29,0,-29
1432,1,0,289,0,-289
1433,0,0,5,0,-5
1434,0,0,24,0,-24
1435,0,0,43,0,-43
1436,1,1,210,2847,2637
1437,0,0,46,0,-46
1438,1,1,603,1878,1275
1439,1,1,119,1277,1158
1440,0,0,193,0,-193
1441,1,1,190,1318,1128
1442,1,0,17,0,-17
1443,1,1,121,1375,1254
1444,1,1,1129,1366,237
1445,0,0,25,0,-25
1446,0,0,12,0,-12
1447,1,0,18,0,-18
1448,1,0,63,0,-63
1449,0,0,149,0,-149
1450,0,0,3,0,-3
1451,1,0,4,0,-4
1452,1,1,448,1399,951
1453,0,0,51,0,-51
1454,1,0,20,0,-20
1455,1,1,212,2066,1854
1456,1,1,338,1356,1018
1457,1,0,150,0,-150
1458,1,0,151,0,-151
1459,0,0,32,0,-32
1460,1,1,736,1282,546
1461,1,0,44,0,-44
1462,1,1,1130,1402,272
1463,1,1,68,1545,1477
1464,1,0,107,0,-107
1465,0,0,35,0,-35
1466,1,0,60,0,-60
1467,1,1,500,1225,725
1468,0,0,140,0,-140
1469,1,1,1229,1332,103
1470,1,1,1064,1201,137
1471,1,1,1311,1802,491
1472,1,0,15,0,-15
1473,1,1,156,1376,1220
1474,0,0,27,0,-27
1475,1,0,170,0,-170
1476,1,1,434,2261,1827
1477,1,1,737,1282,545
1478,1,1,277,2379,2102
1479,1,0,196,0,-196
1480,1,1,646,2963,2317
1481,1,0,11,0,-11
1482,0,0,13,0,-13
1483,1,1,529,1205,676
1484,0,0,78,0,-78
1485,1,0,47,0,-47
1486,1,0,4,0,-4
1487,1,1,23,1562,1539
1488,1,1,1235,1464,229
1489,1,0,69,0,-69
1490,0,0,25,0,-25
1491,0,0,123,0,-123
1492,1,0,4,0,-4
1493,1,1,20,1311,1291
1494,1,1,79,1422,1343
1495,1,1,470,1774,1304
1496,0,0,20,0,-20
1497,1,0,55,0,-55
1498,1,0,2,0,-2
1499,0,0,130,0,-130
1500,0,0,28,0,-28
1501,0,0,114,0,-114
1502,1,1,232,1234,1002
1503,0,0,27,0,-27
1504,0,0,10,0,-10
1505,0,0,25,0,-25
1506,1,0,31,0,-31
1507,1,1,286,1443,1157
1508,1,0,56,0,-56
1509,1,1,247,1867,1620
1510,0,0,32,0,-32
1511,0,0,7,0,-7
1512,1,0,48,0,-48
1513,1,1,215,2389,2174
1514,0,0,126,0,-126
1515,1,1,214,1687,1473
1516,1,1,754,1240,486
1517,0,0,6,0,-6
1518,1,1,1293,1628,335
1519,1,1,376,1490,1114
1520,0,0,69,0,-69
1521,1,0,11,0,-11
1522,1,0,68,0,-68
1523,1,1,929,1283,354
1524,0,0,10,0,-10
1525,1,1,69,1255,1186
1526,0,0,65,0,-65
1527,0,0,5,0,-5
1528,0,0,13,0,-13
1529,1,0,41,0,-41
1530,1,1,933,1472,539
1531,0,0,7,0,-7
1532,1,1,456,1655,1199
1533,0,0,183,0,-183
1534,1,1,596,1327,731
1535,1,1,148,1451,1303
1536,1,0,88,0,-88
1537,1,1,555,1341,786
1538,1,0,121,0,-121
1539,0,0,11,0,-11
1540,0,0,41,0,-41
1541,0,0,90,0,-90
1542,0,0,0,0,0
1543,1,1,151,1233,1082
1544,0,0,2,0,-2
1545,1,1,673,1555,882
1546,1,1,847,1634,787
1547,0,0,246,0,-246
1548,0,0,8,0,-8
1549,0,0,78,0,-78
1550,1,0,69,0,-69
1551,0,0,59,0,-59
1552,1,1,281,1437,1156
1553,0,0,50,0,-50
1554,0,0,190,0,-190
1555,0,0,35,0,-35
1556,1,1,260,2175,1915
1557,0,0,26,0,-26
1558,1,0,7,0,-7
1559,0,0,19,0,-19
1560,1,1,740,1703,963
1561,0,0,16,0,-16
1562,1,0,65,0,-65
1563,0,0,57,0,-57
1564,1,0,6,0,-6
1565,1,1,939,1261,322
1566,0,0,66,0,-66
1567,1,0,3,0,-3
1568,0,0,20,0,-20
1569,0,0,11,0,-11
1570,1,1,573,1719,1146
1571,1,0,21,0,-21
1572,0,0,148,0,-148
1573,1,0,2,0,-2
1574,1,1,224,1206,982
1575,1,0,19,0,-19
1576,1,1,456,1219,763
1577,1,1,583,1380,797
1578,1,1,724,1534,810
1579,0,0,37,0,-37
1580,1,0,101,0,-101
1581,1,1,41,1496,1455
1582,1,1,203,1325,1122
1583,1,0,35,0,-35
1584,0,0,32,0,-32
1585,1,0,1,0,-1
1586,0,0,26,0,-26
1587,0,0,40,0,-40
1588,1,1,170,1583,1413
1589,1,0,8,0,-8
1590,0,0,3,0,-3
1591,0,0,2,0,-2
1592,1,1,22,2485,2463
1593,0,0,5,0,-5
1594,1,0,35,0,-35
1595,1,0,126,0,-126
1596,1,0,55,0,-55
1597,1,1,475,1440,965
1598,1,0,56,0,-56
1599,1,0,35,0,-35
1600,1,1,236,1622,1386
1601,1,1,748,1253,505
1602,0,0,75,0,-75
1603,1,0,91,0,-91
1604,1,0,99,0,-99
1605,1,1,1046,1388,342
1606,1,1,1187,1670,483
1607,1,0,38,0,-38
1608,0,0,6,0,-6
1609,0,0,23,0,-23
1610,0,0,35,0,-35
1611,0,0,58,0,-58
1612,1,1,1164,1267,103
1613,1,0,46,0,-46
1614,0,0,13,0,-13
1615,0,0,54,0,-54
1616,1,0,19,0,-19
1617,1,1,66,1592,1526
1618,0,0,30,0,-30
1619,0,0,96,0,-96
1620,0,0,52,0,-52
1621,1,0,0,0,0
1622,1,1,50,1360,1310
1623,1,1,323,2318,1995
1624,1,1,1375,1289,-86
1625,1,0,21,0,-21
1626,0,0,41,0,-41
1627,1,0,4,0,-4
1628,0,0,52,0,-52
1629,1,1,98,1362,1264
1630,1,1,232,1210,978
1631,0,0,31,0,-31
1632,1,0,28,0,-28
1633,1,1,591,2360,1769
1634,0,0,107,0,-107
1635,0,0,5,0,-5
1636,0,0,23,0,-23
1637,1,1,301,3269,2968
1638,1,1,502,1202,700
1639,0,0,31,0,-31
1640,1,1,50,1575,1525
1641,1,0,90,0,-90
1642,1,1,416,1317,901
1643,1,1,2108,1828,-280
1644,0,0,23,0,-23
1645,0,0,5,0,-5
1646,1,1,1043,1496,453
1647,1,1,81,1213,1132
1648,0,0,73,0,-73
1649,1,0,23,0,-23
1650,1,1,231,1689,1458
1651,1,1,479,1213,734
1652,0,0,47,0,-47
1653,1,1,1096,1843,747
1654,1,0,1,0,-1
1655,1,1,643,1430,787
1656,1,0,159,0,-159
1657,0,0,8,0,-8
1658,1,0,22,0,-22
1659,1,1,55,1316,1261
1660,0,0,135,0,-135
1661,0,0,37,0,-37
1662,1,1,328,1660,1332
1663,0,0,21,0,-21
1664,1,1,177,1436,1259
1665,1,1,328,1457,1129
1666,0,0,43,0,-43
1667,1,0,43,0,-43
1668,1,1,591,1204,613
1669,0,0,80,0,-80
1670,1,1,1193,1325,132
1671,0,0,27,0,-27
1672,1,0,25,0,-25
1673,1,1,35,1434,1399
1674,0,0,75,0,-75
1675,1,0,114,0,-114
1676,0,0,5,0,-5
1677,1,0,5,0,-5
1678,0,0,14,0,-14
1679,1,0,135,0,-135
1680,1,1,15,3898,3883
1681,1,0,36,0,-36
1682,0,0,47,0,-47
1683,1,1,227,1912,1685
1684,1,1,559,1250,691
1685,0,0,64,0,-64
1686,0,0,3,0,-3
1687,1,1,254,1214,960
1688,0,0,10,0,-10
1689,1,1,549,1307,758
1690,1,0,1,0,-1
1691,0,0,106,0,-106
1692,1,0,7,0,-7
1693,1,1,131,1436,1305
1694,1,0,253,0,-253
1695,1,0,38,0,-38
1696,0,0,20,0,-20
1697,1,1,648,1491,843
1698,0,0,2,0,-2
1699,0,0,78,0,-78
1700,0,0,128,0,-128
1701,0,0,375,0,-375
1702,1,1,128,1603,1475
1703,0,0,51,0,-51
1704,0,0,11,0,-11
1705,0,0,35,0,-35
1706,0,0,4,0,-4
1707,0,0,122,0,-122
1708,0,0,108,0,-108
1709,1,0,23,0,-23
1710,1,1,56,1533,1477
1711,0,0,19,0,-19
1712,0,0,9,0,-9
1713,1,0,30,0,-30
1714,0,0,60,0,-60
1715,1,1,551,1251,700
1716,0,0,80,0,-80
1717,1,0,16,0,-16
1718,1,1,177,1767,1590
1719,1,1,46,1278,1232
1720,1,1,149,1219,1070
1721,1,0,103,0,-103
1722,0,0,36,0,-36
1723,1,0,80,0,-80
1724,1,0,41,0,-41
1725,1,0,28,0,-28
1726,1,1,100,1270,1170
1727,1,1,79,2313,2234
1728,1,1,727,2275,1548
1729,0,0,18,0,-18
1730,1,1,342,1358,1016
1731,0,0,6,0,-6
1732,1,0,7,0,-7
1733,0,0,17,0,-17
1734,1,1,313,1539,1226
1735,1,0,111,0,-111
1736,1,1,422,1561,1139
1737,1,1,566,2054,1488
1738,1,0,36,0,-36
1739,1,0,45,0,-45
1740,1,0,35,0,-35
1741,0,0,10,0,-10
1742,0,0,10,0,-10
1743,1,0,42,0,-42
1744,1,1,766,1442,676
1745,1,0,59,0,-59
1746,1,1,487,1547,1060
1747,0,0,50,0,-50
1748,1,0,77,0,-77
1749,1,0,117,0,-117
1750,1,0,12,0,-12
1751,1,0,63,0,-63
1752,1,0,1,0,-1
1753,0,0,4,0,-4
1754,1,1,329,1205,876
1755,0,0,301,0,-301
1756,1,1,94,1493,1399
1757,0,0,20,0,-20
1758,1,0,182,0,-182
1759,1,0,9,0,-9
1760,1,1,303,2066,1763
1761,1,1,1513,1328,-185
1762,0,0,9,0,-9
1763,1,1,326,1538,1212
1764,1,1,936,1211,275
1765,1,1,22,1351,1329
1766,0,0,194,0,-194
1767,0,0,27,0,-27
1768,1,1,392,1372,980
1769,1,0,4,0,-4
1770,0,0,129,0,-129
1771,0,0,5,0,-5
1772,1,1,729,2471,1742
1773,0,0,57,0,-57
1774,1,1,530,1204,674
1775,0,0,45,0,-45
1776,0,0,3,0,-3
1777,0,0,12,0,-12
1778,1,1,288,1564,1276
1779,1,0,26,0,-26
1780,0,0,58,0,-58
1781,0,0,114,0,-114
1782,1,1,522,1305,783
1783,1,1,242,1832,1590
1784,1,0,21,0,-21
1785,1,1,249,2635,2386
1786,0,0,79,0,-79
1787,0,0,13,0,-13
1788,0,0,110,0,-110
1789,1,1,910,1424,514
1790,1,1,799,1572,773
1791,0,0,10,0,-10
1792,0,0,35,0,-35
1793,1,1,681,1264,583
1794,1,0,5,0,-5
1795,1,1,1111,1215,104
1796,0,0,29,0,-29
1797,1,0,0,0,0
1798,0,0,14,0,-14
1799,1,1,520,1464,944
1800,1,1,716,1245,529
1801,0,0,17,0,-17
1802,1,1,230,2572,2342
1803,0,0,177,0,-177
1804,1,0,87,0,-87
1805,1,0,13,0,-13
1806,0,0,145,0,-145
1807,0,0,63,0,-63
1808,1,0,33,0,-33
1809,0,0,62,0,-62
1810,0,0,36,0,-36
1811,1,1,687,1522,835
1812,1,0,61,0,-61
1813,1,1,645,1914,1269
1814,0,0,85,0,-85
1815,0,0,29,0,-29
1816,1,0,0,0,0
1817,0,0,106,0,-106
1818,0,0,65,0,-65
1819,1,0,94,0,-94
1820,1,1,226,1370,1144
1821,1,0,4,0,-4
1822,1,1,37,1274,1237
1823,0,0,7,0,-7
1824,1,1,182,1324,1142
1825,1,0,17,0,-17
1826,1,0,1,0,-1
1827,1,1,658,1493,835
1828,1,1,338,1370,1032
1829,0,0,60,0,-60
1830,1,0,11,0,-11
1831,1,1,49,2032,1983
1832,1,1,411,3050,2639
1833,1,0,83,0,-83
1834,0,0,25,0,-25
1835,0,0,11,0,-11
1836,1,1,526,1203,677
1837,0,0,26,0,-26
1838,0,0,18,0,-18
1839,0,0,88,0,-88
1840,1,1,995,1559,564
1841,1,1,1220,1456,236
1842,0,0,14,0,-14
1843,1,0,24,0,-24
1844,0,0,17,0,-17
1845,1,1,2252,1369,-883
1846,0,0,66,0,-66
1847,1,1,523,1725,1202
1848,0,0,19,0,-19
1849,0,0,6,0,-6
1850,0,0,352,0,-352
1851,1,0,40,0,-40
1852,0,0,81,0,-81
1853,1,0,1,0,-1
1854,1,0,28,0,-28
1855,1,1,622,1277,655
1856,0,0,16,0,-16
1857,1,1,110,1418,1308
1858,0,0,74,0,-74
1859,1,1,147,1522,1375
1860,1,0,30,0,-30
1861,1,0,8,0,-8
1862,1,1,181,1240,1059
1863,0,0,13,0,-13
1864,1,0,36,0,-36
1865,0,0,27,0,-27
1866,0,0,36,0,-36
1867,1,0,10,0,-10
1868,0,0,49,0,-49
1869,1,1,217,1725,1508
1870,0,0,71,0,-71
1871,1,1,1284,1876,592
1872,1,0,20,0,-20
1873,1,0,10,0,-10
1874,0,0,16,0,-16
1875,1,1,218,1269,1051
1876,0,0,176,0,-176
1877,0,0,84,0,-84
1878,0,0,34,0,-34
1879,0,0,57,0,-57
1880,0,0,44,0,-44
1881,1,1,1934,1388,-546
1882,0,0,93,0,-93
1883,1,1,31,1640,1609
1884,0,0,51,0,-51
1885,0,0,0,0,0
1886,0,0,0,0,0
1887,0,0,22,0,-22
1888,1,1,695,2089,1394
1889,0,0,21,0,-21
1890,1,0,33,0,-33
1891,1,1,132,1312,1180
1892,1,0,70,0,-70
1893,1,1,47,1846,1799
1894,1,0,24,0,-24
1895,1,1,207,1366,1159
1896,1,0,55,0,-55
1897,0,0,83,0,-83
1898,1,0,53,0,-53
1899,0,0,241,0,-241
1900,0,0,81,0,-81
1901,0,0,64,0,-64
1902,1,0,66,0,-66
1903,1,0,26,0,-26
1904,0,0,9,0,-9
1905,1,1,687,1345,658
1906,1,1,1115,3745,2630
1907,1,1,239,1428,1189
1908,1,1,98,1452,1354
1909,1,1,163,1290,1127
1910,0,0,36,0,-36
1911,1,1,685,1504,819
1912,0,0,96,0,-96
1913,0,0,136,0,-136
1914,0,0,27,0,-27
1915,1,0,30,0,-30
1916,1,1,1613,1659,46
1917,0,0,67,0,-67
1918,0,0,32,0,-32
1919,1,0,233,0,-233
1920,0,0,5,0,-5
1921,1,0,27,0,-27
1922,1,1,356,1413,1057
1923,0,0,63,0,-63
1924,0,0,47,0,-47
1925,0,0,149,0,-149
1926,1,0,216,0,-216
1927,1,1,2076,1418,-658
1928,0,0,114,0,-114
1929,0,0,25,0,-25
1930,0,0,59,0,-59
1931,1,1,1178,1297,119
1932,0,0,25,0,-25
1933,1,0,31,0,-31
1934,1,1,387,1297,910
1935,1,1,220,1724,1504
1936,0,0,0,0,0
1937,1,1,757,1974,1217
1938,1,0,74,0,-74
1939,0,0,159,0,-159
1940,1,1,1130,1617,487
1941,1,0,11,0,-11
1942,1,1,570,1438,868
1943,0,0,45,0,-45
1944,1,1,126,1205,1079
1945,0,0,106,0,-106
1946,1,1,2883,1858,-1025
1947,0,0,1,0,-1
1948,0,0,25,0,-25
1949,0,0,1,0,-1
1950,1,1,538,1252,714
1951,0,0,117,0,-117
1952,1,0,77,0,-77
1953,0,0,133,0,-133
1954,0,0,36,0,-36
1955,0,0,145,0,-145
1956,0,0,37,0,-37
1957,0,0,7,0,-7
1958,1,0,56,0,-56
1959,0,0,3,0,-3
1960,1,1,340,1239,899
1961,1,1,1264,1249,-15
1962,1,0,23,0,-23
1963,1,0,12,0,-12
1964,1,1,194,1635,1441
1965,0,0,124,0,-124
1966,1,1,471,1307,836
1967,1,1,1317,1226,-91
1968,1,1,206,1554,1348
1969,0,0,7,0,-7
1970,0,0,40,0,-40
1971,0,0,12,0,-12
1972,1,1,331,1483,1152
1973,0,0,37,0,-37
1974,0,0,46,0,-46
1975,1,1,198,1286,1088
1976,1,0,9,0,-9
1977,0,0,32,0,-32
1978,0,0,10,0,-10
1979,1,1,549,1978,1429
1980,1,0,252,0,-252
1981,0,0,58,0,-58
1982,1,1,111,1289,1178
1983,0,0,34,0,-34
1984,1,1,1212,1235,23
1985,1,0,1,0,-1
1986,1,1,225,1341,1116
1987,1,1,78,3266,3188
1988,0,0,76,0,-76
1989,1,0,16,0,-16
1990,1,1,1707,1769,62
1991,1,1,1304,1238,-66
1992,1,1,1096,1385,289
1993,1,0,78,0,-78
1994,0,0,18,0,-18
1995,1,1,578,1218,640
1996,1,0,28,0,-28
1997,1,0,54,0,-54
1998,1,1,963,1252,289
1999,0,0,219,0,-219
2000,0,0,86,0,-86
2001,0,0,7,0,-7
2002,0,0,22,0,-22
2003,0,0,43,0,-43
2004,0,0,13,0,-13
2005,1,1,648,1362,714
2006,1,1,597,1633,1036
2007,1,1,399,3166,2767
2008,0,0,70,0,-70
2009,0,0,71,0,-71
2010,1,0,108,0,-108
2011,0,0,46,0,-46
2012,0,0,1,0,-1
2013,0,0,3,0,-3
2014,1,0,22,0,-22
2015,0,0,30,0,-30
2016,1,1,852,1755,903
2017,0,0,25,0,-25
2018,1,0,71,0,-71
2019,1,1,303,1313,1010
2020,1,1,567,1576,1009
2021,0,0,106,0,-106
2022,1,0,113,0,-113
2023,1,1,852,1221,369
2024,0,0,20,0,-20
2025,1,1,107,1350,1243
2026,1,1,500,1236,736
2027,0,0,2,0,-2
2028,1,1,353,1774,1421
2029,1,0,87,0,-87
2030,1,1,234,1513,1279
2031,0,0,48,0,-48
2032,0,0,54,0,-54
2033,0,0,58,0,-58
2034,0,0,32,0,-32
2035,0,0,6,0,-6
2036,1,0,25,0,-25
2037,1,1,11,1203,1192
2038,0,0,10,0,-10
2039,1,0,249,0,-249
2040,1,1,156,1293,1137
2041,1,1,762,1733,971
2042,0,0,51,0,-51
2043,1,1,389,1432,1043
2044,1,1,159,1561,1402
2045,1,1,786,1782,996
2046,0,0,26,0,-26
2047,0,0,9,0,-9
2048,1,0,26,0,-26
2049,1,0,59,0,-59
2050,1,0,12,0,-12
2051,1,0,16,0,-16
2052,1,0,22,0,-22
2053,1,1,1479,2091,612
2054,1,0,9,0,-9
2055,0,0,19,0,-19
2056,0,0,96,0,-96
2057,0,0,6,0,-6
2058,0,0,28,0,-28
2059,0,0,62,0,-62
2060,0,0,103,0,-103
2061,1,0,49,0,-49
2062,0,0,8,0,-8
2063,0,0,212,0,-212
2064,0,0,90,0,-90
2065,0,0,30,0,-30
2066,1,1,365,1232,867
2067,1,0,28,0,-28
2068,1,0,1,0,-1
2069,0,0,3,0,-3
2070,1,0,26,0,-26
2071,0,0,165,0,-165
2072,0,0,3,0,-3
2073,1,1,285,1209,924
2074,1,0,21,0,-21
2075,0,0,13,0,-13
2076,1,1,333,1599,1266
2077,1,0,71,0,-71
2078,0,0,41,0,-41
2079,0,0,15,0,-15
2080,1,0,36,0,-36
2081,0,0,24,0,-24
2082,0,0,13,0,-13
2083,1,1,1388,2915,1527
2084,0,0,17,0,-17
2085,0,0,90,0,-90
2086,0,0,12,0,-12
2087,0,0,137,0,-137
2088,1,0,4,0,-4
2089,1,0,38,0,-38
2090,0,0,62,0,-62
2091,0,0,42,0,-42
2092,1,1,228,1549,1321
2093,0,0,7,0,-7
2094,1,0,8,0,-8
2095,0,0,0,0,0
2096,0,0,14,0,-14
2097,1,1,496,2132,1636
2098,1,1,1648,1372,-276
2099,0,0,133,0,-133
2100,1,1,1424,1227,-197
2101,0,0,22,0,-22
2102,0,0,25,0,-25
2103,0,0,50,0,-50
2104,0,0,62,0,-62
2105,0,0,35,0,-35
2106,1,0,16,0,-16
2107,1,0,89,0,-89
2108,0,0,10,0,-10
2109,0,0,3,0,-3
2110,1,0,37,0,-37
2111,0,0,33,0,-33
2112,0,0,49,0,-49
2113,1,1,837,1285,448
2114,1,1,784,2034,1250
2115,0,0,4,0,-4
2116,0,0,11,0,-11
2117,1,0,99,0,-99
2118,0,0,17,0,-17
2119,1,0,68,0,-68
2120,0,0,6,0,-6
2121,1,1,307,1274,967
2122,0,0,23,0,-23
2123,0,0,18,0,-18
2124,1,0,5,0,-5
2125,1,1,680,1545,865
2126,1,1,41,1322,1281
2127,0,0,8,0,-8
2128,1,1,89,1233,1144
2129,1,0,1,0,-1
2130,0,0,49,0,-49
2131,0,0,49,0,-49
2132,1,1,156,1203,1047
2133,0,0,164,0,-164
2134,0,0,18,0,-18
2135,1,1,147,1729,1582
2136,1,1,177,1268,1091
2137,1,0,53,0,-53
2138,0,0,2,0,-2
2139,1,1,283,2005,1722
2140,1,1,10,1531,1521
2141,1,0,7,0,-7
2142,0,0,17,0,-17
2143,0,0,36,0,-36
2144,1,1,27,1380,1353
2145,1,1,161,1238,1077
2146,0,0,18,0,-18
2147,1,1,500,2538,2038
2148,0,0,30,0,-30
2149,1,1,511,1410,899
2150,1,1,23,1411,1388
2151,1,0,4,0,-4
2152,0,0,56,0,-56
2153,1,0,79,0,-79
2154,1,0,25,0,-25
2155,1,0,57,0,-57
2156,1,0,25,0,-25
2157,0,0,17,0,-17
2158,0,0,57,0,-57
2159,0,0,6,0,-6
2160,0,0,41,0,-41
2161,0,0,19,0,-19
2162,1,1,265,1247,982
2163,0,0,58,0,-58
2164,1,0,51,0,-51
2165,0,0,132,0,-132
2166,0,0,39,0,-39
2167,0,0,155,0,-155
2168,0,0,13,0,-13
2169,1,1,658,1473,815
2170,1,1,423,2181,1758
2171,1,1,1938,1237,-701
2172,1,1,455,1473,1018
2173,0,0,73,0,-73
2174,0,0,21,0,-21
2175,0,0,95,0,-95
2176,1,0,37,0,-37
2177,1,1,492,1281,789
2178,1,1,275,1496,1221
2179,0,0,93,0,-93
2180,1,1,359,1279,920
2181,0,0,187,0,-187
2182,0,0,23,0,-23
2183,0,0,65,0,-65
2184,0,0,75,0,-75
2185,1,1,136,1405,1269
2186,0,0,32,0,-32
2187,0,0,8,0,-8
2188,0,0,22,0,-22
2189,1,0,9,0,-9
2190,1,1,85,1394,1309
2191,1,0,9,0,-9
2192,1,1,121,1363,1242
2193,0,0,70,0,-70
2194,1,1,423,2114,1691
2195,1,0,66,0,-66
2196,1,0,73,0,-73
2197,1,0,29,0,-29
2198,0,0,67,0,-67
2199,1,0,1,0,-1
2200,0,0,36,0,-36
2201,1,0,12,0,-12
2202,1,1,251,1345,1094
2203,1,1,510,2528,2018
2204,1,0,12,0,-12
2205,0,0,19,0,-19
2206,1,1,1275,1539,264
2207,1,0,87,0,-87
2208,0,0,177,0,-177
2209,0,0,80,0,-80
2210,1,0,47,0,-47
2211,1,1,422,1257,835
2212,0,0,11,0,-11
2213,1,0,16,0,-16
2214,0,0,30,0,-30
2215,0,0,1,0,-1
2216,0,0,14,0,-14
2217,1,0,50,0,-50
2218,1,1,672,1224,552
2219,1,0,93,0,-93
2220,1,0,136,0,-136
2221,1,0,6,0,-6
2222,1,1,192,1333,1141
2223,1,1,274,2441,2167
2224,1,1,476,1287,811
2225,0,0,4,0,-4
2226,0,0,8,0,-8
2227,0,0,11,0,-11
2228,0,0,11,0,-11
2229,0,0,157,0,-157
2230,1,0,5,0,-5
2231,0,0,53,0,-53
2232,1,1,781,1570,789
2233,1,0,120,0,-120
2234,1,1,82,1563,1481
2235,1,0,57,0,-57
2236,0,0,23,0,-23
2237,1,0,14,0,-14
2238,0,0,5,0,-5
2239,0,0,237,0,-237
2240,1,1,915,1454,539
2241,0,0,60,0,-60
2242,0,0,32,0,-32
2243,1,0,29,0,-29
2244,1,1,369,1202,833
2245,1,0,4,0,-4
2246,0,0,61,0,-61
2247,0,0,5,0,-5
2248,1,1,130,1240,1110
2249,1,1,1062,1260,198
2250,0,0,23,0,-23
2251,1,1,240,1370,1130
2252,1,0,36,0,-36
2253,0,0,58,0,-58
2254,1,0,59,0,-59
2255,0,0,104,0,-104
2256,1,1,1128,1254,126
2257,1,0,61,0,-61
2258,0,0,159,0,-159
2259,0,0,20,0,-20
2260,0,0,44,0,-44
2261,1,0,9,0,-9
2262,1,1,772,1215,443
2263,1,0,3,0,-3
2264,0,0,24,0,-24
2265,0,0,12,0,-12
2266,1,0,10,0,-10
2267,1,1,529,1631,1102
2268,1,0,41,0,-41
2269,1,1,455,1687,1232
2270,0,0,48,0,-48
2271,0,0,33,0,-33
2272,0,0,35,0,-35
2273,1,1,773,1432,659
2274,1,0,31,0,-31
2275,1,1,111,1356,1245
2276,1,0,5,0,-5
2277,0,0,150,0,-150
2278,0,0,90,0,-90
2279,1,1,403,1435,1032
2280,1,1,317,1560,1243
2281,0,0,66,0,-66
2282,1,0,6,0,-6
2283,1,1,608,1221,613
2284,1,1,316,1600,1284
2285,1,1,344,2073,1729
2286,1,0,0,0,0
2287,1,0,13,0,-13
2288,0,0,7,0,-7
2289,0,0,185,0,-185
2290,0,0,61,0,-61
2291,1,1,81,1285,1204
2292,1,0,3,0,-3
2293,1,1,110,2189,2079
2294,1,1,255,1633,1378
2295,1,0,14,0,-14
2296,1,0,9,0,-9
2297,1,0,29,0,-29
2298,1,1,1081,1299,218
2299,1,1,487,1247,760
2300,0,0,35,0,-35
2301,1,1,51,1559,1508
2302,1,1,44,1411,1367
2303,1,1,554,2082,1528
2304,1,1,273,1232,959
2305,0,0,12,0,-12
2306,0,0,15,0,-15
2307,1,1,701,1348,647
2308,0,0,68,0,-68
2309,1,0,119,0,-119
2310,1,1,520,1232,712
2311,1,1,259,1933,1674
2312,1,0,78,0,-78
2313,1,0,29,0,-29
2314,0,0,67,0,-67
2315,1,0,8,0,-8
2316,0,0,35,0,-35
2317,1,0,108,0,-108
2318,1,1,116,2704,2588
2319,0,0,37,0,-37
2320,1,1,1030,1285,255
2321,1,1,488,1362,874
2322,1,0,0,0,0
2323,1,0,50,0,-50
2324,1,0,75,0,-75
2325,0,0,181,0,-181
2326,0,0,34,0,-34
2327,1,1,169,1351,1182
2328,1,0,12,0,-12
2329,1,1,111,1216,1105
2330,1,0,218,0,-218
2331,1,1,339,1305,966
2332,1,0,16,0,-16
2333,1,0,63,0,-63
2334,0,0,26,0,-26
2335,1,1,177,1224,1047
2336,0,0,125,0,-125
2337,1,0,11,0,-11
2338,1,1,2446,1295,-1151
2339,0,0,41,0,-41
2340,0,0,89,0,-89
2341,1,0,204,0,-204
2342,0,0,39,0,-39
2343,0,0,36,0,-36
2344,1,1,512,1340,828
2345,1,0,12,0,-12
2346,0,0,147,0,-147
2347,1,1,1572,1765,193
2348,0,0,12,0,-12
2349,0,0,4,0,-4
2350,1,1,504,2953,2449
2351,1,0,79,0,-79
2352,0,0,50,0,-50
2353,0,0,91,0,-91
2354,0,0,145,0,-145
2355,0,0,76,0,-76
2356,0,0,107,0,-107
2357,1,0,30,0,-30
2358,1,0,65,0,-65
2359,1,0,166,0,-166
2360,1,1,696,1355,659
2361,0,0,30,0,-30
2362,1,0,127,0,-127
2363,1,1,70,1603,1533
2364,1,1,171,1217,1046
2365,1,1,440,1237,797
2366,1,1,258,1692,1434
2367,0,0,43,0,-43
2368,1,0,52,0,-52
2369,1,0,17,0,-17
2370,1,1,113,2341,2228
2371,0,0,82,0,-82
2372,1,1,1027,1746,719
2373,0,0,20,0,-20
2374,0,0,74,0,-74
2375,0,0,11,0,-11
2376,0,0,3,0,-3
2377,1,0,15,0,-15
2378,1,1,407,1401,994
2379,0,0,4,0,-4
2380,1,1,232,1280,1048
2381,1,0,44,0,-44
2382,1,0,20,0,-20
2383,1,1,412,1418,1006
2384,0,0,53,0,-53
2385,1,0,71,0,-71
2386,1,0,41,0,-41
2387,1,0,49,0,-49
2388,0,0,11,0,-11
2389,1,1,1289,1476,187
2390,1,0,18,0,-18
2391,1,1,221,1646,1425
2392,1,1,307,2152,1845
2393,0,0,83,0,-83
2394,1,0,94,0,-94
2395,1,1,48,1698,1650
2396,0,0,16,0,-16
2397,0,0,4,0,-4
2398,0,0,2,0,-2
2399,1,1,772,1200,428
2400,1,0,10,0,-10
2401,1,1,1029,1230,201
2402,1,1,159,1471,1312
2403,0,0,49,0,-49
2404,1,1,1543,1354,-189
2405,1,0,19,0,-19
2406,1,1,384,1252,868
2407,0,0,37,0,-37
2408,0,0,0,0,0
2409,0,0,14,0,-14
2410,0,0,13,0,-13
2411,1,0,2,0,-2
2412,0,0,59,0,-59
2413,1,0,4,0,-4
2414,1,0,72,0,-72
2415,1,1,475,1957,1482
2416,1,1,225,1219,994
2417,0,0,17,0,-17
2418,0,0,36,0,-36
2419,0,0,104,0,-104
2420,1,1,1057,1662,605
2421,1,1,313,1278,965
2422,1,1,484,1318,834
2423,1,1,1104,1792,688
2424,1,0,36,0,-36
2425,0,0,173,0,-173
2426,0,0,7,0,-7
2427,0,0,8,0,-8
2428,1,0,1,0,-1
2429,1,0,40,0,-40
2430,1,1,135,1582,1447
2431,0,0,48,0,-48
2432,1,0,18,0,-18
2433,1,0,58,0,-58
2434,0,0,62,0,-62
2435,1,0,1,0,-1
2436,0,0,119,0,-119
2437,0,0,61,0,-61
2438,0,0,33,0,-33
2439,0,0,33,0,-33
2440,0,0,345,0,-345
2441,0,0,91,0,-91
2442,0,0,42,0,-42
2443,1,0,0,0,0
2444,0,0,5,0,-5
2445,1,1,468,1383,915
2446,0,0,62,0,-62
2447,1,0,0,0,0
2448,1,1,825,2015,1190
2449,1,0,101,0,-101
2450,1,1,119,1388,1269
2451,0,0,42,0,-42
2452,0,0,50,0,-50
2453,1,0,25,0,-25
2454,0,0,33,0,-33
2455,0,0,16,0,-16
2456,0,0,21,0,-21
2457,1,0,20,0,-20
2458,0,0,12,0,-12
2459,1,1,1204,1793,589
2460,1,1,90,2362,2272
2461,1,1,1032,1445,413
2462,1,1,266,1244,978
2463,1,1,632,1404,772
2464,1,0,43,0,-43
2465,1,0,21,0,-21
2466,1,1,141,3393,3252
2467,1,0,3,0,-3
2468,1,0,47,0,-47
2469,1,1,209,1341,1132
2470,0,0,66,0,-66
2471,1,1,325,1222,897
2472,0,0,14,0,-14
2473,0,0,120,0,-120
2474,1,1,315,1272,957
2475,1,0,36,0,-36
2476,1,1,351,1607,1256
2477,1,1,65,1470,1405
2478,0,0,27,0,-27
2479,1,1,877,2076,1199
2480,1,1,70,1353,1283
2481,1,1,74,1637,1563
2482,1,0,88,0,-88
2483,0,0,8,0,-8
2484,0,0,106,0,-106
2485,1,0,56,0,-56
2486,0,0,38,0,-38
2487,1,1,413,1253,840
2488,0,0,69,0,-69
2489,1,1,226,1232,1006
2490,0,0,39,0,-39
2491,1,1,251,1937,1686
2492,1,0,9,0,-9
2493,1,0,45,0,-45
2494,0,0,0,0,0
2495,1,0,59,0,-59
2496,0,0,44,0,-44
2497,1,1,234,1255,1021
2498,0,0,44,0,-44
2499,1,1,468,1241,773
2500,1,1,83,1369,1286
2501,1,1,361,1818,1457
2502,1,0,61,0,-61
2503,1,0,3,0,-3
2504,1,1,938,1511,573
2505,0,0,8,0,-8
2506,0,0,29,0,-29
2507,1,1,182,1439,1257
2508,1,0,71,0,-71
2509,0,0,205,0,-205
2510,1,0,66,0,-66
2511,1,0,26,0,-26
2512,1,1,194,1599,1405
2513,1,0,71,0,-71
2514,1,1,1324,1469,145
2515,1,1,463,1319,856
2516,1,0,32,0,-32
2517,1,0,24,0,-24
2518,1,0,20,0,-20
2519,1,0,78,0,-78
2520,0,0,6,0,-6
2521,1,1,246,1437,1191
2522,1,1,227,1590,1363
2523,1,0,23,0,-23
2524,0,0,66,0,-66
2525,0,0,60,0,-60
2526,0,0,40,0,-40
2527,0,0,89,0,-89
2528,0,0,133,0,-133
2529,0,0,57,0,-57
2530,1,0,0,0,0
2531,1,0,36,0,-36
2532,1,0,66,0,-66
2533,1,0,26,0,-26
2534,1,1,523,1252,729
2535,0,0,48,0,-48
2536,1,0,4,0,-4
2537,1,0,9,0,-9
2538,0,0,170,0,-170
2539,1,1,845,1345,500
2540,1,1,2360,1790,-570
2541,1,1,1586,2628,1042
2542,1,1,218,1649,1431
2543,0,0,18,0,-18
2544,0,0,105,0,-105
2545,0,0,44,0,-44
2546,0,0,1,0,-1
2547,1,0,106,0,-106
2548,1,0,229,0,-229
2549,1,0,32,0,-32
2550,1,0,13,0,-13
2551,1,0,131,0,-131
2552,0,0,11,0,-11
2553,0,0,9,0,-9
2554,0,0,49,0,-49
2555,0,0,24,0,-24
2556,0,0,23,0,-23
2557,0,0,49,0,-49
2558,0,0,31,0,-31
2559,1,1,617,1213,596
2560,1,1,204,2196,1992
2561,1,1,1085,1473,388
2562,1,1,4,1906,1902
2563,1,0,29,0,-29
2564,0,0,31,0,-31
2565,0,0,19,0,-19
2566,1,0,46,0,-46
2567,1,1,385,1263,878
2568,0,0,73,0,-73
2569,1,1,413,1216,803
2570,1,1,328,1411,1083
2571,0,0,7,0,-7
2572,0,0,8,0,-8
2573,0,0,114,0,-114
2574,1,1,241,1478,1237
2575,0,0,66,0,-66
2576,1,0,14,0,-14
2577,0,0,5,0,-5
2578,0,0,0,0,0
2579,1,1,243,1634,1391
2580,1,1,136,1241,1105
2581,0,0,18,0,-18
2582,0,0,0,0,0
2583,0,0,126,0,-126
2584,1,0,132,0,-132
2585,0,0,41,0,-41
2586,1,1,901,1406,505
2587,1,0,179,0,-179
2588,0,0,5,0,-5
2589,0,0,43,0,-43
2590,0,0,144,0,-144
2591,1,0,7,0,-7
2592,1,1,232,1370,1138
2593,1,1,482,1611,1129
2594,0,0,5,0,-5
2595,0,0,8,0,-8
2596,1,0,1,0,-1
2597,1,1,482,1221,739
2598,0,0,68,0,-68
2599,1,0,22,0,-22
2600,1,0,31,0,-31
2601,0,0,8,0,-8
2602,0,0,189,0,-189
2603,1,0,92,0,-92
2604,1,0,73,0,-73
2605,1,0,47,0,-47
2606,1,1,846,1467,621
2607,1,0,152,0,-152
2608,1,0,88,0,-88
2609,0,0,54,0,-54
2610,1,0,156,0,-156
2611,1,0,108,0,-108
2612,1,1,453,1498,1045
2613,0,0,10,0,-10
2614,1,0,34,0,-34
2615,0,0,37,0,-37
2616,1,0,14,0,-14
2617,1,0,1,0,-1
2618,1,1,586,1202,616
2619,1,1,1457,1299,-158
2620,1,1,274,1219,945
2621,0,0,74,0,-74
2622,1,0,201,0,-201
2623,0,0,190,0,-190
2624,1,1,397,1315,918
2625,1,0,5,0,-5
2626,1,0,40,0,-40
2627,0,0,21,0,-21
2628,1,1,133,1641,1508
2629,1,1,459,1355,896
2630,1,1,1192,1239,47
2631,0,0,29,0,-29
2632,1,0,22,0,-22
2633,1,1,580,1466,886
2634,0,0,28,0,-28
2635,1,1,871,1312,441
2636,0,0,84,0,-84
2637,1,1,141,1906,1765
2638,0,0,97,0,-97
2639,1,1,8,1303,1295
2640,0,0,35,0,-35
2641,0,0,6,0,-6
2642,1,1,143,1297,1154
2643,1,1,589,1547,958
2644,1,0,15,0,-15
2645,1,1,2710,1207,-1503
2646,1,1,630,1293,663
2647,0,0,11,0,-11
2648,1,0,3,0,-3
2649,0,0,11,0,-11
2650,1,1,457,1264,807
2651,0,0,67,0,-67
2652,0,0,17,0,-17
2653,1,1,724,1266,542
2654,1,0,111,0,-111
2655,1,1,320,1241,921
2656,0,0,68,0,-68
2657,1,1,566,5351,4785
2658,1,1,823,2653,1830
2659,0,0,27,0,-27
2660,1,0,59,0,-59
2661,0,0,73,0,-73
2662,1,1,572,1445,873
2663,0,0,47,0,-47
2664,0,0,29,0,-29
2665,1,0,19,0,-19
2666,1,1,697,3316,2619
2667,1,1,459,1524,1065
2668,1,1,718,1926,1208
2669,0,0,91,0,-91
2670,1,0,26,0,-26
2671,1,1,853,1204,351
2672,1,0,83,0,-83
2673,1,1,132,1321,1189
2674,1,1,378,3194,2816
2675,1,1,677,1532,855
2676,0,0,26,0,-26
2677,1,0,10,0,-10
2678,0,0,49,0,-49
2679,1,0,112,0,-112
2680,1,1,591,1245,654
2681,1,1,589,1560,971
2682,1,1,16,1449,1433
2683,0,0,29,0,-29
2684,0,0,3,0,-3
2685,0,0,80,0,-80
2686,1,1,225,1895,1670
2687,1,0,72,0,-72
2688,1,1,366,1397,1031
2689,1,1,188,1305,1117
2690,1,0,97,0,-97
2691,1,0,46,0,-46
2692,0,0,210,0,-210
2693,0,0,26,0,-26
2694,1,0,6,0,-6
2695,0,0,23,0,-23
2696,1,0,67,0,-67
2697,0,0,7,0,-7
2698,1,0,182,0,-182
2699,1,1,102,1699,1597
2700,1,1,173,1508,1335
2701,1,0,13,0,-13
2702,0,0,100,0,-100
2703,1,1,245,1238,993
2704,0,0,108,0,-108
2705,1,0,33,0,-33
2706,1,0,3,0,-3
2707,1,0,27,0,-27
2708,1,0,27,0,-27
2709,0,0,6,0,-6
2710,1,0,12,0,-12
2711,1,0,67,0,-67
2712,0,0,39,0,-39
2713,0,0,7,0,-7
2714,0,0,16,0,-16
2715,1,0,1,0,-1
2716,0,0,40,0,-40
2717,1,0,36,0,-36
2718,1,1,543,1522,979
2719,1,1,765,1391,626
2720,1,0,154,0,-154
2721,1,1,1036,4575,3539
2722,1,1,1480,1737,257
2723,1,1,630,2095,1465
2724,1,0,26,0,-26
2725,1,1,636,1550,914
2726,0,0,116,0,-116
2727,1,1,428,1272,844
2728,0,0,222,0,-222
2729,1,1,559,1498,939
2730,0,0,30,0,-30
2731,1,1,645,1524,879
2732,0,0,130,0,-130
2733,1,1,298,1266,968
2734,0,0,2,0,-2
2735,1,1,336,1678,1342
2736,0,0,138,0,-138
2737,1,0,15,0,-15
2738,1,1,465,1750,1285
2739,0,0,16,0,-16
2740,0,0,2,0,-2
2741,0,0,32,0,-32
2742,0,0,17,0,-17
2743,1,1,115,1397,1282
2744,1,0,25,0,-25
2745,0,0,27,0,-27
2746,1,0,50,0,-50
2747,0,0,65,0,-65
2748,1,0,45,0,-45
2749,0,0,28,0,-28
2750,0,0,70,0,-70
2751,0,0,143,0,-143
2752,1,0,53,0,-53
2753,1,0,47,0,-47
2754,0,0,7,0,-7
2755,0,0,9,0,-9
2756,1,1,284,1394,1110
2757,1,1,1796,1516,-280
2758,1,1,897,1420,523
2759,1,1,1218,1398,180
2760,0,0,28,0,-28
2761,1,1,74,1200,1126
2762,1,0,40,0,-40
2763,0,0,17,0,-17
2764,1,0,48,0,-48
2765,1,1,176,1274,1098
2766,1,0,58,0,-58
2767,0,0,12,0,-12
2768,1,0,78,0,-78
2769,0,0,71,0,-71
2770,0,0,84,0,-84
2771,1,1,541,1202,661
2772,0,0,28,0,-28
2773,0,0,48,0,-48
2774,1,0,20,0,-20
2775,1,0,32,0,-32
2776,0,0,114,0,-114
2777,1,0,17,0,-17
2778,1,0,89,0,-89
2779,1,0,41,0,-41
2780,1,0,110,0,-110
2781,1,0,38,0,-38
2782,1,1,199,1733,1534
2783,0,0,11,0,-11
2784,0,0,52,0,-52
2785,0,0,60,0,-60
2786,1,1,562,1410,848
2787,0,0,101,0,-101
2788,1,1,1032,1248,216
2789,1,0,37,0,-37
2790,1,0,47,0,-47
2791,1,1,549,1449,900
2792,1,1,396,1327,931
2793,0,0,183,0,-183
2794,1,1,539,1306,767
2795,1,1,382,2156,1774
2796,1,0,2,0,-2
2797,0,0,28,0,-28
2798,1,1,1264,1464,200
2799,0,0,1,0,-1
2800,1,1,160,1613,1453
2801,1,0,328,0,-328
2802,1,0,5,0,-5
2803,0,0,65,0,-65
2804,0,0,92,0,-92
2805,1,1,1102,1510,408
2806,1,0,10,0,-10
2807,0,0,349,0,-349
2808,1,0,22,0,-22
2809,0,0,5,0,-5
2810,1,1,210,1288,1078
2811,0,0,21,0,-21
2812,1,0,48,0,-48
2813,0,0,196,0,-196
2814,1,0,83,0,-83
2815,0,0,10,0,-10
2816,0,0,21,0,-21
2817,1,0,104,0,-104
2818,1,1,24,1281,1257
2819,0,0,112,0,-112
2820,1,1,712,1282,570
2821,0,0,25,0,-25
2822,1,1,1204,1315,111
2823,1,0,17,0,-17
2824,1,0,25,0,-25
2825,1,1,1321,1216,-105
2826,1,0,9,0,-9
2827,1,1,825,1518,693
2828,1,1,249,1662,1413
2829,1,1,1113,3199,2086
2830,0,0,38,0,-38
2831,1,1,57,1503,1446
2832,0,0,138,0,-138
2833,1,1,1801,1209,-592
2834,0,0,32,0,-32
2835,0,0,38,0,-38
2836,1,1,175,1328,1153
2837,1,0,75,0,-75
2838,1,1,1093,1815,722
2839,0,0,4,0,-4
2840,1,0,29,0,-29
2841,1,0,18,0,-18
2842,1,1,698,1263,565
2843,0,0,52,0,-52
2844,1,1,663,1826,1163
2845,1,1,607,1260,653
2846,1,1,342,1886,1544
2847,0,0,29,0,-29
2848,0,0,35,0,-35
2849,1,0,29,0,-29
2850,1,0,46,0,-46
2851,1,0,25,0,-25
2852,1,0,134,0,-134
2853,0,0,175,0,-175
2854,1,1,1012,1800,788
2855,0,0,13,0,-13
2856,1,1,1093,1272,179
2857,0,0,45,0,-45
2858,1,0,6,0,-6
2859,0,0,246,0,-246
2860,1,1,1586,1605,19
2861,0,0,1,0,-1
2862,0,0,12,0,-12
2863,1,1,264,1329,1065
2864,0,0,26,0,-26
2865,0,0,28,0,-28
2866,0,0,12,0,-12
2867,0,0,73,0,-73
2868,1,0,123,0,-123
2869,1,0,9,0,-9
2870,1,1,466,1450,984
2871,1,1,287,1727,1440
2872,1,0,10,0,-10
2873,1,1,109,1685,1576
2874,1,1,356,1498,1142
2875,0,0,6,0,-6
2876,1,0,91,0,-91
2877,1,1,315,1367,1052
2878,1,0,59,0,-59
2879,0,0,8,0,-8
2880,1,0,16,0,-16
2881,1,1,321,1257,936
2882,0,0,43,0,-43
2883,1,1,519,1978,1459
2884,1,0,83,0,-83
2885,1,0,22,0,-22
2886,1,0,62,0,-62
2887,0,0,60,0,-60
2888,0,0,125,0,-125
2889,0,0,23,0,-23
2890,1,0,51,0,-51
2891,0,0,0,0,0
2892,1,1,42,1532,1490
2893,1,0,40,0,-40
2894,0,0,71,0,-71
2895,0,0,12,0,-12
2896,0,0,199,0,-199
2897,0,0,10,0,-10
2898,0,0,23,0,-23
2899,0,0,96,0,-96
2900,1,1,297,1445,1148
2901,0,0,42,0,-42
2902,1,1,752,2402,1650
2903,1,0,58,0,-58
2904,0,0,47,0,-47
2905,1,1,311,2078,1767
2906,0,0,67,0,-67
2907,1,1,379,1667,1288
2908,1,0,35,0,-35
2909,0,0,23,0,-23
2910,1,1,125,1470,1345
2911,0,0,4,0,-4
2912,0,0,74,0,-74
2913,1,1,1026,1495,469
2914,1,1,1524,1693,169
2915,1,1,145,1312,1167
2916,1,1,305,1321,1016
2917,1,1,585,1239,654
2918,0,0,30,0,-30
2919,1,0,87,0,-87
2920,1,0,23,0,-23
2921,0,0,26,0,-26
2922,0,0,11,0,-11
2923,1,1,204,1269,1065
2924,1,1,100,1554,1454
2925,0,0,31,0,-31
2926,1,0,4,0,-4
2927,1,0,22,0,-22
2928,0,0,4,0,-4
2929,1,1,117,1293,1176
2930,1,0,45,0,-45
2931,0,0,273,0,-273
2932,1,1,478,1350,872
2933,1,1,267,1548,1281
2934,0,0,47,0,-47
2935,1,1,1196,1237,41
2936,1,1,936,1446,510
2937,0,0,27,0,-27
2938,1,1,23,1837,1814
2939,1,0,60,0,-60
2940,1,1,759,1282,523
2941,1,1,99,1236,1137
2942,0,0,1,0,-1
2943,1,0,23,0,-23
2944,1,0,5,0,-5
2945,0,0,127,0,-127
2946,0,0,19,0,-19
2947,0,0,131,0,-131
2948,1,0,134,0,-134
2949,0,0,2,0,-2
2950,0,0,91,0,-91
2951,1,0,24,0,-24
2952,0,0,39,0,-39
2953,0,0,23,0,-23
2954,1,0,65,0,-65
2955,0,0,281,0,-281
2956,0,0,186,0,-186
2957,1,1,416,1448,1032
2958,0,0,63,0,-63
2959,1,1,878,1617,739
2960,0,0,171,0,-171
2961,0,0,53,0,-53
2962,1,0,80,0,-80
2963,1,1,357,3580,3223
2964,1,0,37,0,-37
2965,1,0,222,0,-222
2966,1,0,187,0,-187
2967,1,1,1520,1675,155
2968,1,1,212,1698,1486
2969,0,0,106,0,-106
2970,1,1,901,1209,308
2971,0,0,82,0,-82
2972,0,0,93,0,-93
2973,0,0,62,0,-62
2974,1,0,88,0,-88
2975,1,0,27,0,-27
2976,1,0,30,0,-30
2977,1,1,806,1364,558
2978,1,0,149,0,-149
2979,1,1,2619,1339,-1280
2980,0,0,13,0,-13
2981,0,0,9,0,-9
2982,1,1,659,2350,1691
2983,1,1,784,1404,620
2984,1,0,113,0,-113
2985,0,0,67,0,-67
2986,1,0,114,0,-114
2987,0,0,19,0,-19
2988,1,1,100,1270,1170
2989,0,0,8,0,-8
2990,0,0,9,0,-9
2991,0,0,63,0,-63
2992,1,0,6,0,-6
2993,1,0,8,0,-8
2994,1,0,22,0,-22
2995,1,0,74,0,-74
2996,1,1,299,1894,1595
2997,1,0,114,0,-114
2998,0,0,6,0,-6
2999,1,0,105,0,-105
3000,0,0,98,0,-98
3001,0,0,43,0,-43
3002,1,0,40,0,-40
3003,0,0,161,0,-161
3004,0,0,61,0,-61
3005,0,0,2,0,-2
3006,0,0,85,0,-85
3007,1,0,60,0,-60
3008,1,1,144,1291,1147
3009,0,0,7,0,-7
3010,0,0,23,0,-23
3011,1,1,693,1556,863
3012,0,0,33,0,-33
3013,1,1,214,1246,1032
3014,0,0,88,0,-88
3015,1,1,382,1449,1067
3016,1,0,18,0,-18
3017,1,0,7,0,-7
3018,1,1,1384,2429,1045
3019,0,0,49,0,-49
3020,1,0,21,0,-21
3021,0,0,136,0,-136
3022,1,1,175,1617,1442
3023,0,0,19,0,-19
3024,0,0,9,0,-9
3025,1,0,148,0,-148
3026,1,0,14,0,-14
3027,1,1,1024,1641,617
3028,1,0,7,0,-7
3029,1,0,34,0,-34
3030,1,0,231,0,-231
3031,1,0,7,0,-7
3032,1,0,40,0,-40
3033,0,0,9,0,-9
3034,1,1,309,1265,956
3035,0,0,16,0,-16
3036,0,0,18,0,-18
3037,0,0,11,0,-11
3038,1,0,69,0,-69
3039,1,0,39,0,-39
3040,1,1,579,2236,1657
3041,0,0,8,0,-8
3042,0,0,45,0,-45
3043,0,0,30,0,-30
3044,0,0,39,0,-39
3045,0,0,56,0,-56
3046,0,0,41,0,-41
3047,0,0,78,0,-78
3048,0,0,7,0,-7
3049,1,1,556,1359,803
3050,0,0,241,0,-241
3051,1,1,958,1559,601
3052,1,0,70,0,-70
3053,0,0,2,0,-2
3054,1,0,79,0,-79
3055,1,1,619,3077,2458
3056,0,0,1,0,-1
3057,1,1,350,1725,1375
3058,1,0,31,0,-31
3059,0,0,112,0,-112
3060,0,0,168,0,-168
3061,1,1,49,2170,2121
3062,0,0,18,0,-18
3063,0,0,9,0,-9
3064,1,0,4,0,-4
3065,0,0,26,0,-26
3066,1,0,49,0,-49
3067,1,0,3,0,-3
3068,0,0,221,0,-221
3069,1,0,11,0,-11
3070,1,0,30,0,-30
3071,0,0,140,0,-140
3072,1,1,496,1399,903
3073,0,0,87,0,-87
3074,1,0,202,0,-202
3075,1,1,231,1247,1016
3076,1,1,412,1418,1006
3077,1,1,430,1619,1189
3078,1,1,756,1237,481
3079,0,0,6,0,-6
3080,1,0,21,0,-21
3081,1,0,34,0,-34
3082,0,0,97,0,-97
3083,1,1,149,1383,1234
3084,0,0,175,0,-175
3085,0,0,13,0,-13
3086,0,0,8,0,-8
3087,1,0,15,0,-15
3088,1,1,215,1316,1101
3089,1,1,955,2863,1908
3090,0,0,42,0,-42
3091,0,0,17,0,-17
3092,0,0,52,0,-52
3093,0,0,28,0,-28
3094,1,1,1859,1215,-644
3095,0,0,81,0,-81
3096,1,0,45,0,-45
3097,1,0,65,0,-65
3098,0,0,7,0,-7
3099,0,0,32,0,-32
3100,0,0,10,0,-10
3101,1,0,19,0,-19
3102,1,1,519,1354,835
3103,1,0,24,0,-24
3104,1,0,8,0,-8
3105,1,0,35,0,-35
3106,1,0,145,0,-145
3107,1,0,36,0,-36
3108,0,0,86,0,-86
3109,1,1,492,1305,813
3110,0,0,80,0,-80
3111,0,0,67,0,-67
3112,1,1,512,1293,781
3113,1,0,2,0,-2
3114,0,0,61,0,-61
3115,1,0,17,0,-17
3116,1,0,6,0,-6
3117,0,0,29,0,-29
3118,1,0,64,0,-64
3119,1,1,539,1410,871
3120,0,0,7,0,-7
3121,1,0,67,0,-67
3122,1,1,160,1937,1777
3123,1,0,43,0,-43
3124,0,0,37,0,-37
3125,0,0,38,0,-38
3126,1,1,1710,1709,-1
3127,1,0,44,0,-44
3128,1,0,37,0,-37
3129,1,0,129,0,-129
3130,0,0,12,0,-12
3131,0,0,2,0,-2
3132,1,0,54,0,-54
3133,1,0,2,0,-2
3134,0,0,42,0,-42
3135,1,1,508,1376,868
3136,1,0,10,0,-10
3137,1,0,46,0,-46
3138,1,1,226,1613,1387
3139,1,0,43,0,-43
3140,1,0,12,0,-12
3141,0,0,10,0,-10
3142,0,0,61,0,-61
3143,1,1,244,1254,1010
3144,0,0,5,0,-5
3145,0,0,43,0,-43
3146,1,0,23,0,-23
3147,0,0,64,0,-64
3148,1,0,56,0,-56
3149,1,0,116,0,-116
3150,1,0,25,0,-25
3151,1,0,72,0,-72
3152,1,1,709,1294,585
3153,0,0,68,0,-68
3154,0,0,94,0,-94
3155,0,0,123,0,-123
3156,0,0,12,0,-12
3157,1,1,240,1239,999
3158,0,0,6,0,-6
3159,1,0,21,0,-21
3160,0,0,4,0,-4
3161,0,0,82,0,-82
3162,1,1,224,2492,2268
3163,1,1,159,1356,1197
3164,0,0,11,0,-11
3165,1,0,11,0,-11
3166,1,1,1506,2584,1078
3167,0,0,4,0,-4
3168,1,0,66,0,-66
3169,1,1,356,1403,1047
3170,0,0,66,0,-66
3171,1,0,18,0,-18
3172,1,1,390,1219,829
3173,0,0,68,0,-68
3174,1,0,169,0,-169
3175,1,0,91,0,-91
3176,0,0,7,0,-7
3177,0,0,33,0,-33
3178,1,0,62,0,-62
3179,1,1,292,1595,1303
3180,0,0,2,0,-2
3181,1,0,74,0,-74
3182,1,1,787,1611,824
3183,1,0,74,0,-74
3184,1,0,14,0,-14
3185,0,0,33,0,-33
3186,1,0,49,0,-49
3187,1,1,458,1338,880
3188,1,1,167,1535,1368
3189,1,0,229,0,-229
3190,1,1,366,1245,879
3191,1,0,10,0,-10
3192,1,0,44,0,-44
3193,1,0,7,0,-7
3194,1,0,15,0,-15
3195,1,1,326,1418,1092
3196,1,0,28,0,-28
3197,1,0,16,0,-16
3198,1,0,23,0,-23
3199,1,1,109,1475,1366
3200,0,0,3,0,-3
3201,1,0,127,0,-127
3202,1,0,9,0,-9
3203,0,0,72,0,-72
3204,1,0,66,0,-66
3205,1,1,73,1642,1569
3206,1,0,32,0,-32
3207,0,0,270,0,-270
3208,1,1,684,1333,649
3209,1,1,515,2180,1665
3210,0,0,42,0,-42
3211,0,0,10,0,-10
3212,0,0,19,0,-19
3213,1,1,254,1432,1178
3214,0,0,26,0,-26
3215,0,0,22,0,-22
3216,1,1,671,1431,760
3217,0,0,3,0,-3
3218,1,0,8,0,-8
3219,1,1,994,1565,571
3220,0,0,45,0,-45
3221,0,0,9,0,-9
3222,1,1,2553,2365,-188
3223,0,0,57,0,-57
3224,0,0,102,0,-102
3225,1,0,27,0,-27
3226,0,0,35,0,-35
3227,1,0,74,0,-74
3228,1,1,738,4750,4012
3229,1,0,22,0,-22
3230,0,0,169,0,-169
3231,0,0,52,0,-52
3232,0,0,81,0,-81
3233,0,0,18,0,-18
3234,1,1,51,1600,1549
3235,1,0,116,0,-116
3236,1,1,454,1881,1427
3237,0,0,115,0,-115
3238,1,1,459,2634,2175
3239,1,1,2524,1760,-764
3240,1,0,48,0,-48
3241,1,1,119,1487,1368
3242,1,1,481,1368,887
3243,0,0,112,0,-112
3244,1,0,40,0,-40
3245,0,0,6,0,-6
3246,1,0,5,0,-5
3247,0,0,13,0,-13
3248,1,0,17,0,-17
3249,0,0,33,0,-33
3250,1,0,31,0,-31
3251,1,0,18,0,-18
3252,1,1,682,1873,1191
3253,1,1,610,1228,618
3254,1,1,254,1425,1171
3255,0,0,0,0,0
3256,0,0,51,0,-51
3257,0,0,11,0,-11
3258,1,1,154,2369,2215
3259,1,0,31,0,-31
3260,0,0,53,0,-53
3261,0,0,31,0,-31
3262,1,0,90,0,-90
3263,0,0,4,0,-4
3264,0,0,9,0,-9
3265,0,0,84,0,-84
3266,1,0,26,0,-26
3267,1,1,25,1244,1219
3268,0,0,67,0,-67
3269,1,0,22,0,-22
3270,0,0,13,0,-13
3271,1,1,542,1400,858
3272,0,0,108,0,-108
3273,0,0,19,0,-19
3274,1,0,70,0,-70
3275,0,0,19,0,-19
3276,1,0,19,0,-19
3277,1,0,76,0,-76
3278,1,0,39,0,-39
3279,1,1,49,1253,1204
3280,0,0,23,0,-23
3281,1,1,303,1956,1653
3282,0,0,54,0,-54
3283,0,0,13,0,-13
3284,0,0,164,0,-164
3285,1,0,66,0,-66
3286,1,0,1,0,-1
3287,0,0,8,0,-8
3288,1,1,224,1395,1171
3289,0,0,44,0,-44
3290,1,0,16,0,-16
3291,1,1,537,1468,931
3292,1,1,225,1288,1063
3293,1,1,852,1421,569
3294,1,1,282,1248,966
3295,1,1,462,1254,792
3296,1,0,110,0,-110
3297,0,0,22,0,-22
3298,1,0,76,0,-76
3299,0,0,3,0,-3
3300,1,0,96,0,-96
3301,1,0,28,0,-28
3302,1,0,28,0,-28
3303,1,0,37,0,-37
3304,1,1,27,1330,1303
3305,1,1,115,1400,1285
3306,0,0,71,0,-71
3307,0,0,40,0,-40
3308,1,0,91,0,-91
3309,1,0,67,0,-67
3310,0,0,26,0,-26
3311,0,0,13,0,-13
3312,0,0,2,0,-2
3313,0,0,60,0,-60
3314,0,0,4,0,-4
3315,0,0,38,0,-38
3316,0,0,12,0,-12
3317,0,0,42,0,-42
3318,1,0,94,0,-94
3319,0,0,55,0,-55
3320,1,0,0,0,0
3321,1,0,44,0,-44
3322,1,1,61,1637,1576
3323,1,0,4,0,-4
3324,0,0,13,0,-13
3325,0,0,193,0,-193
3326,1,1,1522,1869,347
3327,1,1,327,3228,2901
3328,1,0,56,0,-56
3329,0,0,74,0,-74
3330,1,0,118,0,-118
3331,1,0,118,0,-118
3332,1,0,32,0,-32
3333,1,0,3,0,-3
3334,1,0,3,0,-3
3335,1,1,397,2419,2022
3336,0,0,11,0,-11
3337,1,0,106,0,-106
3338,1,0,63,0,-63
3339,0,0,19,0,-19
3340,0,0,39,0,-39
3341,1,0,98,0,-98
3342,1,0,42,0,-42
3343,1,0,16,0,-16
3344,0,0,53,0,-53
3345,1,1,535,2096,1561
3346,0,0,12,0,-12
3347,0,0,55,0,-55
3348,0,0,15,0,-15
3349,0,0,24,0,-24
3350,1,1,411,1321,910
3351,1,0,32,0,-32
3352,0,0,53,0,-53
3353,0,0,117,0,-117
3354,1,0,31,0,-31
3355,1,1,493,1943,1450
3356,0,0,33,0,-33
3357,0,0,14,0,-14
3358,1,0,139,0,-139
3359,1,0,36,0,-36
3360,0,0,159,0,-159
3361,1,0,32,0,-32
3362,0,0,68,0,-68
3363,1,0,23,0,-23
3364,0,0,106,0,-106
3365,1,1,514,1245,731
3366,1,1,128,1238,1110
3367,1,1,235,1242,1007
3368,1,1,544,1360,816
3369,1,0,71,0,-71
3370,0,0,15,0,-15
3371,0,0,13,0,-13
3372,1,1,472,1268,796
3373,0,0,32,0,-32
3374,1,0,30,0,-30
3375,0,0,36,0,-36
3376,0,0,30,0,-30
3377,0,0,62,0,-62
3378,1,0,38,0,-38
3379,1,0,40,0,-40
3380,0,0,220,0,-220
3381,1,0,60,0,-60
3382,1,0,19,0,-19
3383,1,1,563,2993,2430
3384,0,0,48,0,-48
3385,0,0,17,0,-17
3386,0,0,155,0,-155
3387,1,1,1062,1230,168
3388,1,0,22,0,-22
3389,1,0,27,0,-27
3390,0,0,25,0,-25
3391,1,1,2453,1234,-1219
3392,1,1,334,1429,1095
3393,0,0,12,0,-12
3394,0,0,9,0,-9
3395,1,1,689,1271,582
3396,1,0,27,0,-27
3397,0,0,43,0,-43
3398,1,0,21,0,-21
3399,1,1,523,1510,987
3400,1,0,21,0,-21
3401,0,0,135,0,-135
3402,1,0,27,0,-27
3403,1,0,34,0,-34
3404,1,1,306,1447,1141
3405,1,0,4,0,-4
3406,0,0,107,0,-107
3407,0,0,24,0,-24
3408,1,0,53,0,-53
3409,1,1,489,1560,1071
3410,0,0,46,0,-46
3411,1,0,104,0,-104
3412,1,1,412,1231,819
3413,1,0,19,0,-19
3414,0,0,204,0,-204
3415,1,1,2235,1305,-930
3416,0,0,79,0,-79
3417,0,0,77,0,-77
3418,0,0,33,0,-33
3419,0,0,33,0,-33
3420,1,0,25,0,-25
3421,1,1,450,1235,785
3422,0,0,25,0,-25
3423,0,0,4,0,-4
3424,0,0,11,0,-11
3425,1,1,512,1877,1365
3426,1,0,20,0,-20
3427,0,0,85,0,-85
3428,1,1,147,1529,1382
3429,1,0,29,0,-29
3430,0,0,18,0,-18
3431,1,0,48,0,-48
3432,0,0,35,0,-35
3433,1,0,46,0,-46
3434,1,0,20,0,-20
3435,1,0,39,0,-39
3436,1,0,11,0,-11
3437,1,1,42,1232,1190
3438,1,1,212,1626,1414
3439,0,0,54,0,-54
3440,1,0,73,0,-73
3441,0,0,10,0,-10
3442,1,1,233,1398,1165
3443,0,0,45,0,-45
3444,1,0,18,0,-18
3445,0,0,155,0,-155
3446,0,0,11,0,-11
3447,0,0,65,0,-65
3448,0,0,133,0,-133
3449,1,0,101,0,-101
3450,1,0,43,0,-43
3451,1,1,552,1320,768
3452,1,0,4,0,-4
3453,1,1,481,1327,846
3454,0,0,73,0,-73
3455,0,0,37,0,-37
3456,0,0,63,0,-63
3457,0,0,10,0,-10
3458,1,0,24,0,-24
3459,1,1,557,1748,1191
3460,0,0,7,0,-7
3461,1,1,287,2215,1928
3462,1,0,12,0,-12
3463,1,0,26,0,-26
3464,1,0,134,0,-134
3465,0,0,3,0,-3
3466,1,1,931,3054,2123
3467,0,0,12,0,-12
3468,1,1,605,1616,1011
3469,1,0,116,0,-116
3470,0,0,7,0,-7
3471,0,0,1,0,-1
3472,1,0,145,0,-145
3473,1,0,46,0,-46
3474,1,0,64,0,-64
3475,1,0,21,0,-21
3476,1,1,198,1293,1095
3477,0,0,15,0,-15
3478,1,0,21,0,-21
3479,1,1,1231,1266,35
3480,1,0,22,0,-22
3481,1,0,38,0,-38
3482,1,0,4,0,-4
3483,0,0,29,0,-29
3484,1,0,100,0,-100
3485,1,1,341,2418,2077
3486,1,1,56,1626,1570
3487,0,0,9,0,-9
3488,0,0,8,0,-8
3489,1,1,526,1848,1322
3490,1,1,47,1660,1613
3491,1,0,51,0,-51
3492,0,0,41,0,-41
3493,1,0,31,0,-31
3494,1,1,77,1729,1652
3495,0,0,17,0,-17
3496,1,1,86,1630,1544
3497,1,0,68,0,-68
3498,0,0,24,0,-24
3499,1,1,88,1382,1294
3500,0,0,20,0,-20
3501,1,0,31,0,-31
3502,1,0,62,0,-62
3503,0,0,22,0,-22
3504,0,0,80,0,-80
3505,1,1,1430,1236,-194
3506,1,1,1790,1489,-301
3507,1,1,142,1513,1371
3508,1,0,16,0,-16
3509,1,1,771,2434,1663
3510,1,0,160,0,-160
3511,1,0,1,0,-1
3512,1,0,35,0,-35
3513,1,0,210,0,-210
3514,1,0,53,0,-53
3515,0,0,19,0,-19
3516,1,1,105,1943,1838
3517,1,0,67,0,-67
3518,0,0,89,0,-89
3519,0,0,62,0,-62
3520,1,0,19,0,-19
3521,0,0,38,0,-38
3522,1,1,829,2105,1276
3523,0,0,62,0,-62
3524,0,0,101,0,-101
3525,1,1,269,1267,998
3526,1,0,14,0,-14
3527,1,1,1240,1248,8
3528,1,0,8,0,-8
3529,1,1,344,1412,1068
3530,0,0,30,0,-30
3531,1,1,1250,1583,333
3532,1,0,131,0,-131
3533,0,0,30,0,-30
3534,1,1,546,2269,1723
3535,0,0,40,0,-40
3536,1,0,3,0,-3
3537,1,1,431,1212,781
3538,1,1,1606,1398,-208
3539,1,0,74,0,-74
3540,1,0,34,0,-34
3541,1,1,148,1237,1089
3542,0,0,7,0,-7
3543,1,1,912,1517,605
3544,1,0,19,0,-19
3545,0,0,26,0,-26
3546,0,0,8,0,-8
3547,1,0,22,0,-22
3548,0,0,84,0,-84
3549,1,0,75,0,-75
3550,0,0,96,0,-96
3551,1,0,29,0,-29
3552,0,0,43,0,-43
3553,1,1,1542,1225,-317
3554,0,0,29,0,-29
3555,0,0,56,0,-56
3556,1,0,29,0,-29
3557,1,0,35,0,-35
3558,0,0,102,0,-102
3559,1,1,279,1220,941
3560,1,1,245,2152,1907
3561,1,0,51,0,-51
3562,1,1,283,1632,1349
3563,0,0,35,0,-35
3564,1,1,1185,1339,154
3565,0,0,17,0,-17
3566,0,0,36,0,-36
3567,1,1,1088,1246,158
3568,1,1,73,1809,1736
3569,1,0,8,0,-8
3570,0,0,35,0,-35
3571,0,0,54,0,-54
3572,0,0,21,0,-21
3573,0,0,58,0,-58
3574,0,0,26,0,-26
3575,1,0,1,0,-1
3576,1,0,76,0,-76
3577,0,0,54,0,-54
3578,1,1,344,2523,2179
3579,1,0,25,0,-25
3580,1,0,207,0,-207
3581,0,0,126,0,-126
3582,1,1,651,1846,1195
3583,0,0,17,0,-17
3584,0,0,72,0,-72
3585,1,1,1167,1430,263
3586,1,1,292,1803,1511
3587,0,0,97,0,-97
3588,0,0,84,0,-84
3589,0,0,15,0,-15
3590,1,0,5,0,-5
3591,1,1,1113,1207,94
3592,1,1,251,1345,1094
3593,0,0,33,0,-33
3594,0,0,33,0,-33
3595,0,0,14,0,-14
3596,1,0,3,0,-3
3597,1,1,714,1428,714
3598,1,1,768,1330,562
3599,0,0,22,0,-22
3600,1,0,10,0,-10
3601,1,1,144,1874,1730
3602,1,0,15,0,-15
3603,1,0,51,0,-51
3604,0,0,24,0,-24
3605,1,0,22,0,-22
3606,0,0,14,0,-14
3607,1,0,210,0,-210
3608,1,1,1353,1386,33
3609,1,1,450,1287,837
3610,0,0,65,0,-65
3611,0,0,10,0,-10
3612,0,0,63,0,-63
3613,1,0,2,0,-2
3614,1,1,1403,1386,-17
3615,1,1,191,6472,6281
3616,1,1,108,1224,1116
3617,0,0,4,0,-4
3618,0,0,53,0,-53
3619,1,1,637,1206,569
3620,0,0,0,0,0
3621,1,0,31,0,-31
3622,1,0,4,0,-4
3623,1,1,488,1470,982
3624,1,1,61,1795,1734
3625,1,0,4,0,-4
3626,1,0,16,0,-16
3627,1,1,810,1616,806
3628,1,1,221,1227,1006
3629,1,1,13,1365,1352
3630,0,0,35,0,-35
3631,0,0,29,0,-29
3632,1,1,205,3714,3509
3633,1,1,491,1382,891
3634,1,1,716,2192,1476
3635,0,0,190,0,-190
3636,1,1,19,1283,1264
3637,1,1,1284,1272,-12
3638,1,0,51,0,-51
3639,1,1,399,1630,1231
3640,0,0,31,0,-31
3641,1,0,45,0,-45
3642,1,1,398,1226,828
3643,1,0,71,0,-71
3644,1,1,169,1984,1815
3645,1,1,231,2743,2512
3646,1,1,718,1307,589
3647,1,0,19,0,-19
3648,1,0,109,0,-109
3649,1,1,537,1219,682
3650,1,0,12,0,-12
3651,0,0,65,0,-65
3652,1,0,7,0,-7
3653,0,0,79,0,-79
3654,0,0,20,0,-20
3655,1,1,2083,1320,-763
3656,0,0,2,0,-2
3657,1,1,1385,1250,-135
3658,0,0,144,0,-144
3659,0,0,26,0,-26
3660,1,1,690,2040,1350
3661,1,0,59,0,-59
3662,0,0,93,0,-93
3663,1,0,10,0,-10
3664,1,1,139,1230,1091
3665,1,0,26,0,-26
3666,1,1,196,1459,1263
3667,0,0,142,0,-142
3668,1,0,45,0,-45
3669,0,0,163,0,-163
3670,1,1,595,1216,621
3671,0,0,30,0,-30
3672,1,1,1128,1734,606
3673,1,1,544,2239,1695
3674,0,0,26,0,-26
3675,1,0,1,0,-1
3676,0,0,26,0,-26
3677,1,1,1417,1558,141
3678,1,1,849,1839,990
3679,0,0,236,0,-236
3680,0,0,23,0,-23
3681,1,1,118,1309,1191
3682,1,0,23,0,-23
3683,1,1,128,2052,1924
3684,1,1,494,2472,1978
3685,1,0,22,0,-22
3686,0,0,44,0,-44
3687,1,1,603,1340,737
3688,0,0,55,0,-55
3689,1,1,657,1260,603
3690,0,0,63,0,-63
3691,0,0,1,0,-1
3692,1,0,168,0,-168
3693,0,0,11,0,-11
3694,0,0,32,0,-32
3695,1,0,49,0,-49
3696,1,1,195,1230,1035
3697,1,1,503,2132,1629
3698,0,0,1,0,-1
3699,1,1,38,1289,1251
3700,0,0,4,0,-4
3701,0,0,0,0,0
3702,0,0,36,0,-36
3703,1,1,1148,1623,475
3704,0,0,19,0,-19
3705,1,0,1,0,-1
3706,0,0,44,0,-44
3707,1,0,16,0,-16
3708,1,1,693,1250,557
3709,1,1,2688,1505,-1183
3710,1,0,58,0,-58
3711,0,0,125,0,-125
3712,0,0,9,0,-9
3713,1,1,346,1603,1257
3714,1,0,21,0,-21
3715,0,0,2,0,-2
3716,1,0,11,0,-11
3717,1,1,120,2466,2346
3718,1,1,1258,1365,107
3719,1,0,21,0,-21
3720,1,0,8,0,-8
3721,1,0,134,0,-134
3722,0,0,153,0,-153
3723,1,1,354,1672,1318
3724,1,1,454,1587,1133
3725,0,0,3,0,-3
3726,1,1,1109,1254,145
3727,1,0,7,0,-7
3728,0,0,3,0,-3
3729,1,1,239,3071,2832
3730,1,1,688,1258,570
3731,0,0,30,0,-30
3732,1,1,194,1305,1111
3733,1,0,95,0,-95
3734,1,1,82,1353,1271
3735,1,1,24,1201,1177
3736,1,1,590,1314,724
3737,1,0,62,0,-62
3738,1,1,803,1317,514
3739,1,1,837,1209,372
3740,0,0,53,0,-53
3741,1,1,1351,2388,1037
3742,1,1,435,1629,1194
3743,1,0,1,0,-1
3744,1,1,60,1271,1211
3745,1,0,36,0,-36
3746,1,0,74,0,-74
3747,1,1,100,1295,1195
3748,1,0,38,0,-38
3749,0,0,22,0,-22
3750,0,0,29,0,-29
3751,1,0,0,0,0
3752,0,0,18,0,-18
3753,1,0,36,0,-36
3754,0,0,1,0,-1
3755,0,0,61,0,-61
3756,1,0,126,0,-126
3757,0,0,1,0,-1
3758,0,0,3,0,-3
3759,0,0,25,0,-25
3760,1,0,131,0,-131
3761,1,0,3,0,-3
3762,1,1,329,1671,1342
3763,1,1,423,1332,909
3764,0,0,48,0,-48
3765,1,0,55,0,-55
3766,1,0,27,0,-27
3767,1,0,26,0,-26
3768,0,0,322,0,-322
3769,1,0,101,0,-101
3770,1,0,83,0,-83
3771,1,0,48,0,-48
3772,0,0,64,0,-64
3773,1,1,1061,1534,473
3774,1,0,1,0,-1
3775,1,0,68,0,-68
3776,1,1,263,2461,2198
3777,0,0,52,0,-52
3778,0,0,13,0,-13
3779,0,0,0,0,0
3780,1,1,188,1217,1029
3781,1,0,7,0,-7
3782,0,0,107,0,-107
3783,1,1,122,1591,1469
3784,1,0,32,0,-32
3785,0,0,22,0,-22
3786,1,0,82,0,-82
3787,1,1,1149,2414,1265
3788,1,1,301,1996,1695
3789,1,1,944,2538,1594
3790,0,0,60,0,-60
3791,0,0,121,0,-121
3792,1,0,10,0,-10
3793,1,0,24,0,-24
3794,1,0,35,0,-35
3795,1,1,176,1301,1125
3796,1,0,2,0,-2
3797,1,1,512,1378,866
3798,1,1,945,2801,1856
3799,0,0,5,0,-5
3800,0,0,33,0,-33
3801,0,0,52,0,-52
3802,0,0,0,0,0
3803,0,0,76,0,-76
3804,0,0,34,0,-34
3805,0,0,78,0,-78
3806,0,0,9,0,-9
3807,1,0,19,0,-19
3808,0,0,5,0,-5
3809,0,0,6,0,-6
3810,0,0,38,0,-38
3811,1,0,42,0,-42
3812,1,0,9,0,-9
3813,1,0,21,0,-21
3814,1,0,40,0,-40
3815,1,0,129,0,-129
3816,1,1,695,1357,662
3817,1,0,105,0,-105
3818,0,0,65,0,-65
3819,1,1,591,1296,705
3820,1,0,25,0,-25
3821,0,0,44,0,-44
3822,0,0,17,0,-17
3823,1,1,61,1548,1487
3824,0,0,10,0,-10
3825,1,1,82,1379,1297
3826,1,0,75,0,-75
3827,0,0,79,0,-79
3828,0,0,22,0,-22
3829,0,0,9,0,-9
3830,1,0,63,0,-63
3831,0,0,127,0,-127
3832,1,0,52,0,-52
3833,1,1,1527,1248,-279
3834,1,1,71,1799,1728
3835,1,0,65,0,-65
3836,0,0,62,0,-62
3837,1,0,32,0,-32
3838,0,0,35,0,-35
3839,0,0,11,0,-11
3840,1,0,0,0,0
3841,1,1,389,1328,939
3842,0,0,28,0,-28
3843,1,1,44,1539,1495
3844,0,0,65,0,-65
3845,1,0,52,0,-52
3846,1,0,97,0,-97
3847,1,1,231,1454,1223
3848,1,1,664,1237,573
3849,0,0,123,0,-123
3850,0,0,4,0,-4
3851,1,1,269,1301,1032
3852,1,0,74,0,-74
3853,1,1,709,1508,799
3854,0,0,22,0,-22
3855,1,0,19,0,-19
3856,0,0,62,0,-62
3857,0,0,25,0,-25
3858,0,0,127,0,-127
3859,1,1,448,1429,981
3860,1,0,15,0,-15
3861,1,0,20,0,-20
3862,0,0,79,0,-79
3863,0,0,61,0,-61
3864,1,1,173,1977,1804
3865,1,0,56,0,-56
3866,0,0,59,0,-59
3867,0,0,22,0,-22
3868,1,1,120,1833,1713
3869,1,0,5,0,-5
3870,0,0,95,0,-95
3871,1,1,1533,1771,238
3872,0,0,197,0,-197
3873,0,0,24,0,-24
3874,1,0,39,0,-39
3875,0,0,1,0,-1
3876,1,0,129,0,-129
3877,1,0,33,0,-33
3878,1,1,83,1931,1848
3879,1,0,68,0,-68
3880,1,0,3,0,-3
3881,1,0,165,0,-165
3882,0,0,14,0,-14
3883,1,1,152,1672,1520
3884,0,0,11,0,-11
3885,0,0,31,0,-31
3886,1,1,469,1200,731
3887,1,1,296,1580,1284
3888,0,0,187,0,-187
3889,0,0,71,0,-71
3890,0,0,27,0,-27
3891,0,0,21,0,-21
3892,1,1,636,1411,775
3893,1,0,35,0,-35
3894,0,0,26,0,-26
3895,1,0,155,0,-155
3896,1,1,103,1930,1827
3897,0,0,167,0,-167
3898,0,0,5,0,-5
3899,0,0,205,0,-205
3900,0,0,49,0,-49
3901,1,0,4,0,-4
3902,1,1,1116,2439,1323
3903,1,0,128,0,-128
3904,1,0,13,0,-13
3905,1,1,122,1564,1442
3906,1,0,17,0,-17
3907,1,1,698,1287,589
3908,0,0,74,0,-74
3909,1,0,113,0,-113
3910,1,1,232,1337,1105
3911,0,0,28,0,-28
3912,1,1,725,1492,767
3913,0,0,13,0,-13
3914,0,0,69,0,-69
3915,0,0,27,0,-27
3916,0,0,75,0,-75
3917,1,1,143,1273,1130
3918,0,0,203,0,-203
3919,0,0,22,0,-22
3920,0,0,10,0,-10
3921,1,0,108,0,-108
3922,1,1,172,1299,1127
3923,1,1,686,1383,697
3924,1,0,43,0,-43
3925,0,0,91,0,-91
3926,0,0,2,0,-2
3927,1,1,1354,1503,149
3928,0,0,44,0,-44
3929,1,1,276,4268,3992
3930,1,0,12,0,-12
3931,1,0,59,0,-59
3932,1,1,1393,1407,14
3933,1,1,394,1227,833
3934,1,1,1113,1803,690
3935,0,0,10,0,-10
3936,1,1,426,1225,799
3937,0,0,137,0,-137
3938,1,0,79,0,-79
3939,1,0,90,0,-90
3940,1,1,211,2107,1896
3941,0,0,45,0,-45
3942,0,0,3,0,-3
3943,1,1,125,1795,1670
3944,1,0,0,0,0
3945,0,0,10,0,-10
3946,1,1,282,1298,1016
3947,1,1,224,1416,1192
3948,1,0,130,0,-130
3949,1,0,0,0,0
3950,1,0,71,0,-71
3951,1,0,33,0,-33
3952,1,0,7,0,-7
3953,1,0,6,0,-6
3954,0,0,11,0,-11
3955,0,0,41,0,-41
3956,1,1,1961,1777,-184
3957,0,0,22,0,-22
3958,1,0,38,0,-38
3959,1,0,36,0,-36
3960,1,0,28,0,-28
3961,1,0,25,0,-25
3962,1,1,404,1370,966
3963,1,0,81,0,-81
3964,0,0,39,0,-39
3965,0,0,8,0,-8
3966,1,1,347,1679,1332
3967,0,0,29,0,-29
3968,1,1,264,1327,1063
3969,1,1,90,1657,1567
3970,0,0,50,0,-50
3971,1,1,749,1307,558
3972,1,0,82,0,-82
3973,1,1,125,1276,1151
3974,1,0,73,0,-73
3975,0,0,22,0,-22
3976,0,0,19,0,-19
3977,1,0,92,0,-92
3978,1,0,60,0,-60
3979,1,0,2,0,-2
3980,0,0,14,0,-14
3981,1,0,19,0,-19
3982,1,1,145,1219,1074
3983,0,0,6,0,-6
3984,1,0,30,0,-30
3985,1,1,1002,1244,242
3986,0,0,22,0,-22
3987,1,0,33,0,-33
3988,1,0,1,0,-1
3989,0,0,7,0,-7
3990,1,1,452,1402,950
3991,0,0,3,0,-3
3992,1,1,553,1277,724
3993,1,0,111,0,-111
3994,0,0,50,0,-50
3995,1,1,283,2929,2646
3996,0,0,72,0,-72
3997,0,0,20,0,-20
3998,1,0,36,0,-36
3999,1,0,17,0,-17
4000,0,0,13,0,-13
4001,0,0,66,0,-66
4002,1,1,211,1797,1586
4003,0,0,28,0,-28
4004,0,0,12,0,-12
4005,0,0,44,0,-44
4006,1,1,1362,1425,63
4007,0,0,7,0,-7
4008,1,0,25,0,-25
4009,1,1,1618,1601,-17
4010,1,1,112,1333,1221
4011,0,0,16,0,-16
4012,1,0,5,0,-5
4013,1,1,312,1221,909
4014,1,0,16,0,-16
4015,0,0,52,0,-52
4016,1,0,5,0,-5
4017,1,0,98,0,-98
4018,1,0,54,0,-54
4019,0,0,167,0,-167
4020,1,1,503,1314,811
4021,1,1,545,1211,666
4022,0,0,73,0,-73
4023,0,0,2,0,-2
4024,1,1,348,1865,1517
4025,0,0,23,0,-23
4026,1,1,1192,1451,259
4027,1,1,143,1464,1321
4028,0,0,20,0,-20
4029,1,1,283,1565,1282
4030,0,0,27,0,-27
4031,1,0,84,0,-84
4032,0,0,102,0,-102
4033,0,0,106,0,-106
4034,1,0,22,0,-22
4035,1,0,187,0,-187
4036,0,0,173,0,-173
4037,0,0,12,0,-12
4038,1,1,384,1432,1048
4039,0,0,56,0,-56
4040,0,0,130,0,-130
4041,1,0,19,0,-19
4042,1,0,22,0,-22
4043,0,0,49,0,-49
4044,1,0,96,0,-96
4045,0,0,3,0,-3
4046,1,1,182,1544,1362
4047,0,0,85,0,-85
4048,1,0,65,0,-65
4049,1,1,149,1455,1306
4050,1,1,1831,1668,-163
4051,0,0,104,0,-104
4052,0,0,37,0,-37
4053,1,0,70,0,-70
4054,1,1,103,2317,2214
4055,1,1,930,1231,301
4056,1,0,10,0,-10
4057,1,1,504,1391,887
4058,1,1,579,1235,656
4059,1,0,37,0,-37
4060,0,0,29,0,-29
4061,1,1,468,1509,1041
4062,1,1,269,1630,1361
4063,0,0,30,0,-30
4064,0,0,50,0,-50
4065,0,0,21,0,-21
4066,1,1,856,1297,441
4067,0,0,10,0,-10
4068,0,0,31,0,-31
4069,1,0,10,0,-10
4070,1,1,592,1693,1101
4071,1,0,30,0,-30
4072,1,0,90,0,-90
4073,0,0,28,0,-28
4074,0,0,27,0,-27
4075,0,0,57,0,-57
4076,1,1,588,1764,1176
4077,1,1,164,2582,2418
4078,1,0,71,0,-71
4079,1,1,699,1562,863
4080,1,0,29,0,-29
4081,0,0,69,0,-69
4082,1,0,1,0,-1
4083,1,0,74,0,-74
4084,1,1,87,1290,1203
4085,0,0,96,0,-96
4086,1,0,10,0,-10
4087,1,1,1094,1473,379
4088,1,0,29,0,-29
4089,1,0,209,0,-209
4090,1,1,453,1238,785
4091,0,0,44,0,-44
4092,0,0,118,0,-118
4093,1,1,154,1458,1304
4094,1,1,25,1396,1371
4095,1,0,11,0,-11
4096,1,1,179,1307,1128
4097,0,0,3,0,-3
4098,1,1,306,1965,1659
4099,1,1,145,1680,1535
4100,0,0,74,0,-74
4101,1,1,215,1299,1084
4102,1,0,0,0,0
4103,1,0,67,0,-67
4104,1,0,51,0,-51
4105,1,0,257,0,-257
4106,1,1,244,1306,1062
4107,1,1,165,1290,1125
4108,1,1,126,1874,1748
4109,1,0,228,0,-228
4110,1,0,35,0,-35
4111,0,0,67,0,-67
4112,1,0,27,0,-27
4113,1,0,10,0,-10
4114,1,1,93,1528,1435
4115,0,0,15,0,-15
4116,1,0,52,0,-52
4117,0,0,93,0,-93
4118,1,1,418,1359,941
4119,1,0,41,0,-41
4120,0,0,15,0,-15
4121,1,1,1087,1264,177
4122,1,0,69,0,-69
4123,1,1,169,1255,1086
4124,1,1,70,1224,1154
4125,1,1,1750,2403,653
4126,1,0,97,0,-97
4127,1,0,24,0,-24
4128,1,1,309,2148,1839
4129,1,0,98,0,-98
4130,0,0,61,0,-61
4131,1,0,65,0,-65
4132,0,0,26,0,-26
4133,0,0,50,0,-50
4134,0,0,12,0,-12
4135,0,0,82,0,-82
4136,0,0,41,0,-41
4137,1,0,27,0,-27
4138,0,0,46,0,-46
4139,0,0,66,0,-66
4140,1,1,445,1396,951
4141,0,0,61,0,-61
4142,1,1,823,1230,407
4143,0,0,26,0,-26
4144,1,1,643,1571,928
4145,1,0,108,0,-108
4146,1,1,113,1553,1440
4147,0,0,13,0,-13
4148,0,0,83,0,-83
4149,1,0,14,0,-14
4150,0,0,72,0,-72
4151,1,1,144,1373,1229
4152,1,0,35,0,-35
4153,1,0,1,0,-1
4154,0,0,29,0,-29
4155,1,1,117,1448,1331
4156,1,0,0,0,0
4157,0,0,156,0,-156
4158,0,0,27,0,-27
4159,0,0,15,0,-15
4160,1,1,648,1398,750
4161,1,1,765,1371,606
4162,1,1,1683,1458,-225
4163,1,1,144,1279,1135
4164,1,0,3,0,-3
4165,1,0,70,0,-70
4166,0,0,102,0,-102
4167,1,0,15,0,-15
4168,0,0,95,0,-95
4169,0,0,141,0,-141
4170,1,0,45,0,-45
4171,1,0,56,0,-56
4172,0,0,3,0,-3
4173,0,0,104,0,-104
4174,1,1,799,1412,613
4175,1,1,1794,1267,-527
4176,1,0,133,0,-133
4177,1,0,44,0,-44
4178,1,0,54,0,-54
4179,1,1,832,1253,421
4180,1,0,43,0,-43
4181,1,0,10,0,-10
4182,0,0,2,0,-2
4183,0,0,35,0,-35
4184,0,0,84,0,-84
4185,0,0,282,0,-282
4186,0,0,29,0,-29
4187,0,0,0,0,0
4188,1,0,36,0,-36
4189,0,0,19,0,-19
4190,0,0,48,0,-48
4191,0,0,49,0,-49
4192,1,0,27,0,-27
4193,1,0,0,0,0
4194,1,1,364,1860,1496
4195,1,1,123,1286,1163
4196,0,0,51,0,-51
4197,0,0,8,0,-8
4198,0,0,54,0,-54
4199,0,0,18,0,-18
4200,0,0,50,0,-50
4201,1,1,505,1392,887
4202,1,1,70,1471,1401
4203,1,1,204,1660,1456
4204,1,1,501,1549,1048
4205,1,0,43,0,-43
4206,0,0,1,0,-1
4207,0,0,60,0,-60
4208,0,0,29,0,-29
4209,0,0,173,0,-173
4210,1,1,984,1275,291
4211,0,0,1,0,-1
4212,1,1,599,1245,646
4213,1,1,704,1488,784
4214,1,1,1140,1242,102
4215,0,0,36,0,-36
4216,0,0,29,0,-29
4217,0,0,44,0,-44
4218,0,0,69,0,-69
4219,1,1,518,1250,732
4220,1,1,553,1434,881
4221,1,1,172,1314,1142
4222,1,0,11,0,-11
4223,0,0,17,0,-17
4224,1,0,20,0,-20
4225,1,1,566,1632,1066
4226,1,0,43,0,-43
4227,0,0,59,0,-59
4228,1,1,327,1786,1459
4229,1,0,8,0,-8
4230,1,1,524,1432,908
4231,0,0,38,0,-38
4232,1,1,350,2009,1659
4233,1,1,123,1865,1742
4234,1,1,218,1507,1289
4235,0,0,25,0,-25
4236,0,0,13,0,-13
4237,1,1,211,1231,1020
4238,1,0,17,0,-17
4239,0,0,36,0,-36
4240,0,0,37,0,-37
4241,1,0,47,0,-47
4242,1,1,145,1269,1124
4243,0,0,111,0,-111
4244,0,0,43,0,-43
4245,1,0,40,0,-40
4246,0,0,3,0,-3
4247,1,1,1169,1297,128
4248,1,0,43,0,-43
4249,0,0,96,0,-96
4250,1,0,39,0,-39
4251,1,1,164,1254,1090
4252,0,0,33,0,-33
4253,1,0,56,0,-56
4254,1,0,174,0,-174
4255,0,0,108,0,-108
4256,1,1,89,1680,1591
4257,1,0,85,0,-85
4258,0,0,50,0,-50
4259,1,1,403,1571,1168
4260,0,0,12,0,-12
4261,1,0,121,0,-121
4262,0,0,91,0,-91
4263,0,0,65,0,-65
4264,0,0,0,0,0
4265,1,0,23,0,-23
4266,1,0,4,0,-4
4267,1,0,53,0,-53
4268,1,0,4,0,-4
4269,1,1,487,1246,759
4270,1,0,30,0,-30
4271,1,0,51,0,-51
4272,1,0,35,0,-35
4273,0,0,95,0,-95
4274,0,0,7,0,-7
4275,0,0,10,0,-10
4276,1,0,31,0,-31
4277,1,0,6,0,-6
4278,0,0,21,0,-21
4279,1,0,53,0,-53
4280,1,1,276,2258,1982
4281,1,1,391,1284,893
4282,0,0,94,0,-94
4283,1,0,232,0,-232
4284,1,1,516,2039,1523
4285,1,0,63,0,-63
4286,0,0,52,0,-52
4287,0,0,20,0,-20
4288,1,1,107,2500,2393
4289,1,0,6,0,-6
4290,0,0,61,0,-61
4291,1,1,220,1361,1141
4292,0,0,20,0,-20
4293,1,0,36,0,-36
4294,0,0,37,0,-37
4295,0,0,25,0,-25
4296,1,0,57,0,-57
4297,1,1,486,2320,1834
4298,1,1,141,3384,3243
4299,1,0,7,0,-7
4300,0,0,23,0,-23
4301,0,0,79,0,-79
4302,0,0,99,0,-99
4303,0,0,41,0,-41
4304,1,1,510,1264,754
4305,1,1,613,1359,746
4306,0,0,16,0,-16
4307,0,0,26,0,-26
4308,0,0,1,0,-1
4309,1,1,155,1595,1440
4310,0,0,144,0,-144
4311,1,1,905,1839,934
4312,0,0,65,0,-65
4313,0,0,16,0,-16
4314,1,1,1282,1521,239
4315,1,0,104,0,-104
4316,1,1,1201,1642,441
4317,0,0,99,0,-99
4318,1,0,0,0,0
4319,0,0,30,0,-30
4320,1,1,850,1379,529
4321,1,0,7,0,-7
4322,1,1,369,1476,1107
4323,1,1,164,1789,1625
4324,1,1,399,1329,930
4325,0,0,53,0,-53
4326,1,1,810,1453,643
4327,1,0,17,0,-17
4328,1,0,88,0,-88
4329,1,1,320,2405,2085
4330,1,0,113,0,-113
4331,1,1,253,1338,1085
4332,0,0,1,0,-1
4333,1,0,6,0,-6
4334,1,0,23,0,-23
4335,1,1,903,1212,309
4336,1,0,204,0,-204
4337,1,1,886,1426,540
4338,1,0,3,0,-3
4339,1,1,419,1617,1198
4340,1,0,18,0,-18
4341,0,0,135,0,-135
4342,0,0,73,0,-73
4343,0,0,81,0,-81
4344,0,0,38,0,-38
4345,1,1,113,2161,2048
4346,1,0,48,0,-48
4347,1,0,6,0,-6
4348,1,1,281,1255,974
4349,1,0,73,0,-73
4350,1,0,135,0,-135
4351,1,0,98,0,-98
4352,1,1,502,1216,714
4353,1,1,625,1391,766
4354,1,1,430,1308,878
4355,0,0,31,0,-31
4356,1,1,103,2438,2335
4357,1,0,94,0,-94
4358,1,1,718,2022,1304
4359,0,0,144,0,-144
4360,1,0,55,0,-55
4361,1,1,50,1391,1341
4362,1,1,395,1296,901
4363,0,0,18,0,-18
4364,0,0,7,0,-7
4365,1,1,70,1603,1533
4366,1,1,595,1941,1346
4367,1,0,3,0,-3
4368,1,0,10,0,-10
4369,1,1,284,1536,1252
4370,1,0,1,0,-1
4371,1,0,7,0,-7
4372,1,0,33,0,-33
4373,0,0,13,0,-13
4374,1,0,106,0,-106
4375,1,0,9,0,-9
4376,1,1,596,1349,753
4377,0,0,124,0,-124
4378,1,0,173,0,-173
4379,1,0,55,0,-55
4380,1,1,333,1211,878
4381,1,1,53,1333,1280
4382,1,0,46,0,-46
4383,1,1,332,1587,1255
4384,0,0,9,0,-9
4385,1,1,252,2522,2270
4386,1,0,4,0,-4
4387,1,0,15,0,-15
4388,1,1,429,1361,932
4389,1,1,739,1478,739
4390,1,1,77,1575,1498
4391,1,1,139,2116,1977
4392,0,0,28,0,-28
4393,1,0,70,0,-70
4394,1,1,1005,1787,782
4395,0,0,10,0,-10
4396,0,0,9,0,-9
4397,1,0,73,0,-73
4398,1,1,699,1669,970
4399,0,0,30,0,-30
4400,1,0,1,0,-1
4401,1,1,161,2433,2272
4402,1,0,11,0,-11
4403,1,1,131,3937,3806
4404,1,0,51,0,-51
4405,0,0,7,0,-7
4406,1,0,39,0,-39
4407,0,0,110,0,-110
4408,0,0,29,0,-29
4409,1,0,33,0,-33
4410,1,1,820,1379,559
4411,0,0,50,0,-50
4412,1,1,156,1324,1168
4413,0,0,23,0,-23
4414,0,0,21,0,-21
4415,1,1,232,1295,1063
4416,1,1,4,2027,2023
4417,1,0,41,0,-41
4418,1,1,186,2326,2140
4419,1,0,74,0,-74
4420,0,0,17,0,-17
4421,1,1,529,1385,856
4422,0,0,138,0,-138
4423,1,0,24,0,-24
4424,1,1,50,2527,2477
4425,1,1,1051,1775,724
4426,0,0,34,0,-34
4427,1,0,21,0,-21
4428,0,0,11,0,-11
4429,1,1,576,1235,659
4430,1,0,16,0,-16
4431,0,0,14,0,-14
4432,0,0,57,0,-57
4433,1,0,19,0,-19
4434,0,0,73,0,-73
4435,1,1,113,1233,1120
4436,1,0,45,0,-45
4437,1,0,48,0,-48
4438,0,0,33,0,-33
4439,1,1,1107,3103,1996
4440,1,0,137,0,-137
4441,0,0,23,0,-23
4442,0,0,31,0,-31
4443,1,1,106,1442,1336
4444,1,0,37,0,-37
4445,1,0,60,0,-60
4446,1,0,48,0,-48
4447,1,0,8,0,-8
4448,1,1,180,1531,1351
4449,0,0,301,0,-301
4450,0,0,65,0,-65
4451,0,0,8,0,-8
4452,0,0,57,0,-57
4453,1,1,329,2382,2053
4454,1,0,13,0,-13
4455,1,1,1091,1262,171
4456,0,0,13,0,-13
4457,1,0,117,0,-117
4458,0,0,10,0,-10
4459,1,0,28,0,-28
4460,1,0,13,0,-13
4461,1,1,524,1235,711
4462,0,0,24,0,-24
4463,1,0,140,0,-140
4464,1,0,136,0,-136
4465,1,0,21,0,-21
4466,0,0,14,0,-14
4467,1,1,387,1315,928
4468,0,0,90,0,-90
4469,1,1,679,1583,904
4470,1,1,382,1673,1291
4471,1,1,1091,2859,1768
4472,0,0,87,0,-87
4473,0,0,57,0,-57
4474,1,0,52,0,-52
4475,0,0,51,0,-51
4476,1,0,15,0,-15
4477,1,0,37,0,-37
4478,0,0,124,0,-124
4479,1,1,236,1522,1286
4480,1,0,41,0,-41
4481,1,1,593,1333,740
4482,1,1,382,1300,918
4483,0,0,37,0,-37
4484,1,1,1000,1889,889
4485,1,1,360,1365,1005
4486,0,0,33,0,-33
4487,1,0,6,0,-6
4488,1,1,202,1297,1095
4489,0,0,27,0,-27
4490,1,0,8,0,-8
4491,0,0,10,0,-10
4492,1,0,15,0,-15
4493,1,1,978,1467,489
4494,1,0,30,0,-30
4495,1,0,2,0,-2
4496,1,0,24,0,-24
4497,0,0,27,0,-27
4498,1,1,188,1394,1206
4499,0,0,122,0,-122
4500,1,0,26,0,-26
4501,0,0,38,0,-38
4502,1,1,764,2042,1278
4503,1,1,414,1202,788
4504,0,0,11,0,-11
4505,0,0,14,0,-14
4506,1,1,33,1337,1304
4507,1,1,176,1499,1323
4508,0,0,9,0,-9
4509,0,0,202,0,-202
4510,1,0,139,0,-139
4511,0,0,76,0,-76
4512,1,1,1079,1240,161
4513,1,1,488,2898,2410
4514,0,0,33,0,-33
4515,1,1,131,1246,1115
4516,0,0,46,0,-46
4517,1,1,67,1211,1144
4518,0,0,148,0,-148
4519,1,1,456,1925,1469
4520,1,0,30,0,-30
4521,1,0,105,0,-105
4522,1,0,36,0,-36
4523,0,0,54,0,-54
4524,0,0,103,0,-103
4525,1,0,92,0,-92
4526,1,1,171,3246,3075
4527,0,0,95,0,-95
4528,1,1,624,1398,774
4529,0,0,70,0,-70
4530,1,1,262,1431,1169
4531,1,0,76,0,-76
4532,1,1,707,1311,604
4533,0,0,51,0,-51
4534,0,0,193,0,-193
4535,1,0,5,0,-5
4536,0,0,36,0,-36
4537,0,0,14,0,-14
4538,1,1,197,1380,1183
4539,0,0,53,0,-53
4540,0,0,19,0,-19
4541,0,0,213,0,-213
4542,1,1,87,1642,1555
4543,0,0,2,0,-2
4544,1,1,48,1290,1242
4545,1,0,1,0,-1
4546,1,1,58,1669,1611
4547,0,0,36,0,-36
4548,0,0,26,0,-26
4549,0,0,16,0,-16
4550,1,0,48,0,-48
4551,0,0,29,0,-29
4552,0,0,2,0,-2
4553,0,0,34,0,-34
4554,1,1,2823,1273,-1550
4555,1,1,1085,1214,129
4556,0,0,187,0,-187
4557,0,0,45,0,-45
4558,1,0,54,0,-54
4559,1,0,8,0,-8
4560,1,0,74,0,-74
4561,1,1,128,1268,1140
4562,1,1,738,1200,462
4563,0,0,62,0,-62
4564,0,0,48,0,-48
4565,0,0,16,0,-16
4566,1,0,171,0,-171
4567,1,1,987,1605,618
4568,1,0,4,0,-4
4569,1,0,76,0,-76
4570,0,0,61,0,-61
4571,0,0,22,0,-22
4572,1,1,366,1238,872
4573,0,0,147,0,-147
4574,0,0,22,0,-22
4575,0,0,53,0,-53
4576,0,0,15,0,-15
4577,1,1,378,1229,851
4578,0,0,59,0,-59
4579,0,0,92,0,-92
4580,1,1,177,1400,1223
4581,1,1,412,1270,858
4582,1,0,77,0,-77
4583,0,0,12,0,-12
4584,1,0,286,0,-286
4585,0,0,79,0,-79
4586,1,1,63,2397,2334
4587,0,0,94,0,-94
4588,0,0,11,0,-11
4589,0,0,24,0,-24
4590,1,0,1,0,-1
4591,0,0,14,0,-14
4592,1,1,610,1243,633
4593,1,1,268,1790,1522
4594,1,1,54,1764,1710
4595,1,0,64,0,-64
4596,0,0,37,0,-37
4597,1,0,10,0,-10
4598,0,0,32,0,-32
4599,0,0,19,0,-19
4600,1,0,19,0,-19
4601,1,1,461,1258,797
4602,0,0,17,0,-17
4603,1,1,1089,1565,476
4604,1,1,182,1265,1083
4605,0,0,8,0,-8
4606,0,0,173,0,-173
4607,1,1,895,1355,460
4608,0,0,197,0,-197
4609,1,0,103,0,-103
4610,0,0,9,0,-9
4611,1,1,155,1366,1211
4612,0,0,85,0,-85
4613,1,1,496,2340,1844
4614,1,0,39,0,-39
4615,0,0,119,0,-119
4616,0,0,109,0,-109
4617,0,0,14,0,-14
4618,1,1,95,1308,1213
4619,1,1,845,1280,435
4620,1,1,269,1685,1416
4621,0,0,7,0,-7
4622,0,0,63,0,-63
4623,1,1,621,1330,709
4624,1,1,263,1229,966
4625,0,0,37,0,-37
4626,1,1,227,2118,1891
4627,0,0,11,0,-11
4628,1,0,69,0,-69
4629,0,0,41,0,-41
4630,1,1,629,1236,607
4631,1,0,90,0,-90
4632,1,1,940,1496,556
4633,0,0,18,0,-18
4634,0,0,5,0,-5
4635,1,1,160,1213,1053
4636,1,0,10,0,-10
4637,0,0,28,0,-28
4638,1,0,34,0,-34
4639,0,0,40,0,-40
4640,1,0,99,0,-99
4641,0,0,82,0,-82
4642,0,0,29,0,-29
4643,1,0,106,0,-106
4644,1,0,33,0,-33
4645,1,0,6,0,-6
4646,0,0,18,0,-18
4647,1,0,39,0,-39
4648,1,0,11,0,-11
4649,0,0,18,0,-18
4650,0,0,269,0,-269
4651,0,0,9,0,-9
4652,1,1,895,1347,452
4653,1,1,306,1221,915
4654,0,0,53,0,-53
4655,0,0,9,0,-9
4656,1,1,755,1243,488
4657,1,1,213,1984,1771
4658,1,0,14,0,-14
4659,1,1,344,1352,1008
4660,0,0,30,0,-30
4661,1,1,19,2882,2863
4662,1,0,12,0,-12
4663,1,1,1765,1382,-383
4664,1,1,155,2155,2000
4665,1,1,507,1232,725
4666,1,1,445,1252,807
4667,1,0,34,0,-34
4668,1,0,24,0,-24
4669,1,0,26,0,-26
4670,0,0,73,0,-73
4671,0,0,13,0,-13
4672,0,0,24,0,-24
4673,1,1,139,3645,3506
4674,0,0,67,0,-67
4675,0,0,39,0,-39
4676,0,0,73,0,-73
4677,0,0,13,0,-13
4678,0,0,80,0,-80
4679,1,1,1222,1299,77
4680,1,1,161,2152,1991
4681,1,0,23,0,-23
4682,1,0,3,0,-3
4683,1,0,69,0,-69
4684,1,0,94,0,-94
4685,1,0,12,0,-12
4686,1,0,75,0,-75
4687,0,0,8,0,-8
4688,1,1,163,1410,1247
4689,0,0,53,0,-53
4690,1,0,31,0,-31
4691,1,1,634,1597,963
4692,1,0,83,0,-83
4693,1,1,1050,1958,908
4694,0,0,2,0,-2
4695,1,0,9,0,-9
4696,0,0,20,0,-20
4697,1,1,757,1472,715
4698,1,0,10,0,-10
4699,1,1,632,1472,840
4700,0,0,16,0,-16
4701,1,0,60,0,-60
4702,1,0,149,0,-149
4703,0,0,23,0,-23
4704,1,0,76,0,-76
4705,1,0,26,0,-26
4706,1,0,15,0,-15
4707,1,1,66,2073,2007
4708,1,0,15,0,-15
4709,1,0,24,0,-24
4710,0,0,44,0,-44
4711,1,1,92,1346,1254
4712,1,1,318,1983,1665
4713,0,0,14,0,-14
4714,0,0,21,0,-21
4715,1,0,87,0,-87
4716,0,0,34,0,-34
4717,1,1,2389,1625,-764
4718,0,0,90,0,-90
4719,1,1,472,1369,897
4720,1,0,28,0,-28
4721,0,0,57,0,-57
4722,1,1,54,1486,1432
4723,1,1,451,2110,1659
4724,1,0,52,0,-52
4725,1,1,263,1551,1288
4726,1,0,54,0,-54
4727,1,0,7,0,-7
4728,1,0,17,0,-17
4729,1,1,97,1842,1745
4730,1,0,16,0,-16
4731,0,0,33,0,-33
4732,0,0,140,0,-140
4733,1,1,190,1607,1417
4734,1,0,13,0,-13
4735,0,0,17,0,-17
4736,1,0,97,0,-97
4737,0,0,90,0,-90
4738,0,0,80,0,-80
4739,0,0,234,0,-234
4740,0,0,22,0,-22
4741,1,0,23,0,-23
4742,1,1,246,1612,1366
4743,1,0,49,0,-49
4744,1,1,1624,1519,-105
4745,1,0,22,0,-22
4746,0,0,12,0,-12
4747,1,1,33,1216,1183
4748,1,1,630,1242,612
4749,0,0,160,0,-160
4750,1,0,257,0,-257
4751,0,0,11,0,-11
4752,0,0,91,0,-91
4753,1,0,23,0,-23
4754,1,0,49,0,-49
4755,1,1,989,1556,567
4756,0,0,40,0,-40
4757,1,0,16,0,-16
4758,1,1,128,2252,2124
4759,1,1,98,1625,1527
4760,1,1,376,1238,862
4761,1,0,36,0,-36
4762,0,0,87,0,-87
4763,1,1,1510,1383,-127
4764,1,0,19,0,-19
4765,1,0,11,0,-11
4766,0,0,40,0,-40
4767,0,0,35,0,-35
4768,0,0,2,0,-2
4769,1,1,195,2691,2496
4770,1,1,169,1339,1170
4771,1,1,316,2150,1834
4772,1,0,129,0,-129
4773,0,0,51,0,-51
4774,1,1,155,1275,1120
4775,0,0,4,0,-4
4776,1,1,220,1274,1054
4777,0,0,67,0,-67
4778,0,0,2,0,-2
4779,0,0,6,0,-6
4780,1,0,39,0,-39
4781,1,1,483,1232,749
4782,0,0,53,0,-53
4783,1,0,114,0,-114
4784,1,1,371,1385,1014
4785,1,1,1972,1267,-705
4786,1,0,60,0,-60
4787,1,1,189,2220,2031
4788,0,0,22,0,-22
4789,1,1,350,1204,854
4790,1,0,75,0,-75
4791,1,0,44,0,-44
4792,1,0,101,0,-101
4793,1,1,309,1803,1494
4794,1,1,1343,1489,146
4795,1,0,110,0,-110
4796,1,1,199,1219,1020
4797,1,0,12,0,-12
4798,1,1,26,2568,2542
4799,1,0,20,0,-20
4800,0,0,4,0,-4
4801,1,1,1390,1369,-21
4802,0,0,65,0,-65
4803,1,1,130,1351,1221
4804,0,0,2,0,-2
4805,0,0,160,0,-160
4806,0,0,7,0,-7
4807,0,0,138,0,-138
4808,0,0,1,0,-1
4809,1,0,87,0,-87
4810,1,0,17,0,-17
4811,1,0,24,0,-24
4812,0,0,25,0,-25
4813,1,1,2446,1512,-934
4814,0,0,11,0,-11
4815,1,1,243,1881,1638
4816,1,0,2,0,-2
4817,1,0,26,0,-26
4818,1,1,141,1288,1147
4819,1,0,42,0,-42
4820,1,0,83,0,-83
4821,1,0,2,0,-2
4822,1,1,480,1846,1366
4823,0,0,5,0,-5
4824,0,0,107,0,-107
4825,1,0,45,0,-45
4826,0,0,87,0,-87
4827,1,1,593,1415,822
4828,1,0,56,0,-56
4829,0,0,139,0,-139
4830,0,0,65,0,-65
4831,0,0,32,0,-32
4832,0,0,10,0,-10
4833,1,0,54,0,-54
4834,1,1,246,1421,1175
4835,1,0,18,0,-18
4836,1,0,34,0,-34
4837,0,0,40,0,-40
4838,1,0,92,0,-92
4839,0,0,81,0,-81
4840,0,0,12,0,-12
4841,1,0,3,0,-3
4842,0,0,104,0,-104
4843,0,0,54,0,-54
4844,0,0,57,0,-57
4845,0,0,101,0,-101
4846,0,0,61,0,-61
4847,1,0,29,0,-29
4848,1,0,31,0,-31
4849,1,1,650,1206,556
4850,1,0,2,0,-2
4851,1,1,67,1288,1221
4852,1,1,261,1323,1062
4853,1,0,70,0,-70
4854,1,0,23,0,-23
4855,1,1,138,1386,1248
4856,1,1,556,1881,1325
4857,1,1,389,1234,845
4858,1,0,35,0,-35
4859,1,1,231,1223,992
4860,1,1,222,3672,3450
4861,0,0,47,0,-47
4862,1,0,43,0,-43
4863,1,1,1411,1254,-157
4864,0,0,5,0,-5
4865,0,0,30,0,-30
4866,1,0,67,0,-67
4867,0,0,55,0,-55
4868,0,0,126,0,-126
4869,0,0,39,0,-39
4870,1,0,58,0,-58
4871,0,0,2,0,-2
4872,0,0,4,0,-4
4873,1,1,48,1963,1915
4874,1,0,56,0,-56
4875,0,0,111,0,-111
4876,0,0,32,0,-32
4877,1,0,184,0,-184
4878,1,1,717,1350,633
4879,0,0,21,0,-21
4880,1,0,56,0,-56
4881,1,1,498,2035,1537
4882,1,1,240,1853,1613
4883,0,0,30,0,-30
4884,1,1,278,1380,1102
4885,0,0,21,0,-21
4886,0,0,13,0,-13
4887,1,0,20,0,-20
4888,0,0,6,0,-6
4889,1,0,63,0,-63
4890,1,0,37,0,-37
4891,0,0,32,0,-32
4892,1,1,535,1304,769
4893,1,1,242,1699,1457
4894,1,1,592,1350,758
4895,1,0,57,0,-57
4896,1,1,473,1342,869
4897,1,1,362,1275,913
4898,1,0,42,0,-42
4899,0,0,10,0,-10
4900,1,1,251,2268,2017
4901,1,1,463,1201,738
4902,0,0,26,0,-26
4903,1,1,782,1803,1021
4904,0,0,25,0,-25
4905,1,0,108,0,-108
4906,1,1,295,1290,995
4907,0,0,4,0,-4
4908,1,1,1639,1214,-425
4909,0,0,106,0,-106
4910,1,1,200,1310,1110
4911,1,1,479,1356,877
4912,0,0,96,0,-96
4913,1,1,963,1219,256
4914,1,0,34,0,-34
4915,1,0,5,0,-5
4916,0,0,60,0,-60
4917,0,0,3,0,-3
4918,1,1,1793,1396,-397
4919,0,0,25,0,-25
4920,0,0,21,0,-21
4921,1,0,28,0,-28
4922,1,1,197,1278,1081
4923,0,0,14,0,-14
4924,0,0,137,0,-137
4925,0,0,20,0,-20
4926,0,0,10,0,-10
4927,1,0,12,0,-12
4928,0,0,157,0,-157
4929,1,1,386,1388,1002
4930,0,0,21,0,-21
4931,1,0,30,0,-30
4932,1,1,2844,1354,-1490
4933,1,1,268,1292,1024
4934,0,0,29,0,-29
4935,1,1,974,2076,1102
4936,0,0,4,0,-4
4937,0,0,20,0,-20
4938,1,0,0,0,0
4939,1,1,185,1348,1163
4940,1,0,140,0,-140
4941,1,1,90,1817,1727
4942,1,0,16,0,-16
4943,1,1,614,2133,1519
4944,0,0,63,0,-63
4945,0,0,9,0,-9
4946,1,0,18,0,-18
4947,0,0,51,0,-51
4948,1,0,36,0,-36
4949,1,0,34,0,-34
4950,0,0,33,0,-33
4951,1,0,55,0,-55
4952,1,1,315,1224,909
4953,0,0,1,0,-1
4954,1,0,53,0,-53
4955,0,0,25,0,-25
4956,1,0,26,0,-26
4957,1,0,1,0,-1
4958,1,1,358,1337,979
4959,0,0,8,0,-8
4960,0,0,31,0,-31
4961,0,0,32,0,-32
4962,0,0,45,0,-45
4963,0,0,128,0,-128
4964,1,0,4,0,-4
4965,1,0,196,0,-196
4966,1,0,25,0,-25
4967,0,0,20,0,-20
4968,0,0,22,0,-22
4969,0,0,42,0,-42
4970,1,1,149,1261,1112
4971,0,0,46,0,-46
4972,1,1,615,1696,1081
4973,1,0,82,0,-82
4974,0,0,103,0,-103
4975,1,1,715,2530,1815
4976,0,0,24,0,-24
4977,1,1,143,1479,1336
4978,1,0,208,0,-208
4979,1,0,26,0,-26
4980,0,0,40,0,-40
4981,0,0,12,0,-12
4982,0,0,33,0,-33
4983,1,0,59,0,-59
4984,1,0,19,0,-19
4985,1,0,210,0,-210
4986,0,0,9,0,-9
4987,0,0,40,0,-40
4988,1,1,407,1486,1079
4989,0,0,274,0,-274
4990,0,0,6,0,-6
4991,0,0,60,0,-60
4992,0,0,30,0,-30
4993,1,0,75,0,-75
4994,1,1,166,1269,1103
4995,0,0,23,0,-23
4996,1,1,783,1482,699
4997,0,0,121,0,-121
4998,1,1,893,1208,315
4999,0,0,14,0,-14
5000,1,0,41,0,-41
5001,0,0,9,0,-9
5002,0,0,26,0,-26
5003,1,0,118,0,-118
5004,1,0,74,0,-74
5005,0,0,3,0,-3
5006,1,1,146,1304,1158
5007,0,0,4,0,-4
5008,1,0,13,0,-13
5009,0,0,10,0,-10
5010,1,1,327,1847,1520
5011,0,0,0,0,0
5012,1,1,71,1309,1238
5013,0,0,106,0,-106
5014,0,0,20,0,-20
5015,1,0,14,0,-14
5016,1,0,119,0,-119
5017,1,1,300,2047,1747
5018,1,0,21,0,-21
5019,0,0,95,0,-95
5020,1,1,637,1430,793
5021,1,0,41,0,-41
5022,1,1,885,1274,389
5023,1,0,33,0,-33
5024,0,0,7,0,-7
5025,1,0,50,0,-50
5026,1,1,927,1204,277
5027,1,1,221,1524,1303
5028,1,1,1408,1269,-139
5029,1,0,61,0,-61
5030,0,0,11,0,-11
5031,0,0,13,0,-13
5032,1,1,453,1225,772
5033,1,1,1145,1358,213
5034,0,0,107,0,-107
5035,0,0,71,0,-71
5036,1,1,749,1207,458
5037,0,0,38,0,-38
5038,1,0,61,0,-61
5039,0,0,10,0,-10
5040,0,0,44,0,-44
5041,1,1,772,1273,501
5042,0,0,135,0,-135
5043,1,1,6,1392,1386
5044,0,0,11,0,-11
5045,1,1,181,1775,1594
5046,1,0,36,0,-36
5047,0,0,12,0,-12
5048,0,0,68,0,-68
5049,1,0,41,0,-41
5050,1,0,54,0,-54
5051,0,0,62,0,-62
5052,1,0,81,0,-81
5053,1,0,2,0,-2
5054,1,0,32,0,-32
5055,0,0,142,0,-142
5056,1,0,48,0,-48
5057,0,0,91,0,-91
5058,1,1,565,1978,1413
5059,0,0,31,0,-31
5060,0,0,178,0,-178
5061,0,0,51,0,-51
5062,0,0,0,0,0
5063,1,0,9,0,-9
5064,1,1,443,1232,789
5065,0,0,31,0,-31
5066,0,0,87,0,-87
5067,1,0,8,0,-8
5068,1,0,4,0,-4
5069,0,0,46,0,-46
5070,0,0,38,0,-38
5071,1,0,0,0,0
5072,1,0,1,0,-1
5073,1,1,240,1409,1169
5074,0,0,145,0,-145
5075,1,0,148,0,-148
5076,0,0,132,0,-132
5077,1,0,53,0,-53
5078,0,0,35,0,-35
5079,0,0,14,0,-14
5080,1,0,26,0,-26
5081,1,0,124,0,-124
5082,1,1,420,1561,1141
5083,1,1,319,1267,948
5084,1,1,161,1454,1293
5085,1,0,9,0,-9
5086,0,0,185,0,-185
5087,0,0,15,0,-15
5088,1,1,342,3461,3119
5089,0,0,87,0,-87
5090,0,0,93,0,-93
5091,0,0,82,0,-82
5092,0,0,19,0,-19
5093,0,0,36,0,-36
5094,0,0,105,0,-105
5095,1,0,36,0,-36
5096,0,0,22,0,-22
5097,0,0,21,0,-21
5098,1,1,1689,1268,-421
5099,1,1,326,1411,1085
5100,0,0,16,0,-16
5101,1,0,27,0,-27
5102,1,0,27,0,-27
5103,1,0,35,0,-35
5104,1,0,53,0,-53
5105,1,1,135,1272,1137
5106,0,0,128,0,-128
5107,0,0,86,0,-86
5108,1,1,186,1715,1529
5109,0,0,27,0,-27
5110,1,1,1068,1615,547
5111,1,0,29,0,-29
5112,1,0,71,0,-71
5113,1,1,423,1384,961
5114,0,0,183,0,-183
5115,0,0,3,0,-3
5116,0,0,83,0,-83
5117,1,0,0,0,0
5118,0,0,18,0,-18
5119,0,0,73,0,-73
5120,1,1,901,1513,612
5121,1,1,401,2102,1701
5122,0,0,4,0,-4
5123,0,0,68,0,-68
5124,0,0,17,0,-17
5125,1,0,3,0,-3
5126,0,0,172,0,-172
5127,0,0,22,0,-22
5128,1,0,54,0,-54
5129,1,1,497,1221,724
5130,0,0,32,0,-32
5131,1,0,58,0,-58
5132,0,0,14,0,-14
5133,0,0,0,0,0
5134,1,0,63,0,-63
5135,0,0,15,0,-15
5136,0,0,34,0,-34
5137,0,0,6,0,-6
5138,1,0,64,0,-64
5139,1,0,44,0,-44
5140,1,1,921,1803,882
5141,1,0,73,0,-73
5142,1,1,425,1418,993
5143,0,0,27,0,-27
5144,0,0,29,0,-29
5145,0,0,57,0,-57
5146,0,0,66,0,-66
5147,1,0,1,0,-1
5148,1,0,12,0,-12
5149,1,1,1279,1605,326
5150,1,1,291,1251,960
5151,1,0,99,0,-99
5152,1,1,311,1293,982
5153,1,0,23,0,-23
5154,0,0,36,0,-36
5155,0,0,8,0,-8
5156,1,1,290,1864,1574
5157,0,0,126,0,-126
5158,1,1,440,1279,839
5159,1,1,1056,1563,507
5160,1,1,57,1672,1615
5161,1,0,22,0,-22
5162,1,0,83,0,-83
5163,1,0,139,0,-139
5164,1,0,13,0,-13
5165,0,0,39,0,-39
5166,1,0,39,0,-39
5167,1,1,1285,1794,509
5168,1,1,608,1831,1223
5169,1,1,751,1253,502
5170,1,1,336,2183,1847
5171,0,0,51,0,-51
5172,1,1,177,1303,1126
5173,1,1,291,1360,1069
5174,0,0,24,0,-24
5175,0,0,5,0,-5
5176,0,0,97,0,-97
5177,1,1,131,1422,1291
5178,0,0,1,0,-1
5179,1,1,747,2070,1323
5180,1,1,317,1768,1451
5181,0,0,62,0,-62
5182,0,0,130,0,-130
5183,0,0,28,0,-28
5184,1,0,55,0,-55
5185,1,0,34,0,-34
5186,0,0,41,0,-41
5187,1,1,153,1544,1391
5188,1,0,3,0,-3
5189,1,0,4,0,-4
5190,1,0,52,0,-52
5191,0,0,31,0,-31
5192,0,0,38,0,-38
5193,1,1,281,3058,2777
5194,1,1,959,1473,514
5195,1,1,366,1200,834
5196,0,0,1,0,-1
5197,1,0,54,0,-54
5198,0,0,15,0,-15
5199,1,1,35,2040,2005
5200,1,0,94,0,-94
5201,1,1,98,1242,1144
5202,1,0,74,0,-74
5203,1,0,107,0,-107
5204,0,0,16,0,-16
5205,1,1,91,1255,1164
5206,0,0,69,0,-69
5207,0,0,15,0,-15
5208,0,0,71,0,-71
5209,1,0,9,0,-9
5210,0,0,32,0,-32
5211,0,0,2,0,-2
5212,0,0,4,0,-4
5213,0,0,128,0,-128
5214,1,1,453,1216,763
5215,1,0,1,0,-1
5216,1,1,1156,1626,470
5217,0,0,68,0,-68
5218,0,0,33,0,-33
5219,1,0,19,0,-19
5220,0,0,9,0,-9
5221,0,0,102,0,-102
5222,1,0,141,0,-141
5223,1,1,273,1399,1126
5224,0,0,25,0,-25
5225,1,0,41,0,-41
5226,1,1,445,1329,884
5227,1,0,63,0,-63
5228,1,0,1,0,-1
5229,0,0,60,0,-60
5230,1,1,348,1572,1224
5231,1,0,3,0,-3
5232,1,1,232,2098,1866
5233,0,0,35,0,-35
5234,1,1,178,2391,2213
5235,1,1,150,1225,1075
5236,0,0,34,0,-34
5237,1,0,66,0,-66
5238,1,1,333,1292,959
5239,1,0,8,0,-8
5240,0,0,47,0,-47
5241,1,1,676,2142,1466
5242,0,0,21,0,-21
5243,1,1,134,1207,1073
5244,1,1,86,3081,2995
5245,1,1,688,1461,773
5246,1,1,289,1464,1175
5247,0,0,81,0,-81
5248,1,1,51,1589,1538
5249,1,1,84,1321,1237
5250,1,1,73,1327,1254
5251,0,0,29,0,-29
5252,1,0,7,0,-7
5253,1,1,346,1398,1052
5254,1,0,9,0,-9
5255,1,1,404,1375,971
5256,1,1,282,1268,986
5257,0,0,95,0,-95
5258,1,1,369,2019,1650
5259,1,0,13,0,-13
5260,0,0,40,0,-40
5261,0,0,17,0,-17
5262,1,0,58,0,-58
5263,1,1,1112,1965,853
5264,0,0,65,0,-65
5265,0,0,236,0,-236
5266,0,0,17,0,-17
5267,0,0,12,0,-12
5268,0,0,3,0,-3
5269,0,0,24,0,-24
5270,1,0,92,0,-92
5271,1,1,43,1254,1211
5272,1,0,51,0,-51
5273,0,0,37,0,-37
5274,1,0,51,0,-51
5275,1,1,157,1422,1265
5276,0,0,27,0,-27
5277,1,1,1450,1227,-223
5278,0,0,205,0,-205
5279,1,1,651,1376,725
5280,0,0,102,0,-102
5281,1,1,708,1260,552
5282,1,0,29,0,-29
5283,0,0,34,0,-34
5284,1,0,150,0,-150
5285,1,0,172,0,-172
5286,1,1,105,1305,1200
5287,1,0,25,0,-25
5288,0,0,22,0,-22
5289,1,1,129,1651,1522
5290,1,0,11,0,-11
5291,1,0,35,0,-35
5292,1,0,26,0,-26
5293,1,0,21,0,-21
5294,0,0,7,0,-7
5295,1,0,19,0,-19
5296,1,1,129,1464,1335
5297,1,0,70,0,-70
5298,1,0,58,0,-58
5299,1,1,98,1818,1720
5300,1,0,69,0,-69
5301,1,1,2622,1331,-1291
5302,0,0,14,0,-14
5303,0,0,43,0,-43
5304,1,1,175,1232,1057
5305,0,0,31,0,-31
5306,0,0,183,0,-183
5307,1,1,440,1564,1124
5308,0,0,196,0,-196
5309,1,1,151,1333,1182
5310,1,0,13,0,-13
5311,0,0,52,0,-52
5312,1,0,28,0,-28
5313,1,1,229,1213,984
5314,0,0,87,0,-87
5315,1,0,29,0,-29
5316,1,0,13,0,-13
5317,1,0,2,0,-2
5318,0,0,28,0,-28
5319,0,0,5,0,-5
5320,1,0,12,0,-12
5321,0,0,27,0,-27
5322,1,0,62,0,-62
5323,1,0,39,0,-39
5324,1,0,29,0,-29
5325,1,1,40,1760,1720
5326,1,1,77,1651,1574
5327,0,0,52,0,-52
5328,0,0,102,0,-102
5329,1,1,71,1204,1133
5330,1,1,194,1393,1199
5331,1,0,45,0,-45
5332,1,0,12,0,-12
5333,0,0,54,0,-54
5334,0,0,155,0,-155
5335,1,1,1462,1262,-200
5336,1,1,513,1231,718
5337,1,1,465,1259,794
5338,1,1,1017,1422,405
5339,0,0,70,0,-70
5340,0,0,75,0,-75
5341,1,0,41,0,-41
5342,0,0,24,0,-24
5343,0,0,24,0,-24
5344,0,0,11,0,-11
5345,1,1,74,1264,1190
5346,1,0,16,0,-16
5347,0,0,31,0,-31
5348,0,0,31,0,-31
5349,0,0,83,0,-83
5350,0,0,37,0,-37
5351,1,0,42,0,-42
5352,1,0,42,0,-42
5353,1,1,875,1490,615
5354,1,1,214,2417,2203
5355,1,1,812,2168,1356
5356,0,0,33,0,-33
5357,1,1,239,1701,1462
5358,1,0,118,0,-118
5359,1,1,593,1668,1075
5360,0,0,71,0,-71
5361,1,0,39,0,-39
5362,1,1,405,1594,1189
5363,1,0,99,0,-99
5364,1,0,20,0,-20
5365,1,0,36,0,-36
5366,1,1,135,1201,1066
5367,1,0,76,0,-76
5368,1,1,224,2806,2582
5369,1,0,10,0,-10
5370,0,0,203,0,-203
5371,1,1,806,1393,587
5372,1,1,688,2014,1326
5373,0,0,27,0,-27
5374,1,1,390,1817,1427
5375,1,0,5,0,-5
5376,1,0,84,0,-84
5377,0,0,236,0,-236
5378,1,1,110,1469,1359
5379,0,0,71,0,-71
5380,0,0,67,0,-67
5381,0,0,20,0,-20
5382,1,0,23,0,-23
5383,0,0,17,0,-17
5384,0,0,25,0,-25
5385,1,0,57,0,-57
5386,1,0,57,0,-57
5387,0,0,61,0,-61
5388,1,0,0,0,0
5389,0,0,134,0,-134
5390,0,0,18,0,-18
5391,0,0,166,0,-166
5392,1,0,6,0,-6
5393,0,0,27,0,-27
5394,0,0,9,0,-9
5395,0,0,0,0,0
5396,0,0,62,0,-62
5397,0,0,2,0,-2
5398,1,0,53,0,-53
5399,1,0,61,0,-61
5400,1,0,5,0,-5
5401,1,0,21,0,-21
5402,1,0,0,0,0
5403,1,1,247,1839,1592
5404,0,0,33,0,-33
5405,1,1,348,1368,1020
5406,0,0,20,0,-20
5407,0,0,45,0,-45
5408,0,0,67,0,-67
5409,0,0,10,0,-10
5410,1,1,330,2992,2662
5411,1,1,1597,1220,-377
5412,0,0,84,0,-84
5413,0,0,65,0,-65
5414,1,0,49,0,-49
5415,0,0,109,0,-109
5416,0,0,0,0,0
5417,1,0,4,0,-4
5418,1,1,115,1288,1173
5419,1,1,1147,1535,388
5420,1,0,24,0,-24
5421,1,0,48,0,-48
5422,1,1,1032,1245,213
5423,0,0,95,0,-95
5424,1,1,467,1204,737
5425,1,0,98,0,-98
5426,0,0,4,0,-4
5427,1,0,15,0,-15
5428,0,0,51,0,-51
5429,0,0,10,0,-10
5430,0,0,16,0,-16
5431,1,0,24,0,-24
5432,1,0,7,0,-7
5433,0,0,73,0,-73
5434,0,0,2,0,-2
5435,1,1,574,1216,642
5436,1,0,85,0,-85
5437,0,0,9,0,-9
5438,1,1,48,1721,1673
5439,1,0,2,0,-2
5440,1,1,125,1420,1295
5441,1,0,28,0,-28
5442,1,1,505,1264,759
5443,1,1,50,1700,1650
5444,1,0,64,0,-64
5445,1,1,342,1255,913
5446,1,0,6,0,-6
5447,0,0,39,0,-39
5448,1,1,206,1324,1118
5449,1,1,2652,1498,-1154
5450,0,0,168,0,-168
5451,1,1,1307,1646,339
5452,1,0,149,0,-149
5453,0,0,83,0,-83
5454,0,0,88,0,-88
5455,1,1,280,1344,1064
5456,1,1,268,1455,1187
5457,0,0,86,0,-86
5458,1,1,500,1427,927
5459,0,0,81,0,-81
5460,0,0,225,0,-225
5461,0,0,38,0,-38
5462,1,1,1366,1284,-82
5463,0,0,26,0,-26
5464,1,1,1420,1534,114
5465,0,0,28,0,-28
5466,1,1,228,1637,1409
5467,0,0,73,0,-73
5468,0,0,9,0,-9
5469,0,0,17,0,-17
5470,0,0,11,0,-11
5471,1,0,15,0,-15
5472,1,0,10,0,-10
5473,1,1,325,2179,1854
5474,1,0,28,0,-28
5475,0,0,8,0,-8
5476,1,1,851,2079,1228
5477,1,0,0,0,0
5478,1,1,1339,1934,595
5479,1,0,5,0,-5
5480,1,1,195,1239,1044
5481,1,0,8,0,-8
5482,0,0,39,0,-39
5483,1,0,9,0,-9
5484,1,1,691,1230,539
5485,0,0,42,0,-42
5486,1,1,918,1263,345
5487,1,1,710,1231,521
5488,0,0,33,0,-33
5489,0,0,34,0,-34
5490,1,0,50,0,-50
5491,0,0,18,0,-18
5492,1,1,389,2557,2168
5493,0,0,33,0,-33
5494,0,0,68,0,-68
5495,1,1,2373,1413,-960
5496,1,1,83,1791,1708
5497,0,0,131,0,-131
5498,1,0,7,0,-7
5499,0,0,154,0,-154
5500,1,1,218,1806,1588
5501,0,0,69,0,-69
5502,1,0,50,0,-50
5503,1,1,148,2404,2256
5504,1,0,5,0,-5
5505,0,0,188,0,-188
5506,1,0,6,0,-6
5507,1,1,554,1615,1061
5508,1,1,808,1517,709
5509,1,1,421,1226,805
5510,0,0,26,0,-26
5511,1,1,242,1286,1044
5512,0,0,21,0,-21
5513,0,0,28,0,-28
5514,1,1,24,1268,1244
5515,1,0,24,0,-24
5516,1,1,1059,1267,208
5517,0,0,84,0,-84
5518,0,0,77,0,-77
5519,1,0,0,0,0
5520,1,1,1097,1558,461
5521,1,0,17,0,-17
5522,0,0,6,0,-6
5523,1,1,1401,1318,-83
5524,1,1,812,1341,529
5525,1,1,447,1476,1029
5526,0,0,5,0,-5
5527,1,1,190,1630,1440
5528,1,0,105,0,-105
5529,1,0,22,0,-22
5530,1,0,1,0,-1
5531,0,0,49,0,-49
5532,0,0,36,0,-36
5533,0,0,22,0,-22
5534,0,0,13,0,-13
5535,1,1,118,1454,1336
5536,1,0,45,0,-45
5537,1,0,95,0,-95
5538,0,0,40,0,-40
5539,1,1,138,1419,1281
5540,0,0,14,0,-14
5541,1,0,6,0,-6
5542,1,0,4,0,-4
5543,0,0,11,0,-11
5544,1,1,426,1279,853
5545,1,0,45,0,-45
5546,1,0,34,0,-34
5547,1,1,47,1330,1283
5548,0,0,26,0,-26
5549,1,0,132,0,-132
5550,1,1,566,1514,948
5551,0,0,24,0,-24
5552,1,1,905,1411,506
5553,1,0,11,0,-11
5554,1,1,1170,1811,641
5555,1,1,336,1503,1167
5556,1,0,0,0,0
5557,1,0,118,0,-118
5558,1,0,14,0,-14
5559,1,0,8,0,-8
5560,1,0,65,0,-65
5561,0,0,28,0,-28
5562,1,0,2,0,-2
5563,1,1,51,1293,1242
5564,0,0,9,0,-9
5565,1,0,75,0,-75
5566,0,0,1,0,-1
5567,0,0,9,0,-9
5568,0,0,10,0,-10
5569,1,0,74,0,-74
5570,1,0,49,0,-49
5571,1,1,1193,2168,975
5572,1,1,192,1509,1317
5573,1,0,100,0,-100
5574,1,1,785,1339,554
5575,0,0,48,0,-48
5576,0,0,37,0,-37
5577,0,0,76,0,-76
5578,1,1,319,1937,1618
5579,1,1,694,1453,759
5580,0,0,6,0,-6
5581,1,1,448,1210,762
5582,0,0,161,0,-161
5583,1,1,32,2883,2851
5584,0,0,8,0,-8
5585,1,1,135,1368,1233
5586,0,0,154,0,-154
5587,1,1,187,2883,2696
5588,1,0,15,0,-15
5589,1,1,21,1542,1521
5590,1,1,376,1240,864
5591,1,0,1,0,-1
5592,0,0,9,0,-9
5593,1,0,136,0,-136
5594,1,1,224,1295,1071
5595,1,1,156,1224,1068
5596,1,0,55,0,-55
5597,0,0,13,0,-13
5598,0,0,61,0,-61
5599,1,0,54,0,-54
5600,0,0,27,0,-27
5601,1,0,13,0,-13
5602,0,0,17,0,-17
5603,1,1,1959,1338,-621
5604,1,0,67,0,-67
5605,1,0,16,0,-16
5606,1,1,539,1224,685
5607,1,1,295,1528,1233
5608,1,0,3,0,-3
5609,1,0,3,0,-3
5610,1,1,881,1578,697
5611,0,0,167,0,-167
5612,1,0,17,0,-17
5613,1,1,701,1300,599
5614,0,0,70,0,-70
5615,0,0,55,0,-55
5616,1,1,349,2394,2045
5617,0,0,3,0,-3
5618,1,1,72,1387,1315
5619,0,0,40,0,-40
5620,0,0,23,0,-23
5621,0,0,94,0,-94
5622,0,0,32,0,-32
5623,1,1,551,1227,676
5624,1,1,248,4222,3974
5625,1,0,13,0,-13
5626,1,0,5,0,-5
5627,1,0,46,0,-46
5628,0,0,71,0,-71
5629,1,0,46,0,-46
5630,0,0,9,0,-9
5631,0,0,9,0,-9
5632,0,0,4,0,-4
5633,1,0,130,0,-130
5634,1,0,153,0,-153
5635,0,0,40,0,-40
5636,1,0,5,0,-5
5637,0,0,3,0,-3
5638,0,0,129,0,-129
5639,1,0,4,0,-4
5640,1,0,115,0,-115
5641,1,0,5,0,-5
5642,1,0,58,0,-58
5643,1,0,51,0,-51
5644,0,0,27,0,-27
5645,1,0,0,0,0
5646,1,0,18,0,-18
5647,0,0,73,0,-73
5648,1,1,495,1299,804
5649,0,0,33,0,-33
5650,0,0,35,0,-35
5651,0,0,77,0,-77
5652,1,1,148,1240,1092
5653,1,0,57,0,-57
5654,0,0,347,0,-347
5655,0,0,12,0,-12
5656,0,0,13,0,-13
5657,1,0,13,0,-13
5658,1,1,214,2167,1953
5659,1,0,12,0,-12
5660,0,0,0,0,0
5661,0,0,30,0,-30
5662,1,0,43,0,-43
5663,1,1,1656,1301,-355
5664,0,0,96,0,-96
5665,1,1,310,1233,923
5666,1,0,44,0,-44
5667,1,0,44,0,-44
5668,0,0,34,0,-34
5669,1,1,216,1249,1033
5670,0,0,1,0,-1
5671,1,1,402,1341,939
5672,0,0,2,0,-2
5673,1,1,112,1282,1170
5674,1,0,7,0,-7
5675,1,1,895,2236,1341
5676,1,0,52,0,-52
5677,1,1,499,1282,783
5678,1,0,27,0,-27
5679,1,0,28,0,-28
5680,1,0,118,0,-118
5681,0,0,40,0,-40
5682,1,0,50,0,-50
5683,0,0,16,0,-16
5684,1,0,68,0,-68
5685,0,0,2,0,-2
5686,1,1,96,2988,2892
5687,1,0,3,0,-3
5688,0,0,8,0,-8
5689,1,1,1260,1320,60
5690,1,1,230,1427,1197
5691,0,0,201,0,-201
5692,0,0,112,0,-112
5693,1,1,369,1843,1474
5694,1,1,178,1604,1426
5695,0,0,123,0,-123
5696,1,1,378,1294,916
5697,0,0,7,0,-7
5698,1,1,226,1248,1022
5699,1,1,58,1272,1214
5700,1,0,116,0,-116
5701,0,0,40,0,-40
5702,0,0,43,0,-43
5703,1,1,41,1424,1383
5704,1,1,361,1655,1294
5705,1,1,1236,1417,181
5706,0,0,105,0,-105
5707,0,0,24,0,-24
5708,0,0,41,0,-41
5709,0,0,13,0,-13
5710,1,1,248,1312,1064
5711,1,1,506,1564,1058
5712,0,0,344,0,-344
5713,1,0,7,0,-7
5714,0,0,73,0,-73
5715,1,1,1155,1402,247
5716,1,1,833,1210,377
5717,1,0,130,0,-130
5718,1,1,188,1390,1202
5719,0,0,27,0,-27
5720,1,1,27,1702,1675
5721,0,0,2,0,-2
5722,1,1,316,1643,1327
5723,1,1,249,1248,999
5724,0,0,21,0,-21
5725,0,0,20,0,-20
5726,1,1,930,2776,1846
5727,1,0,19,0,-19
5728,1,1,346,1209,863
5729,0,0,82,0,-82
5730,1,0,8,0,-8
5731,1,1,359,1219,860
5732,0,0,116,0,-116
5733,1,0,17,0,-17
5734,1,1,196,1628,1432
5735,0,0,75,0,-75
5736,0,0,22,0,-22
5737,1,1,1568,1522,-46
5738,0,0,60,0,-60
5739,0,0,63,0,-63
5740,1,0,45,0,-45
5741,1,0,32,0,-32
5742,1,0,22,0,-22
5743,0,0,30,0,-30
5744,1,1,949,1597,648
5745,1,0,58,0,-58
5746,1,1,977,1344,367
5747,0,0,26,0,-26
5748,0,0,31,0,-31
5749,1,0,59,0,-59
5750,1,1,295,1309,1014
5751,1,1,613,1264,651
5752,0,0,244,0,-244
5753,1,0,27,0,-27
5754,1,0,10,0,-10
5755,1,0,43,0,-43
5756,1,1,160,1841,1681
5757,0,0,10,0,-10
5758,1,0,24,0,-24
5759,0,0,36,0,-36
5760,0,0,19,0,-19
5761,1,0,24,0,-24
5762,1,1,144,1552,1408
5763,0,0,35,0,-35
5764,0,0,56,0,-56
5765,1,1,653,1296,643
5766,1,1,273,1719,1446
5767,1,1,582,1237,655
5768,0,0,26,0,-26
5769,1,0,53,0,-53
5770,1,0,48,0,-48
5771,1,0,36,0,-36
5772,1,1,122,1296,1174
5773,0,0,8,0,-8
5774,0,0,22,0,-22
5775,1,0,92,0,-92
5776,0,0,26,0,-26
5777,1,1,429,2961,2532
5778,0,0,81,0,-81
5779,1,0,155,0,-155
5780,0,0,21,0,-21
5781,1,1,592,2544,1952
5782,1,1,310,1982,1672
5783,1,0,75,0,-75
5784,1,0,14,0,-14
5785,0,0,185,0,-185
5786,0,0,73,0,-73
5787,0,0,14,0,-14
5788,1,1,566,1747,1181
5789,1,0,16,0,-16
5790,0,0,30,0,-30
5791,1,0,65,0,-65
5792,0,0,87,0,-87
5793,0,0,224,0,-224
5794,0,0,36,0,-36
5795,1,0,22,0,-22
5796,0,0,17,0,-17
5797,0,0,160,0,-160
5798,0,0,0,0,0
5799,1,1,181,1536,1355
5800,1,0,43,0,-43
5801,0,0,72,0,-72
5802,0,0,4,0,-4
5803,0,0,51,0,-51
5804,0,0,17,0,-17
5805,0,0,43,0,-43
5806,1,1,236,2581,2345
5807,0,0,34,0,-34
5808,0,0,74,0,-74
5809,1,1,152,1801,1649
5810,1,0,4,0,-4
5811,0,0,15,0,-15
5812,0,0,132,0,-132
5813,0,0,6,0,-6
5814,0,0,17,0,-17
5815,0,0,22,0,-22
5816,1,0,87,0,-87
5817,1,1,373,1970,1597
5818,0,0,42,0,-42
5819,0,0,14,0,-14
5820,0,0,50,0,-50
5821,1,1,511,1355,844
5822,1,0,3,0,-3
5823,1,1,339,1264,925
5824,1,1,44,5086,5042
5825,1,0,60,0,-60
5826,1,1,931,2964,2033
5827,0,0,44,0,-44
5828,1,0,140,0,-140
5829,1,1,245,1349,1104
5830,1,0,44,0,-44
5831,0,0,19,0,-19
5832,0,0,50,0,-50
5833,1,1,199,1245,1046
5834,0,0,55,0,-55
5835,1,1,215,1339,1124
5836,1,0,24,0,-24
5837,1,0,55,0,-55
5838,0,0,62,0,-62
5839,1,1,222,1310,1088
5840,1,0,1,0,-1
5841,0,0,1,0,-1
5842,1,1,59,1341,1282
5843,0,0,83,0,-83
5844,0,0,52,0,-52
5845,1,1,881,2899,2018
5846,1,0,77,0,-77
5847,1,1,569,1542,973
5848,1,1,633,1545,912
5849,1,1,270,2162,1892
5850,1,1,144,2244,2100
5851,0,0,25,0,-25
5852,1,0,10,0,-10
5853,1,1,350,1334,984
5854,1,0,106,0,-106
5855,1,1,1517,1253,-264
5856,1,1,871,1550,679
5857,1,0,111,0,-111
5858,1,0,14,0,-14
5859,0,0,5,0,-5
5860,1,0,19,0,-19
5861,0,0,4,0,-4
5862,1,1,6,1781,1775
5863,0,0,11,0,-11
5864,0,0,100,0,-100
5865,1,0,81,0,-81
5866,0,0,3,0,-3
5867,0,0,54,0,-54
5868,1,1,146,1327,1181
5869,0,0,16,0,-16
5870,0,0,44,0,-44
5871,0,0,101,0,-101
5872,1,0,164,0,-164
5873,0,0,61,0,-61
5874,1,0,9,0,-9
5875,0,0,57,0,-57
5876,0,0,208,0,-208
5877,0,0,3,0,-3
5878,1,0,152,0,-152
5879,0,0,55,0,-55
5880,1,0,33,0,-33
5881,1,1,115,1369,1254
5882,1,0,18,0,-18
5883,0,0,14,0,-14
5884,1,0,25,0,-25
5885,0,0,44,0,-44
5886,1,1,755,1826,1071
5887,0,0,219,0,-219
5888,1,1,1005,1246,241
5889,1,0,36,0,-36
5890,1,0,3,0,-3
5891,0,0,5,0,-5
5892,0,0,14,0,-14
5893,1,1,624,1257,633
5894,1,0,0,0,0
5895,1,0,2,0,-2
5896,0,0,39,0,-39
5897,0,0,24,0,-24
5898,0,0,25,0,-25
5899,0,0,17,0,-17
5900,1,0,4,0,-4
5901,1,0,199,0,-199
5902,1,1,499,1203,704
5903,1,1,1081,1472,391
5904,0,0,16,0,-16
5905,1,1,857,1605,748
5906,1,1,1276,1399,123
5907,1,1,2660,2264,-396
5908,1,1,9,1577,1568
5909,1,0,6,0,-6
5910,1,0,27,0,-27
5911,1,0,175,0,-175
5912,0,0,24,0,-24
5913,1,1,869,1911,1042
5914,0,0,93,0,-93
5915,0,0,8,0,-8
5916,0,0,141,0,-141
5917,0,0,10,0,-10
5918,0,0,0,0,0
5919,1,0,40,0,-40
5920,0,0,85,0,-85
5921,1,0,68,0,-68
5922,1,1,953,1964,1011
5923,1,1,602,1420,818
5924,1,0,6,0,-6
5925,0,0,53,0,-53
5926,1,0,94,0,-94
5927,1,0,87,0,-87
5928,0,0,54,0,-54
5929,1,1,354,1233,879
5930,0,0,31,0,-31
5931,1,1,858,1250,392
5932,1,0,62,0,-62
5933,0,0,23,0,-23
5934,1,0,175,0,-175
5935,0,0,102,0,-102
5936,0,0,43,0,-43
5937,0,0,88,0,-88
5938,1,1,345,1757,1412
5939,1,1,12,1367,1355
5940,1,0,10,0,-10
5941,0,0,29,0,-29
5942,0,0,78,0,-78
5943,1,0,56,0,-56
5944,1,1,277,1212,935
5945,0,0,43,0,-43
5946,1,1,413,1967,1554
5947,0,0,31,0,-31
5948,0,0,87,0,-87
5949,0,0,63,0,-63
5950,0,0,14,0,-14
5951,1,1,917,1206,289
5952,0,0,2,0,-2
5953,1,0,67,0,-67
5954,0,0,38,0,-38
5955,0,0,23,0,-23
5956,0,0,78,0,-78
5957,1,0,31,0,-31
5958,0,0,1,0,-1
5959,1,0,7,0,-7
5960,1,0,11,0,-11
5961,1,0,10,0,-10
5962,0,0,31,0,-31
5963,1,0,17,0,-17
5964,1,1,1132,1200,68
5965,1,1,160,1738,1578
5966,1,0,14,0,-14
5967,0,0,4,0,-4
5968,1,0,51,0,-51
5969,1,1,130,1564,1434
5970,1,0,44,0,-44
5971,0,0,63,0,-63
5972,1,0,135,0,-135
5973,1,1,503,1460,957
5974,1,1,607,2073,1466
5975,1,0,230,0,-230
5976,1,0,57,0,-57
5977,1,0,29,0,-29
5978,0,0,26,0,-26
5979,0,0,8,0,-8
5980,1,1,554,1207,653
5981,1,0,62,0,-62
5982,1,1,952,1202,250
5983,1,0,17,0,-17
5984,1,1,460,1287,827
5985,1,0,73,0,-73
5986,0,0,5,0,-5
5987,0,0,93,0,-93
5988,1,1,321,1681,1360
5989,1,0,86,0,-86
5990,1,1,446,1262,816
5991,1,0,95,0,-95
5992,1,1,77,1209,1132
5993,1,0,18,0,-18
5994,0,0,120,0,-120
5995,0,0,4,0,-4
5996,1,1,430,1501,1071
5997,0,0,108,0,-108
5998,1,1,243,2363,2120
5999,1,0,74,0,-74
6000,0,0,29,0,-29
6001,0,0,10,0,-10
6002,1,1,117,2279,2162
6003,1,0,189,0,-189
6004,0,0,71,0,-71
6005,0,0,119,0,-119
6006,0,0,91,0,-91
6007,0,0,152,0,-152
6008,1,1,1001,2213,1212
6009,1,0,26,0,-26
6010,0,0,66,0,-66
6011,1,0,112,0,-112
6012,0,0,91,0,-91
6013,1,0,87,0,-87
6014,0,0,89,0,-89
6015,1,1,1456,1483,27
6016,1,1,642,1446,804
6017,0,0,0,0,0
6018,0,0,32,0,-32
6019,1,0,14,0,-14
6020,1,1,1473,1362,-111
6021,1,1,1922,1218,-704
6022,1,0,1,0,-1
6023,0,0,2,0,-2
6024,0,0,79,0,-79
6025,0,0,31,0,-31
6026,1,1,101,1313,1212
6027,1,0,6,0,-6
6028,1,0,23,0,-23
6029,0,0,18,0,-18
6030,1,0,70,0,-70
6031,1,0,36,0,-36
6032,0,0,17,0,-17
6033,1,0,11,0,-11
6034,1,1,2605,1246,-1359
6035,1,1,575,1246,671
6036,0,0,15,0,-15
6037,0,0,177,0,-177
6038,0,0,27,0,-27
6039,1,1,228,1393,1165
6040,1,0,8,0,-8
6041,1,1,231,1326,1095
6042,1,1,90,1259,1169
6043,1,1,1306,1258,-48
6044,1,1,768,1304,536
6045,0,0,29,0,-29
6046,1,1,1334,1766,432
6047,0,0,72,0,-72
6048,0,0,170,0,-170
6049,1,0,71,0,-71
6050,1,1,503,1254,751
6051,1,1,157,1380,1223
6052,0,0,8,0,-8
6053,0,0,17,0,-17
6054,1,1,1294,1227,-67
6055,1,0,24,0,-24
6056,1,0,32,0,-32
6057,1,0,47,0,-47
6058,1,1,165,1507,1342
6059,0,0,40,0,-40
6060,1,0,21,0,-21
6061,1,0,14,0,-14
6062,0,0,83,0,-83
6063,1,0,100,0,-100
6064,1,1,261,2060,1799
6065,1,0,67,0,-67
6066,1,0,106,0,-106
6067,1,1,1083,1489,406
6068,0,0,63,0,-63
6069,1,1,359,2739,2380
6070,0,0,40,0,-40
6071,0,0,200,0,-200
6072,0,0,65,0,-65
6073,1,1,339,1581,1242
6074,0,0,5,0,-5
6075,0,0,4,0,-4
6076,1,0,20,0,-20
6077,1,0,50,0,-50
6078,1,0,17,0,-17
6079,0,0,1,0,-1
6080,0,0,26,0,-26
6081,0,0,9,0,-9
6082,0,0,53,0,-53
6083,1,0,68,0,-68
6084,1,0,122,0,-122
6085,1,1,240,1292,1052
6086,0,0,3,0,-3
6087,0,0,61,0,-61
6088,1,1,344,1395,1051
6089,1,1,8,1518,1510
6090,1,0,24,0,-24
6091,1,1,978,3245,2267
6092,1,0,59,0,-59
6093,1,0,113,0,-113
6094,1,1,585,2612,2027
6095,0,0,28,0,-28
6096,0,0,76,0,-76
6097,1,1,234,1531,1297
6098,1,1,396,1221,825
6099,1,0,70,0,-70
6100,1,1,581,2472,1891
6101,0,0,71,0,-71
6102,1,1,351,1471,1120
6103,1,1,82,1308,1226
6104,0,0,129,0,-129
6105,1,0,3,0,-3
6106,1,1,30,2216,2186
6107,1,0,18,0,-18
6108,1,1,601,1534,933
6109,1,1,678,1344,666
6110,0,0,60,0,-60
6111,1,0,6,0,-6
6112,1,1,403,1358,955
6113,1,1,156,1685,1529
6114,0,0,23,0,-23
6115,1,0,106,0,-106
6116,1,1,102,1438,1336
6117,1,0,54,0,-54
6118,1,1,638,1333,695
6119,1,1,231,1290,1059
6120,0,0,147,0,-147
6121,1,1,224,1718,1494
6122,0,0,32,0,-32
6123,1,1,126,1259,1133
6124,0,0,83,0,-83
6125,1,0,21,0,-21
6126,0,0,35,0,-35
6127,0,0,4,0,-4
6128,1,0,25,0,-25
6129,1,0,23,0,-23
6130,1,0,3,0,-3
6131,0,0,69,0,-69
6132,0,0,65,0,-65
6133,1,0,33,0,-33
6134,1,0,32,0,-32
6135,1,1,422,1220,798
6136,0,0,37,0,-37
6137,0,0,58,0,-58
6138,1,0,16,0,-16
6139,0,0,20,0,-20
6140,1,0,2,0,-2
6141,0,0,238,0,-238
6142,1,0,18,0,-18
6143,1,1,110,1498,1388
6144,1,0,41,0,-41
6145,1,0,194,0,-194
6146,1,1,615,1516,901
6147,1,1,895,1375,480
6148,1,1,1111,1956,845
6149,1,0,24,0,-24
6150,0,0,122,0,-122
6151,1,0,235,0,-235
6152,1,0,1,0,-1
6153,1,1,556,1294,738
6154,1,1,497,1339,842
6155,0,0,74,0,-74
6156,0,0,3,0,-3
6157,0,0,11,0,-11
6158,0,0,19,0,-19
6159,0,0,76,0,-76
6160,1,0,35,0,-35
6161,1,0,14,0,-14
6162,0,0,57,0,-57
6163,1,0,24,0,-24
6164,1,0,34,0,-34
6165,1,0,158,0,-158
6166,1,0,4,0,-4
6167,1,0,9,0,-9
6168,0,0,20,0,-20
6169,1,1,624,1611,987
6170,1,0,10,0,-10
6171,0,0,78,0,-78
6172,0,0,54,0,-54
6173,0,0,189,0,-189
6174,1,1,100,1414,1314
6175,1,1,392,1436,1044
6176,0,0,20,0,-20
6177,1,1,857,1249,392
6178,1,0,28,0,-28
6179,0,0,39,0,-39
6180,1,0,49,0,-49
6181,0,0,99,0,-99
6182,0,0,146,0,-146
6183,0,0,3,0,-3
6184,1,1,660,1804,1144
6185,1,0,8,0,-8
6186,1,0,22,0,-22
6187,1,0,29,0,-29
6188,1,1,246,1485,1239
6189,1,1,147,1376,1229
6190,1,1,279,1387,1108
6191,1,0,108,0,-108
6192,1,0,17,0,-17
6193,0,0,53,0,-53
6194,1,0,66,0,-66
6195,0,0,4,0,-4
6196,0,0,33,0,-33
6197,1,1,333,1311,978
6198,1,0,81,0,-81
6199,0,0,0,0,0
6200,0,0,17,0,-17
6201,0,0,102,0,-102
6202,0,0,34,0,-34
6203,0,0,65,0,-65
6204,1,0,24,0,-24
6205,0,0,95,0,-95
6206,1,1,539,1650,1111
6207,0,0,22,0,-22
6208,1,0,46,0,-46
6209,0,0,60,0,-60
6210,0,0,6,0,-6
6211,1,0,9,0,-9
6212,0,0,36,0,-36
6213,1,0,40,0,-40
6214,0,0,37,0,-37
6215,0,0,128,0,-128
6216,1,0,166,0,-166
6217,1,1,1109,1508,399
6218,0,0,71,0,-71
6219,1,0,43,0,-43
6220,0,0,33,0,-33
6221,1,0,34,0,-34
6222,0,0,109,0,-109
6223,1,1,477,1389,912
6224,1,0,36,0,-36
6225,0,0,51,0,-51
6226,1,0,66,0,-66
6227,0,0,19,0,-19
6228,1,1,779,2087,1308
6229,1,1,681,1245,564
6230,1,1,403,1518,1115
6231,1,0,6,0,-6
6232,0,0,55,0,-55
6233,0,0,61,0,-61
6234,1,0,41,0,-41
6235,1,1,535,1232,697
6236,1,1,135,1698,1563
6237,1,0,50,0,-50
6238,1,0,47,0,-47
6239,0,0,15,0,-15
6240,0,0,76,0,-76
6241,1,0,24,0,-24
6242,0,0,79,0,-79
6243,1,0,167,0,-167
6244,1,0,13,0,-13
6245,1,1,255,1483,1228
6246,1,0,4,0,-4
6247,1,0,75,0,-75
6248,1,0,72,0,-72
6249,0,0,26,0,-26
6250,1,0,70,0,-70
6251,1,1,382,1305,923
6252,0,0,22,0,-22
6253,0,0,20,0,-20
6254,1,1,210,1289,1079
6255,1,0,39,0,-39
6256,0,0,11,0,-11
6257,1,1,509,1771,1262
6258,0,0,102,0,-102
6259,1,1,641,1598,957
6260,1,1,420,1213,793
6261,0,0,69,0,-69
6262,0,0,88,0,-88
6263,1,0,4,0,-4
6264,1,1,1604,1220,-384
6265,1,0,8,0,-8
6266,1,0,3,0,-3
6267,0,0,7,0,-7
6268,0,0,44,0,-44
6269,0,0,11,0,-11
6270,0,0,51,0,-51
6271,0,0,33,0,-33
6272,1,0,19,0,-19
6273,0,0,76,0,-76
6274,1,0,91,0,-91
6275,1,0,21,0,-21
6276,0,0,6,0,-6
6277,0,0,19,0,-19
6278,1,1,489,1635,1146
6279,0,0,32,0,-32
6280,1,1,147,1208,1061
6281,1,0,45,0,-45
6282,0,0,110,0,-110
6283,0,0,43,0,-43
6284,1,1,298,1334,1036
6285,0,0,215,0,-215
6286,1,0,18,0,-18
6287,0,0,24,0,-24
6288,0,0,14,0,-14
6289,1,1,274,1933,1659
6290,1,1,242,2306,2064
6291,0,0,32,0,-32
6292,0,0,71,0,-71
6293,0,0,55,0,-55
6294,1,0,147,0,-147
6295,1,1,1152,1304,152
6296,1,1,181,1277,1096
6297,0,0,78,0,-78
6298,0,0,73,0,-73
6299,0,0,20,0,-20
6300,1,1,641,1341,700
6301,1,0,53,0,-53
6302,1,1,292,1653,1361
6303,1,1,206,3080,2874
6304,0,0,6,0,-6
6305,1,0,21,0,-21
6306,0,0,14,0,-14
6307,0,0,20,0,-20
6308,1,0,42,0,-42
6309,1,1,236,1973,1737
6310,0,0,75,0,-75
6311,1,1,248,1516,1268
6312,1,1,236,1411,1175
6313,0,0,53,0,-53
6314,0,0,133,0,-133
6315,1,1,568,1733,1165
6316,1,0,86,0,-86
6317,1,0,3,0,-3
6318,1,0,4,0,-4
6319,0,0,46,0,-46
6320,0,0,25,0,-25
6321,0,0,96,0,-96
6322,0,0,13,0,-13
6323,1,0,10,0,-10
6324,1,0,70,0,-70
6325,1,1,375,1661,1286
6326,0,0,94,0,-94
6327,0,0,45,0,-45
6328,1,0,4,0,-4
6329,1,1,374,1663,1289
6330,0,0,98,0,-98
6331,1,0,147,0,-147
6332,0,0,81,0,-81
6333,0,0,55,0,-55
6334,1,0,42,0,-42
6335,1,0,21,0,-21
6336,0,0,116,0,-116
6337,0,0,108,0,-108
6338,0,0,60,0,-60
6339,1,1,308,1276,968
6340,1,1,213,1273,1060
6341,1,0,147,0,-147
6342,0,0,49,0,-49
6343,1,1,296,1353,1057
6344,1,0,85,0,-85
6345,1,0,14,0,-14
6346,1,1,1540,1682,142
6347,0,0,18,0,-18
6348,1,1,156,1286,1130
6349,0,0,79,0,-79
6350,1,1,1437,1277,-160
6351,1,1,807,2234,1427
6352,0,0,45,0,-45
6353,1,0,10,0,-10
6354,0,0,65,0,-65
6355,1,0,10,0,-10
6356,0,0,42,0,-42
6357,0,0,16,0,-16
6358,1,1,372,1247,875
6359,1,1,191,1581,1390
6360,0,0,57,0,-57
6361,0,0,1,0,-1
6362,1,1,634,1204,570
6363,0,0,37,0,-37
6364,1,1,375,1449,1074
6365,1,0,104,0,-104
6366,0,0,56,0,-56
6367,0,0,34,0,-34
6368,1,0,93,0,-93
6369,0,0,83,0,-83
6370,1,0,168,0,-168
6371,0,0,16,0,-16
6372,1,0,0,0,0
6373,0,0,1,0,-1
6374,0,0,3,0,-3
6375,1,0,17,0,-17
6376,1,1,670,1371,701
6377,1,0,122,0,-122
6378,1,0,5,0,-5
6379,1,1,470,1291,821
6380,1,0,7,0,-7
6381,1,0,31,0,-31
6382,1,1,404,1349,945
6383,0,0,39,0,-39
6384,1,1,285,1306,1021
6385,1,1,1726,1700,-26
6386,0,0,122,0,-122
6387,1,0,57,0,-57
6388,1,0,13,0,-13
6389,0,0,55,0,-55
6390,0,0,255,0,-255
6391,1,1,629,1281,652
6392,1,0,126,0,-126
6393,1,1,1906,1430,-476
6394,1,0,2,0,-2
6395,1,0,118,0,-118
6396,1,0,17,0,-17
6397,0,0,47,0,-47
6398,1,1,618,1343,725
6399,0,0,43,0,-43
6400,0,0,16,0,-16
6401,1,1,316,1436,1120
6402,1,0,271,0,-271
6403,1,1,216,1275,1059
6404,1,1,865,1355,490
6405,1,0,60,0,-60
6406,1,0,120,0,-120
6407,1,1,63,2092,2029
6408,1,0,63,0,-63
6409,0,0,1,0,-1
6410,1,0,9,0,-9
6411,1,0,51,0,-51
6412,1,1,29,1253,1224
6413,1,1,674,1244,570
6414,1,0,73,0,-73
6415,0,0,74,0,-74
6416,0,0,39,0,-39
6417,1,0,2,0,-2
6418,1,1,271,1224,953
6419,1,0,43,0,-43
6420,0,0,4,0,-4
6421,0,0,132,0,-132
6422,1,0,10,0,-10
6423,1,0,25,0,-25
6424,1,0,8,0,-8
6425,1,0,87,0,-87
6426,1,0,6,0,-6
6427,0,0,70,0,-70
6428,0,0,28,0,-28
6429,1,0,55,0,-55
6430,1,0,66,0,-66
6431,1,1,175,2255,2080
6432,1,0,90,0,-90
6433,0,0,74,0,-74
6434,1,1,75,2694,2619
6435,0,0,54,0,-54
6436,0,0,13,0,-13
6437,1,0,5,0,-5
6438,0,0,65,0,-65
6439,1,0,184,0,-184
6440,1,1,963,1318,355
6441,0,0,93,0,-93
6442,1,0,77,0,-77
6443,0,0,11,0,-11
6444,1,0,2,0,-2
6445,0,0,50,0,-50
6446,1,1,76,2098,2022
6447,1,0,52,0,-52
6448,1,0,5,0,-5
6449,1,0,144,0,-144
6450,0,0,20,0,-20
6451,0,0,5,0,-5
6452,1,0,15,0,-15
6453,0,0,14,0,-14
6454,0,0,15,0,-15
6455,0,0,28,0,-28
6456,1,1,332,1515,1183
6457,1,0,2,0,-2
6458,0,0,3,0,-3
6459,0,0,32,0,-32
6460,1,1,1732,3921,2189
6461,1,0,55,0,-55
6462,0,0,110,0,-110
6463,1,0,28,0,-28
6464,1,1,165,1230,1065
6465,1,0,94,0,-94
6466,0,0,24,0,-24
6467,1,1,1152,1478,326
6468,0,0,101,0,-101
6469,1,0,69,0,-69
6470,0,0,93,0,-93
6471,1,0,7,0,-7
6472,1,1,92,1666,1574
6473,1,1,457,1403,946
6474,1,1,1558,1412,-146
6475,1,0,4,0,-4
6476,0,0,10,0,-10
6477,1,0,22,0,-22
6478,1,0,53,0,-53
6479,0,0,41,0,-41
6480,1,0,6,0,-6
6481,1,0,6,0,-6
6482,1,0,9,0,-9
6483,0,0,5,0,-5
6484,0,0,20,0,-20
6485,1,1,65,1258,1193
6486,0,0,264,0,-264
6487,0,0,57,0,-57
6488,1,0,153,0,-153
6489,0,0,0,0,0
6490,0,0,56,0,-56
6491,1,0,6,0,-6
6492,0,0,45,0,-45
6493,0,0,153,0,-153
6494,0,0,84,0,-84
6495,1,0,48,0,-48
6496,0,0,16,0,-16
6497,1,0,43,0,-43
6498,1,0,41,0,-41
6499,0,0,83,0,-83
6500,1,0,33,0,-33
6501,0,0,8,0,-8
6502,0,0,14,0,-14
6503,1,0,30,0,-30
6504,1,1,127,1282,1155
6505,1,0,16,0,-16
6506,1,0,64,0,-64
6507,1,1,158,1324,1166
6508,0,0,56,0,-56
6509,1,0,29,0,-29
6510,1,0,27,0,-27
6511,0,0,6,0,-6
6512,0,0,71,0,-71
6513,1,0,14,0,-14
6514,1,0,27,0,-27
6515,0,0,2,0,-2
6516,1,0,77,0,-77
6517,1,1,427,1331,904
6518,0,0,19,0,-19
6519,1,1,118,2379,2261
6520,0,0,38,0,-38
6521,0,0,42,0,-42
6522,1,1,177,1222,1045
6523,1,0,33,0,-33
6524,1,0,124,0,-124
6525,1,1,92,1204,1112
6526,1,1,264,1371,1107
6527,1,0,27,0,-27
6528,1,1,405,1449,1044
6529,0,0,24,0,-24
6530,1,1,105,1486,1381
6531,1,0,0,0,0
6532,0,0,74,0,-74
6533,1,1,373,1303,930
6534,1,0,99,0,-99
6535,1,0,188,0,-188
6536,1,1,335,1370,1035
6537,1,0,24,0,-24
6538,0,0,0,0,0
6539,0,0,24,0,-24
6540,1,0,61,0,-61
6541,1,0,13,0,-13
6542,0,0,121,0,-121
6543,0,0,13,0,-13
6544,0,0,11,0,-11
6545,1,1,190,1615,1425
6546,1,0,11,0,-11
6547,0,0,14,0,-14
6548,0,0,24,0,-24
6549,1,0,123,0,-123
6550,1,1,320,1320,1000
6551,1,1,978,1238,260
6552,1,0,4,0,-4
6553,1,0,120,0,-120
6554,0,0,2,0,-2
6555,0,0,55,0,-55
6556,1,1,36,1344,1308
6557,1,0,286,0,-286
6558,0,0,3,0,-3
6559,0,0,2,0,-2
6560,1,0,32,0,-32
6561,0,0,57,0,-57
6562,0,0,5,0,-5
6563,1,0,38,0,-38
6564,1,0,85,0,-85
6565,0,0,90,0,-90
6566,1,1,1557,1254,-303
6567,0,0,20,0,-20
6568,0,0,29,0,-29
6569,1,0,106,0,-106
6570,0,0,87,0,-87
6571,0,0,105,0,-105
6572,0,0,9,0,-9
6573,0,0,17,0,-17
6574,1,1,367,1743,1376
6575,1,1,36,1446,1410
6576,1,0,72,0,-72
6577,1,1,829,1236,407
6578,1,1,45,3846,3801
6579,1,0,0,0,0
6580,0,0,0,0,0
6581,1,1,702,1447,745
6582,1,1,413,1713,1300
6583,0,0,19,0,-19
6584,1,0,87,0,-87
6585,0,0,5,0,-5
6586,0,0,3,0,-3
6587,1,0,51,0,-51
6588,1,1,635,1344,709
6589,0,0,66,0,-66
6590,0,0,88,0,-88
6591,0,0,22,0,-22
6592,0,0,12,0,-12
6593,1,0,23,0,-23
6594,1,1,727,1355,628
6595,1,1,190,1216,1026
6596,1,1,557,1316,759
6597,1,1,292,1323,1031
6598,1,0,0,0,0
6599,1,1,1256,2628,1372
6600,0,0,20,0,-20
6601,1,1,1417,1598,181
6602,1,0,28,0,-28
6603,0,0,37,0,-37
6604,0,0,37,0,-37
6605,1,0,44,0,-44
6606,0,0,48,0,-48
6607,0,0,19,0,-19
6608,0,0,80,0,-80
6609,1,0,74,0,-74
6610,1,0,7,0,-7
6611,1,1,878,1586,708
6612,0,0,41,0,-41
6613,1,1,238,2163,1925
6614,0,0,5,0,-5
6615,1,0,25,0,-25
6616,1,1,258,1437,1179
6617,0,0,38,0,-38
6618,0,0,22,0,-22
6619,1,1,388,2486,2098
6620,1,0,173,0,-173
6621,0,0,181,0,-181
6622,1,0,9,0,-9
6623,0,0,18,0,-18
6624,1,0,14,0,-14
6625,1,1,450,1223,773
6626,0,0,41,0,-41
6627,1,0,102,0,-102
6628,1,1,1109,1319,210
6629,1,0,74,0,-74
6630,0,0,327,0,-327
6631,0,0,29,0,-29
6632,1,1,271,1908,1637
6633,0,0,25,0,-25
6634,1,1,392,1300,908
6635,1,0,67,0,-67
6636,1,1,136,1486,1350
6637,1,1,103,1307,1204
6638,1,0,32,0,-32
6639,1,0,6,0,-6
6640,1,1,1108,2398,1290
6641,0,0,67,0,-67
6642,0,0,39,0,-39
6643,0,0,3,0,-3
6644,1,1,218,1280,1062
6645,0,0,24,0,-24
6646,0,0,93,0,-93
6647,0,0,50,0,-50
6648,1,0,47,0,-47
6649,1,1,98,1271,1173
6650,1,0,4,0,-4
6651,0,0,29,0,-29
6652,0,0,17,0,-17
6653,1,0,19,0,-19
6654,1,1,1136,3338,2202
6655,0,0,9,0,-9
6656,1,0,17,0,-17
6657,0,0,25,0,-25
6658,1,0,38,0,-38
6659,0,0,26,0,-26
6660,1,0,81,0,-81
6661,1,1,51,1397,1346
6662,0,0,23,0,-23
6663,0,0,139,0,-139
6664,0,0,17,0,-17
6665,1,0,45,0,-45
6666,0,0,110,0,-110
6667,0,0,24,0,-24
6668,0,0,13,0,-13
6669,1,0,23,0,-23
6670,1,0,70,0,-70
6671,1,0,22,0,-22
6672,1,0,14,0,-14
6673,0,0,18,0,-18
6674,1,0,34,0,-34
6675,1,0,8,0,-8
6676,0,0,6,0,-6
6677,0,0,100,0,-100
6678,1,1,471,2406,1935
6679,0,0,15,0,-15
6680,1,1,197,1464,1267
6681,1,0,9,0,-9
6682,0,0,2,0,-2
6683,1,0,75,0,-75
6684,0,0,37,0,-37
6685,1,0,12,0,-12
6686,1,1,365,1228,863
6687,0,0,129,0,-129
6688,1,0,99,0,-99
6689,0,0,34,0,-34
6690,1,1,160,1508,1348
6691,0,0,27,0,-27
6692,0,0,10,0,-10
6693,1,0,66,0,-66
6694,0,0,14,0,-14
6695,0,0,48,0,-48
6696,1,1,996,1810,814
6697,1,1,23,1367,1344
6698,1,1,274,1319,1045
6699,1,0,186,0,-186
6700,1,1,1239,2676,1437
6701,1,1,321,2021,1700
6702,0,0,31,0,-31
6703,0,0,32,0,-32
6704,1,1,107,1499,1392
6705,1,1,892,1276,384
6706,0,0,68,0,-68
6707,1,1,672,1257,585
6708,1,0,24,0,-24
6709,1,0,14,0,-14
6710,0,0,9,0,-9
6711,1,1,897,1392,495
6712,1,0,24,0,-24
6713,1,1,260,1339,1079
6714,0,0,255,0,-255
6715,0,0,7,0,-7
6716,1,1,900,1272,372
6717,1,0,11,0,-11
6718,0,0,8,0,-8
6719,1,0,67,0,-67
6720,1,0,179,0,-179
6721,0,0,60,0,-60
6722,1,1,433,1707,1274
6723,0,0,47,0,-47
6724,1,0,14,0,-14
6725,1,0,77,0,-77
6726,1,1,329,1424,1095
6727,0,0,102,0,-102
6728,0,0,35,0,-35
6729,0,0,291,0,-291
6730,1,1,1181,1530,349
6731,1,0,7,0,-7
6732,1,1,524,2066,1542
6733,1,1,1272,1205,-67
6734,1,1,485,1650,1165
6735,1,1,251,1450,1199
6736,1,0,38,0,-38
6737,0,0,77,0,-77
6738,1,0,72,0,-72
6739,1,0,117,0,-117
6740,0,0,17,0,-17
6741,1,1,291,1613,1322
6742,1,1,156,2011,1855
6743,1,0,66,0,-66
6744,1,1,738,1350,612
6745,0,0,111,0,-111
6746,1,1,122,1685,1563
6747,1,1,536,1487,951
6748,1,1,83,1373,1290
6749,1,1,414,1870,1456
6750,1,0,0,0,0
6751,0,0,19,0,-19
6752,0,0,12,0,-12
6753,0,0,26,0,-26
6754,1,0,96,0,-96
6755,0,0,3,0,-3
6756,0,0,39,0,-39
6757,1,1,61,1472,1411
6758,0,0,3,0,-3
6759,0,0,231,0,-231
6760,1,0,7,0,-7
6761,0,0,54,0,-54
6762,0,0,50,0,-50
6763,1,1,270,1833,1563
6764,0,0,146,0,-146
6765,1,0,35,0,-35
6766,0,0,86,0,-86
6767,1,0,5,0,-5
6768,0,0,28,0,-28
6769,1,0,28,0,-28
6770,0,0,34,0,-34
6771,0,0,72,0,-72
6772,0,0,37,0,-37
6773,0,0,82,0,-82
6774,1,0,18,0,-18
6775,0,0,80,0,-80
6776,1,1,260,1349,1089
6777,1,0,146,0,-146
6778,1,1,216,1634,1418
6779,0,0,80,0,-80
6780,0,0,20,0,-20
6781,0,0,12,0,-12
6782,1,1,1067,1991,924
6783,1,1,105,1228,1123
6784,1,0,32,0,-32
6785,1,1,208,4096,3888
6786,0,0,13,0,-13
6787,1,0,23,0,-23
6788,0,0,48,0,-48
6789,0,0,10,0,-10
6790,0,0,7,0,-7
6791,1,1,678,2950,2272
6792,1,0,42,0,-42
6793,1,1,477,2647,2170
6794,1,0,51,0,-51
6795,1,0,4,0,-4
6796,0,0,61,0,-61
6797,1,0,25,0,-25
6798,1,0,13,0,-13
6799,1,0,46,0,-46
6800,1,0,8,0,-8
6801,0,0,25,0,-25
6802,1,0,0,0,0
6803,0,0,22,0,-22
6804,1,1,65,1379,1314
6805,1,0,22,0,-22
6806,0,0,13,0,-13
6807,0,0,56,0,-56
6808,1,0,25,0,-25
6809,0,0,57,0,-57
6810,1,1,1316,1456,140
6811,1,1,1069,1554,485
6812,1,0,98,0,-98
6813,1,1,1956,1511,-445
6814,1,0,9,0,-9
6815,1,1,717,1216,499
6816,1,0,150,0,-150
6817,0,0,8,0,-8
6818,1,0,13,0,-13
6819,1,1,401,1770,1369
6820,1,0,15,0,-15
6821,1,1,138,1236,1098
6822,1,0,22,0,-22
6823,0,0,84,0,-84
6824,0,0,71,0,-71
6825,1,1,198,1411,1213
6826,1,1,97,1214,1117
6827,0,0,46,0,-46
6828,1,1,296,1376,1080
6829,0,0,16,0,-16
6830,1,1,676,1243,567
6831,1,0,118,0,-118
6832,1,0,10,0,-10
6833,1,0,0,0,0
6834,1,1,770,1259,489
6835,0,0,63,0,-63
6836,0,0,46,0,-46
6837,0,0,1,0,-1
6838,1,1,145,2836,2691
6839,1,0,16,0,-16
6840,1,0,132,0,-132
6841,1,0,7,0,-7
6842,1,0,2,0,-2
6843,1,1,963,1390,427
6844,0,0,204,0,-204
6845,1,1,47,1235,1188
6846,1,0,6,0,-6
6847,1,1,384,1231,847
6848,1,0,62,0,-62
6849,0,0,10,0,-10
6850,0,0,39,0,-39
6851,1,0,2,0,-2
6852,1,1,288,3004,2716
6853,1,1,130,1922,1792
6854,1,0,21,0,-21
6855,0,0,95,0,-95
6856,0,0,45,0,-45
6857,0,0,31,0,-31
6858,0,0,2,0,-2
6859,1,0,106,0,-106
6860,1,1,110,2882,2772
6861,1,0,10,0,-10
6862,1,0,45,0,-45
6863,0,0,37,0,-37
6864,1,0,45,0,-45
6865,0,0,32,0,-32
6866,1,0,8,0,-8
6867,1,1,720,1255,535
6868,1,0,28,0,-28
6869,1,1,217,1966,1749
6870,0,0,2,0,-2
6871,0,0,57,0,-57
6872,0,0,84,0,-84
6873,1,0,133,0,-133
6874,0,0,120,0,-120
6875,1,0,17,0,-17
6876,0,0,8,0,-8
6877,1,1,372,1663,1291
6878,1,1,400,1454,1054
6879,1,0,17,0,-17
6880,0,0,66,0,-66
6881,0,0,46,0,-46
6882,1,0,50,0,-50
6883,0,0,34,0,-34
6884,0,0,11,0,-11
6885,1,0,40,0,-40
6886,1,1,223,1296,1073
6887,0,0,19,0,-19
6888,0,0,24,0,-24
6889,0,0,33,0,-33
6890,1,1,538,1381,843
6891,0,0,8,0,-8
6892,0,0,52,0,-52
6893,1,0,8,0,-8
6894,0,0,75,0,-75
6895,1,0,90,0,-90
6896,0,0,22,0,-22
6897,1,0,59,0,-59
6898,0,0,10,0,-10
6899,0,0,24,0,-24
6900,1,0,12,0,-12
6901,1,0,138,0,-138
6902,0,0,69,0,-69
6903,0,0,20,0,-20
6904,1,1,358,2455,2097
6905,1,0,7,0,-7
6906,1,0,70,0,-70
6907,1,1,15,1202,1187
6908,1,0,101,0,-101
6909,1,0,37,0,-37
6910,0,0,108,0,-108
6911,0,0,91,0,-91
6912,1,0,284,0,-284
6913,1,1,791,1375,584
6914,1,1,389,1349,960
6915,1,0,70,0,-70
6916,1,1,1161,1267,106
6917,0,0,108,0,-108
6918,1,1,1172,1336,164
6919,0,0,4,0,-4
6920,0,0,138,0,-138
6921,0,0,5,0,-5
6922,0,0,37,0,-37
6923,1,1,243,3290,3047
6924,0,0,24,0,-24
6925,0,0,131,0,-131
6926,0,0,11,0,-11
6927,0,0,56,0,-56
6928,0,0,49,0,-49
6929,1,1,848,1430,582
6930,1,0,71,0,-71
6931,0,0,21,0,-21
6932,1,1,579,1396,817
6933,0,0,8,0,-8
6934,1,0,11,0,-11
6935,0,0,42,0,-42
6936,1,1,81,1749,1668
6937,0,0,49,0,-49
6938,1,0,10,0,-10
6939,1,1,1071,1576,505
6940,0,0,30,0,-30
6941,0,0,58,0,-58
6942,0,0,13,0,-13
6943,1,0,19,0,-19
6944,0,0,8,0,-8
6945,1,0,90,0,-90
6946,1,0,2,0,-2
6947,1,1,1224,1281,57
6948,0,0,16,0,-16
6949,0,0,11,0,-11
6950,1,0,48,0,-48
6951,1,0,21,0,-21
6952,0,0,20,0,-20
6953,0,0,83,0,-83
6954,0,0,4,0,-4
6955,0,0,9,0,-9
6956,1,0,39,0,-39
6957,1,1,442,1992,1550
6958,0,0,4,0,-4
6959,1,0,44,0,-44
6960,0,0,1,0,-1
6961,0,0,18,0,-18
6962,1,0,8,0,-8
6963,0,0,98,0,-98
6964,1,0,2,0,-2
6965,1,1,49,1217,1168
6966,0,0,11,0,-11
6967,0,0,144,0,-144
6968,1,0,53,0,-53
6969,1,1,572,1443,871
6970,0,0,134,0,-134
6971,1,0,8,0,-8
6972,0,0,73,0,-73
6973,1,0,19,0,-19
6974,0,0,9,0,-9
6975,0,0,44,0,-44
6976,1,0,7,0,-7
6977,1,0,8,0,-8
6978,1,1,618,1520,902
6979,1,1,257,4704,4447
6980,1,1,1045,1467,422
6981,1,0,9,0,-9
6982,1,0,34,0,-34
6983,0,0,150,0,-150
6984,0,0,88,0,-88
6985,1,1,147,1678,1531
6986,0,0,57,0,-57
6987,1,1,641,1842,1201
6988,1,1,63,1475,1412
6989,1,0,83,0,-83
6990,1,1,373,1445,1072
6991,0,0,18,0,-18
6992,0,0,11,0,-11
6993,1,0,40,0,-40
6994,0,0,6,0,-6
6995,0,0,6,0,-6
6996,1,1,475,1756,1281
6997,1,1,690,1374,684
6998,0,0,51,0,-51
6999,0,0,34,0,-34
7000,0,0,5,0,-5
7001,1,0,17,0,-17
7002,1,1,280,1336,1056
7003,1,1,481,1466,985
7004,1,0,19,0,-19
7005,1,0,133,0,-133
7006,1,1,113,1510,1397
7007,1,1,883,1228,345
7008,1,0,4,0,-4
7009,1,1,310,1429,1119
7010,1,0,18,0,-18
7011,1,0,24,0,-24
7012,1,0,10,0,-10
7013,1,0,5,0,-5
7014,0,0,11,0,-11
7015,0,0,68,0,-68
7016,1,1,273,1503,1230
7017,1,1,158,1235,1077
7018,1,0,41,0,-41
7019,0,0,19,0,-19
7020,1,0,34,0,-34
7021,1,0,295,0,-295
7022,1,0,55,0,-55
7023,0,0,0,0,0
7024,0,0,38,0,-38
7025,1,0,78,0,-78
7026,0,0,36,0,-36
7027,1,1,572,1212,640
7028,0,0,63,0,-63
7029,1,0,34,0,-34
7030,0,0,12,0,-12
7031,0,0,26,0,-26
7032,1,0,69,0,-69
7033,1,1,65,1207,1142
7034,1,0,52,0,-52
7035,1,0,47,0,-47
7036,0,0,178,0,-178
7037,1,1,699,2100,1401
7038,0,0,6,0,-6
7039,0,0,11,0,-11
7040,1,0,47,0,-47
7041,1,0,54,0,-54
7042,1,1,150,1372,1222
7043,1,0,49,0,-49
7044,0,0,10,0,-10
7045,0,0,62,0,-62
7046,1,0,52,0,-52
7047,1,1,546,1373,827
7048,0,0,25,0,-25
7049,1,0,49,0,-49
7050,1,1,213,1383,1170
7051,1,1,224,1253,1029
7052,0,0,25,0,-25
7053,1,0,11,0,-11
7054,1,0,23,0,-23
7055,1,0,23,0,-23
7056,1,0,7,0,-7
7057,0,0,5,0,-5
7058,0,0,1,0,-1
7059,0,0,40,0,-40
7060,0,0,86,0,-86
7061,0,0,45,0,-45
7062,1,1,439,1206,767
7063,1,0,32,0,-32
7064,1,1,1150,1983,833
7065,1,1,212,1336,1124
7066,1,0,13,0,-13
7067,1,1,640,2493,1853
7068,1,1,94,1343,1249
7069,0,0,27,0,-27
7070,1,0,120,0,-120
7071,1,0,78,0,-78
7072,0,0,91,0,-91
7073,1,0,22,0,-22
7074,1,0,60,0,-60
7075,1,1,243,1289,1046
7076,0,0,20,0,-20
7077,0,0,33,0,-33
7078,1,1,248,1589,1341
7079,0,0,45,0,-45
7080,1,0,23,0,-23
7081,0,0,143,0,-143
7082,0,0,27,0,-27
7083,1,1,136,1522,1386
7084,1,1,499,1761,1262
7085,0,0,107,0,-107
7086,0,0,6,0,-6
7087,0,0,159,0,-159
7088,1,0,15,0,-15
7089,0,0,129,0,-129
7090,0,0,8,0,-8
7091,1,1,391,1247,856
7092,0,0,5,0,-5
7093,0,0,170,0,-170
7094,0,0,6,0,-6
7095,1,1,194,1378,1184
7096,1,1,57,2511,2454
7097,0,0,15,0,-15
7098,0,0,31,0,-31
7099,1,1,303,2387,2084
7100,1,0,29,0,-29
7101,0,0,32,0,-32
7102,1,1,1300,1667,367
7103,1,1,393,1325,932
7104,1,1,1322,1241,-81
7105,1,0,28,0,-28
7106,1,1,94,1234,1140
7107,0,0,37,0,-37
7108,1,0,3,0,-3
7109,0,0,87,0,-87
7110,0,0,75,0,-75
7111,1,0,20,0,-20
7112,1,1,295,1271,976
7113,0,0,91,0,-91
7114,1,1,1564,1418,-146
7115,0,0,56,0,-56
7116,0,0,0,0,0
7117,1,1,324,2482,2158
7118,1,0,26,0,-26
7119,1,1,724,1584,860
7120,0,0,21,0,-21
7121,0,0,138,0,-138
7122,1,1,260,1360,1100
7123,1,1,90,1258,1168
7124,1,1,447,1368,921
7125,1,0,4,0,-4
7126,0,0,76,0,-76
7127,0,0,224,0,-224
7128,0,0,24,0,-24
7129,0,0,36,0,-36
7130,1,1,107,1465,1358
7131,1,1,1240,1580,340
7132,0,0,6,0,-6
7133,0,0,105,0,-105
7134,0,0,93,0,-93
7135,0,0,22,0,-22
7136,0,0,13,0,-13
7137,1,1,774,1412,638
7138,0,0,4,0,-4
7139,0,0,136,0,-136
7140,0,0,14,0,-14
7141,0,0,74,0,-74
7142,1,1,116,2087,1971
7143,1,0,8,0,-8
7144,0,0,55,0,-55
7145,0,0,76,0,-76
7146,1,1,2462,1496,-966
7147,1,1,222,2968,2746
7148,1,0,80,0,-80
7149,0,0,47,0,-47
7150,0,0,89,0,-89
7151,0,0,22,0,-22
7152,1,0,57,0,-57
7153,1,0,120,0,-120
7154,1,0,29,0,-29
7155,1,0,0,0,0
7156,1,0,8,0,-8
7157,1,1,1123,1723,600
7158,1,1,3032,1525,-1507
7159,0,0,60,0,-60
7160,1,1,139,1621,1482
7161,0,0,60,0,-60
7162,0,0,329,0,-329
7163,0,0,19,0,-19
7164,1,1,121,3153,3032
7165,1,1,548,1368,820
7166,1,1,735,1517,782
7167,0,0,17,0,-17
7168,1,1,368,1399,1031
7169,0,0,184,0,-184
7170,1,0,10,0,-10
7171,1,0,75,0,-75
7172,1,0,14,0,-14
7173,1,1,214,1235,1021
7174,1,1,145,1448,1303
7175,0,0,7,0,-7
7176,0,0,40,0,-40
7177,1,1,1038,1247,209
7178,0,0,10,0,-10
7179,1,1,916,1396,480
7180,0,0,69,0,-69
7181,1,1,254,1385,1131
7182,1,1,331,1302,971
7183,1,1,831,1373,542
7184,1,0,106,0,-106
7185,1,0,68,0,-68
7186,1,0,5,0,-5
7187,1,0,10,0,-10
7188,0,0,66,0,-66
7189,0,0,8,0,-8
7190,1,0,42,0,-42
7191,1,0,14,0,-14
7192,1,0,51,0,-51
7193,0,0,8,0,-8
7194,1,0,7,0,-7
7195,1,1,173,1386,1213
7196,0,0,108,0,-108
7197,0,0,19,0,-19
7198,1,0,11,0,-11
7199,1,0,35,0,-35
7200,0,0,32,0,-32
7201,0,0,56,0,-56
7202,0,0,17,0,-17
7203,0,0,14,0,-14
7204,1,1,107,1779,1672
7205,0,0,51,0,-51
7206,1,0,6,0,-6
7207,0,0,144,0,-144
7208,1,1,328,1454,1126
7209,0,0,7,0,-7
7210,0,0,144,0,-144
7211,0,0,57,0,-57
7212,1,0,67,0,-67
7213,0,0,5,0,-5
7214,1,0,21,0,-21
7215,1,1,550,1320,770
7216,1,1,618,1554,936
7217,0,0,25,0,-25
7218,1,0,22,0,-22
7219,1,1,766,1660,894
7220,1,0,45,0,-45
7221,1,0,11,0,-11
7222,1,1,1109,1417,308
7223,1,1,1519,1678,159
7224,0,0,44,0,-44
7225,1,0,45,0,-45
7226,0,0,96,0,-96
7227,0,0,51,0,-51
7228,0,0,19,0,-19
7229,1,0,7,0,-7
7230,1,1,70,1322,1252
7231,1,0,162,0,-162
7232,1,0,74,0,-74
7233,0,0,83,0,-83
7234,1,1,157,1350,1193
7235,1,0,3,0,-3
7236,1,1,646,1491,845
7237,1,1,581,1409,828
7238,0,0,93,0,-93
7239,1,0,40,0,-40
7240,1,0,8,0,-8
7241,0,0,168,0,-168
7242,1,1,220,1237,1017
7243,0,0,37,0,-37
7244,1,0,158,0,-158
7245,0,0,43,0,-43
7246,1,0,69,0,-69
7247,1,0,143,0,-143
7248,1,0,0,0,0
7249,1,0,5,0,-5
7250,0,0,16,0,-16
7251,0,0,339,0,-339
7252,0,0,85,0,-85
7253,0,0,54,0,-54
7254,1,0,80,0,-80
7255,0,0,66,0,-66
7256,1,1,329,1533,1204
7257,1,1,1473,1256,-217
7258,1,1,197,1331,1134
7259,1,0,15,0,-15
7260,1,0,86,0,-86
7261,1,1,758,1936,1178
7262,1,1,1174,2323,1149
7263,0,0,7,0,-7
7264,1,0,19,0,-19
7265,1,1,1972,1254,-718
7266,0,0,54,0,-54
7267,0,0,25,0,-25
7268,0,0,15,0,-15
7269,1,1,798,1610,812
7270,1,1,450,1425,975
7271,0,0,60,0,-60
7272,1,0,22,0,-22
7273,1,0,23,0,-23
7274,0,0,164,0,-164
7275,1,0,15,0,-15
7276,0,0,45,0,-45
7277,1,1,2220,2243,23
7278,0,0,21,0,-21
7279,0,0,32,0,-32
7280,1,0,65,0,-65
7281,1,0,48,0,-48
7282,0,0,38,0,-38
7283,1,1,30,1482,1452
7284,1,1,882,1705,823
7285,1,1,829,1665,836
7286,1,1,534,1289,755
7287,1,0,279,0,-279
7288,0,0,70,0,-70
7289,0,0,26,0,-26
7290,0,0,134,0,-134
7291,1,1,246,1271,1025
7292,0,0,158,0,-158
7293,1,0,138,0,-138
7294,1,1,774,1512,738
7295,1,1,353,1642,1289
7296,1,1,90,1257,1167
7297,1,1,297,1224,927
7298,0,0,175,0,-175
7299,1,0,171,0,-171
7300,1,0,47,0,-47
7301,1,1,391,1876,1485
7302,1,0,27,0,-27
7303,0,0,7,0,-7
7304,0,0,167,0,-167
7305,1,1,157,1680,1523
7306,1,1,732,1976,1244
7307,0,0,55,0,-55
7308,0,0,34,0,-34
7309,1,0,47,0,-47
7310,1,1,534,1415,881
7311,1,1,1069,1230,161
7312,1,1,746,1205,459
7313,1,1,466,1592,1126
7314,0,0,5,0,-5
7315,0,0,65,0,-65
7316,1,0,29,0,-29
7317,0,0,101,0,-101
7318,0,0,55,0,-55
7319,1,1,61,1217,1156
7320,0,0,3,0,-3
7321,1,1,543,1200,657
7322,0,0,63,0,-63
7323,0,0,0,0,0
7324,1,1,1089,1317,228
7325,0,0,59,0,-59
7326,1,0,110,0,-110
7327,0,0,46,0,-46
7328,0,0,78,0,-78
7329,1,1,1057,1510,453
7330,0,0,22,0,-22
7331,1,0,4,0,-4
7332,0,0,27,0,-27
7333,1,0,65,0,-65
7334,1,1,44,1314,1270
7335,1,1,554,1325,771
7336,0,0,96,0,-96
7337,0,0,50,0,-50
7338,0,0,5,0,-5
7339,0,0,46,0,-46
7340,1,0,27,0,-27
7341,0,0,118,0,-118
7342,1,0,84,0,-84
7343,0,0,66,0,-66
7344,1,1,269,1556,1287
7345,0,0,17,0,-17
7346,0,0,48,0,-48
7347,1,0,37,0,-37
7348,1,0,21,0,-21
7349,0,0,15,0,-15
7350,1,1,292,1748,1456
7351,0,0,43,0,-43
7352,1,0,68,0,-68
7353,0,0,101,0,-101
7354,1,1,312,1267,955
7355,1,0,3,0,-3
7356,0,0,36,0,-36
7357,0,0,20,0,-20
7358,1,1,102,1430,1328
7359,0,0,11,0,-11
7360,1,0,14,0,-14
7361,1,1,33,1265,1232
7362,0,0,4,0,-4
7363,0,0,3,0,-3
7364,0,0,56,0,-56
7365,0,0,28,0,-28
7366,0,0,64,0,-64
7367,0,0,39,0,-39
7368,1,0,117,0,-117
7369,1,0,153,0,-153
7370,0,0,1,0,-1
7371,1,0,24,0,-24
7372,1,0,61,0,-61
7373,1,0,125,0,-125
7374,1,0,1,0,-1
7375,0,0,14,0,-14
7376,0,0,20,0,-20
7377,0,0,80,0,-80
7378,1,1,483,1382,899
7379,1,0,33,0,-33
7380,0,0,4,0,-4
7381,1,0,50,0,-50
7382,1,1,704,1490,786
7383,0,0,35,0,-35
7384,1,1,594,1737,1143
7385,1,1,181,1227,1046
7386,1,1,1008,2332,1324
7387,0,0,1,0,-1
7388,1,1,321,1321,1000
7389,0,0,68,0,-68
7390,1,0,171,0,-171
7391,1,1,198,2192,1994
7392,1,1,714,1266,552
7393,1,1,1894,1301,-593
7394,0,0,72,0,-72
7395,1,0,8,0,-8
7396,1,0,55,0,-55
7397,0,0,25,0,-25
7398,1,0,16,0,-16
7399,0,0,35,0,-35
7400,1,1,133,1905,1772
7401,0,0,15,0,-15
7402,1,1,86,1282,1196
7403,0,0,68,0,-68
7404,1,0,26,0,-26
7405,1,1,387,1543,1156
7406,1,1,598,1297,699
7407,1,0,26,0,-26
7408,0,0,17,0,-17
7409,0,0,41,0,-41
7410,0,0,4,0,-4
7411,0,0,86,0,-86
7412,1,0,8,0,-8
7413,1,0,63,0,-63
7414,0,0,16,0,-16
7415,1,1,1072,1254,182
7416,1,1,151,1364,1213
7417,1,1,696,1277,581
7418,0,0,1,0,-1
7419,1,1,95,1353,1258
7420,0,0,151,0,-151
7421,1,0,63,0,-63
7422,0,0,134,0,-134
7423,1,1,927,2087,1160
7424,0,0,15,0,-15
7425,1,0,26,0,-26
7426,1,0,16,0,-16
7427,0,0,6,0,-6
7428,1,1,264,1900,1636
7429,0,0,44,0,-44
7430,1,0,18,0,-18
7431,1,1,118,1417,1299
7432,0,0,333,0,-333
7433,0,0,39,0,-39
7434,0,0,1,0,-1
7435,1,0,99,0,-99
7436,1,1,328,2343,2015
7437,0,0,28,0,-28
7438,0,0,135,0,-135
7439,1,0,55,0,-55
7440,1,1,408,1964,1556
7441,0,0,10,0,-10
7442,0,0,7,0,-7
7443,1,1,636,1323,687
7444,0,0,3,0,-3
7445,0,0,104,0,-104
7446,1,0,59,0,-59
7447,1,1,147,1728,1581
7448,1,0,3,0,-3
7449,0,0,79,0,-79
7450,1,1,149,1221,1072
7451,1,1,1291,1267,-24
7452,1,1,652,1243,591
7453,1,1,934,1296,362
7454,0,0,61,0,-61
7455,1,0,54,0,-54
7456,1,0,204,0,-204
7457,0,0,14,0,-14
7458,1,0,0,0,0
7459,0,0,74,0,-74
7460,0,0,8,0,-8
7461,1,0,25,0,-25
7462,0,0,149,0,-149
7463,1,1,859,1237,378
7464,1,1,1037,2778,1741
7465,1,1,1583,1225,-358
7466,0,0,140,0,-140
7467,0,0,8,0,-8
7468,1,1,561,1575,1014
7469,1,0,83,0,-83
7470,1,0,50,0,-50
7471,1,1,439,2220,1781
7472,1,1,452,1977,1525
7473,1,0,2,0,-2
7474,1,0,33,0,-33
7475,0,0,8,0,-8
7476,0,0,2,0,-2
7477,1,1,244,1260,1016
7478,1,0,44,0,-44
7479,0,0,11,0,-11
7480,1,1,288,1237,949
7481,0,0,146,0,-146
7482,0,0,74,0,-74
7483,1,0,21,0,-21
7484,1,1,690,1530,840
7485,1,1,579,1368,789
7486,1,0,50,0,-50
7487,0,0,17,0,-17
7488,1,1,1458,1209,-249
7489,0,0,11,0,-11
7490,0,0,4,0,-4
7491,0,0,75,0,-75
7492,0,0,1,0,-1
7493,1,0,78,0,-78
7494,1,1,1024,1268,244
7495,1,1,765,1223,458
7496,0,0,73,0,-73
7497,1,1,381,1306,925
7498,1,0,7,0,-7
7499,1,1,503,1442,939
7500,1,0,16,0,-16
7501,1,1,135,1261,1126
7502,1,0,37,0,-37
7503,0,0,47,0,-47
7504,0,0,72,0,-72
7505,1,0,25,0,-25
7506,0,0,11,0,-11
7507,0,0,40,0,-40
7508,0,0,5,0,-5
7509,0,0,12,0,-12
7510,1,1,131,2293,2162
7511,0,0,34,0,-34
7512,1,1,1543,1219,-324
7513,0,0,187,0,-187
7514,0,0,8,0,-8
7515,1,0,17,0,-17
7516,0,0,27,0,-27
7517,0,0,133,0,-133
7518,0,0,30,0,-30
7519,1,1,428,1524,1096
7520,0,0,7,0,-7
7521,1,0,33,0,-33
7522,0,0,5,0,-5
7523,0,0,2,0,-2
7524,1,1,1117,1874,757
7525,0,0,6,0,-6
7526,1,1,361,1423,1062
7527,1,0,163,0,-163
7528,0,0,0,0,0
7529,1,0,18,0,-18
7530,1,0,43,0,-43
7531,0,0,132,0,-132
7532,0,0,107,0,-107
7533,1,0,0,0,0
7534,1,1,307,1223,916
7535,0,0,40,0,-40
7536,0,0,53,0,-53
7537,0,0,11,0,-11
7538,1,1,906,1422,516
7539,0,0,103,0,-103
7540,0,0,133,0,-133
7541,0,0,11,0,-11
7542,0,0,29,0,-29
7543,1,1,149,1403,1254
7544,1,0,78,0,-78
7545,0,0,38,0,-38
7546,1,0,33,0,-33
7547,1,1,197,1344,1147
7548,0,0,9,0,-9
7549,1,0,118,0,-118
7550,1,0,6,0,-6
7551,0,0,19,0,-19
7552,1,1,1178,1337,159
7553,1,0,52,0,-52
7554,0,0,71,0,-71
7555,1,0,65,0,-65
7556,1,1,176,2296,2120
7557,1,0,30,0,-30
7558,1,1,243,1238,995
7559,0,0,25,0,-25
7560,0,0,42,0,-42
7561,1,1,40,1758,1718
7562,1,1,545,1282,737
7563,1,1,62,1481,1419
7564,1,1,529,1220,691
7565,1,0,73,0,-73
7566,0,0,35,0,-35
7567,1,1,1378,2991,1613
7568,0,0,12,0,-12
7569,0,0,29,0,-29
7570,0,0,5,0,-5
7571,1,0,8,0,-8
7572,1,1,412,1354,942
7573,0,0,101,0,-101
7574,0,0,109,0,-109
7575,1,0,12,0,-12
7576,1,1,300,1785,1485
7577,1,0,46,0,-46
7578,0,0,72,0,-72
7579,1,1,834,1852,1018
7580,1,1,440,1875,1435
7581,0,0,72,0,-72
7582,0,0,2,0,-2
7583,1,0,38,0,-38
7584,0,0,103,0,-103
7585,1,0,113,0,-113
7586,1,1,987,1319,332
7587,0,0,41,0,-41
7588,0,0,14,0,-14
7589,1,1,239,1248,1009
7590,0,0,17,0,-17
7591,0,0,40,0,-40
7592,1,1,643,1282,639
7593,0,0,133,0,-133
7594,1,1,258,1578,1320
7595,0,0,207,0,-207
7596,1,1,460,2008,1548
7597,0,0,21,0,-21
7598,1,1,72,1456,1384
7599,1,0,28,0,-28
7600,1,1,1076,1627,551
7601,1,1,634,1931,1297
7602,0,0,27,0,-27
7603,1,0,37,0,-37
7604,1,0,49,0,-49
7605,1,1,1411,1550,139
7606,1,0,38,0,-38
7607,1,1,165,1230,1065
7608,1,1,433,1915,1482
7609,1,0,0,0,0
7610,0,0,51,0,-51
7611,1,0,17,0,-17
7612,0,0,23,0,-23
7613,0,0,1,0,-1
7614,0,0,24,0,-24
7615,0,0,47,0,-47
7616,1,0,86,0,-86
7617,0,0,19,0,-19
7618,1,1,396,2006,1610
7619,1,0,76,0,-76
7620,1,0,8,0,-8
7621,0,0,1,0,-1
7622,0,0,3,0,-3
7623,1,0,22,0,-22
7624,1,1,100,1332,1232
7625,0,0,8,0,-8
7626,1,1,120,1259,1139
7627,0,0,118,0,-118
7628,0,0,0,0,0
7629,1,1,99,1570,1471
7630,1,1,379,1376,997
7631,0,0,56,0,-56
7632,1,0,18,0,-18
7633,0,0,119,0,-119
7634,0,0,78,0,-78
7635,1,1,1445,2294,849
7636,1,1,223,1203,980
7637,1,0,286,0,-286
7638,1,0,17,0,-17
7639,1,1,525,1683,1158
7640,1,0,45,0,-45
7641,1,1,290,1736,1446
7642,0,0,18,0,-18
7643,1,1,639,1382,743
7644,1,0,14,0,-14
7645,1,0,77,0,-77
7646,1,1,640,1569,929
7647,0,0,35,0,-35
7648,0,0,24,0,-24
7649,1,0,11,0,-11
7650,1,0,15,0,-15
7651,1,1,339,1720,1381
7652,1,0,34,0,-34
7653,1,0,16,0,-16
7654,1,0,29,0,-29
7655,1,1,1247,1278,31
7656,0,0,16,0,-16
7657,1,1,394,1893,1499
7658,0,0,25,0,-25
7659,1,1,1456,1367,-89
7660,1,1,408,1327,919
7661,1,1,654,1830,1176
7662,1,0,3,0,-3
7663,1,0,102,0,-102
7664,1,1,359,1292,933
7665,0,0,28,0,-28
7666,1,0,48,0,-48
7667,0,0,39,0,-39
7668,0,0,75,0,-75
7669,0,0,54,0,-54
7670,0,0,6,0,-6
7671,0,0,61,0,-61
7672,1,0,53,0,-53
7673,0,0,126,0,-126
7674,0,0,11,0,-11
7675,1,0,75,0,-75
7676,1,1,981,1374,393
7677,0,0,7,0,-7
7678,0,0,19,0,-19
7679,0,0,16,0,-16
7680,1,0,54,0,-54
7681,1,1,277,1792,1515
7682,0,0,27,0,-27
7683,1,0,100,0,-100
7684,1,1,201,1604,1403
7685,0,0,7,0,-7
7686,1,0,37,0,-37
7687,1,1,124,1211,1087
7688,0,0,47,0,-47
7689,1,1,553,1295,742
7690,1,0,63,0,-63
7691,1,1,296,1505,1209
7692,0,0,88,0,-88
7693,1,0,153,0,-153
7694,1,0,28,0,-28
7695,1,1,119,1676,1557
7696,0,0,26,0,-26
7697,0,0,28,0,-28
7698,1,1,303,2125,1822
7699,1,1,148,1862,1714
7700,1,0,24,0,-24
7701,1,0,2,0,-2
7702,1,1,976,3318,2342
7703,0,0,28,0,-28
7704,0,0,139,0,-139
7705,1,1,547,1211,664
7706,1,1,63,1501,1438
7707,0,0,6,0,-6
7708,0,0,19,0,-19
7709,0,0,36,0,-36
7710,1,0,1,0,-1
7711,1,1,47,1282,1235
7712,1,0,77,0,-77
7713,0,0,46,0,-46
7714,1,0,57,0,-57
7715,1,1,142,1754,1612
7716,1,0,22,0,-22
7717,1,1,730,1321,591
7718,0,0,56,0,-56
7719,1,0,28,0,-28
7720,1,0,4,0,-4
7721,1,0,32,0,-32
7722,0,0,38,0,-38
7723,0,0,39,0,-39
7724,1,0,105,0,-105
7725,1,0,56,0,-56
7726,1,0,37,0,-37
7727,1,1,163,1469,1306
7728,0,0,1,0,-1
7729,0,0,3,0,-3
7730,0,0,29,0,-29
7731,1,0,67,0,-67
7732,1,1,151,1305,1154
7733,1,1,400,1362,962
7734,0,0,46,0,-46
7735,1,1,1342,1890,548
7736,1,0,7,0,-7
7737,1,0,9,0,-9
7738,0,0,36,0,-36
7739,1,1,99,1301,1202
7740,1,1,1005,1602,597
7741,0,0,80,0,-80
7742,0,0,130,0,-130
7743,1,0,119,0,-119
7744,1,1,420,1336,916
7745,1,1,1008,1625,617
7746,0,0,35,0,-35
7747,1,0,39,0,-39
7748,0,0,13,0,-13
7749,0,0,35,0,-35
7750,0,0,12,0,-12
7751,0,0,58,0,-58
7752,1,0,1,0,-1
7753,1,0,131,0,-131
7754,0,0,35,0,-35
7755,0,0,15,0,-15
7756,1,0,41,0,-41
7757,1,1,300,1603,1303
7758,0,0,43,0,-43
7759,0,0,13,0,-13
7760,0,0,18,0,-18
7761,0,0,89,0,-89
7762,1,1,2320,1893,-427
7763,1,0,22,0,-22
7764,1,1,1054,1406,352
7765,1,0,151,0,-151
7766,1,0,77,0,-77
7767,1,1,60,1249,1189
7768,0,0,14,0,-14
7769,0,0,101,0,-101
7770,1,0,25,0,-25
7771,0,0,29,0,-29
7772,1,0,80,0,-80
7773,0,0,33,0,-33
7774,1,0,84,0,-84
7775,1,0,199,0,-199
7776,0,0,86,0,-86
7777,1,0,40,0,-40
7778,0,0,42,0,-42
7779,1,0,58,0,-58
7780,1,0,6,0,-6
7781,1,0,6,0,-6
7782,1,1,995,1290,295
7783,1,1,2,1852,1850
7784,0,0,65,0,-65
7785,0,0,9,0,-9
7786,1,1,177,1633,1456
7787,1,0,57,0,-57
7788,1,0,70,0,-70
7789,1,0,2,0,-2
7790,1,1,135,1212,1077
7791,1,0,26,0,-26
7792,1,1,623,1228,605
7793,1,1,284,1333,1049
7794,1,0,70,0,-70
7795,0,0,1,0,-1
7796,1,0,11,0,-11
7797,1,0,153,0,-153
7798,1,1,779,1371,592
7799,1,1,441,1761,1320
7800,1,1,122,1458,1336
7801,0,0,32,0,-32
7802,0,0,46,0,-46
7803,1,0,20,0,-20
7804,1,0,21,0,-21
7805,0,0,27,0,-27
7806,1,1,370,1487,1117
7807,1,0,32,0,-32
7808,1,1,1188,1211,23
7809,1,1,477,1214,737
7810,1,0,91,0,-91
7811,1,1,596,1275,679
7812,0,0,59,0,-59
7813,1,1,162,1380,1218
7814,0,0,11,0,-11
7815,1,0,2,0,-2
7816,1,0,110,0,-110
7817,0,0,25,0,-25
7818,0,0,47,0,-47
7819,1,1,694,1486,792
7820,1,1,85,1327,1242
7821,0,0,73,0,-73
7822,1,0,0,0,0
7823,1,0,4,0,-4
7824,1,1,246,7388,7142
7825,1,1,73,2093,2020
7826,0,0,0,0,0
7827,0,0,81,0,-81
7828,0,0,54,0,-54
7829,0,0,38,0,-38
7830,1,1,272,2228,1956
7831,0,0,3,0,-3
7832,1,0,39,0,-39
7833,1,0,97,0,-97
7834,1,1,2279,2047,-232
7835,1,1,282,1233,951
7836,1,1,422,1933,1511
7837,1,0,76,0,-76
7838,0,0,7,0,-7
7839,1,0,8,0,-8
7840,1,0,48,0,-48
7841,1,0,37,0,-37
7842,0,0,53,0,-53
7843,1,0,55,0,-55
7844,0,0,99,0,-99
7845,0,0,57,0,-57
7846,1,0,46,0,-46
7847,1,1,1866,1512,-354
7848,0,0,94,0,-94
7849,0,0,85,0,-85
7850,0,0,235,0,-235
7851,1,0,31,0,-31
7852,0,0,45,0,-45
7853,0,0,10,0,-10
7854,0,0,0,0,0
7855,0,0,94,0,-94
7856,0,0,42,0,-42
7857,1,0,119,0,-119
7858,1,0,26,0,-26
7859,1,0,22,0,-22
7860,1,1,203,1337,1134
7861,1,1,722,1517,795
7862,1,0,1,0,-1
7863,1,1,493,1380,887
7864,1,1,359,1680,1321
7865,1,0,26,0,-26
7866,0,0,29,0,-29
7867,1,0,76,0,-76
7868,0,0,20,0,-20
7869,1,0,53,0,-53
7870,1,0,9,0,-9
7871,0,0,5,0,-5
7872,1,0,82,0,-82
7873,1,1,114,1384,1270
7874,1,1,561,1407,846
7875,1,1,594,2378,1784
7876,1,0,38,0,-38
7877,1,1,277,1242,965
7878,0,0,49,0,-49
7879,0,0,4,0,-4
7880,0,0,48,0,-48
7881,1,0,157,0,-157
7882,0,0,36,0,-36
7883,1,0,46,0,-46
7884,0,0,89,0,-89
7885,0,0,155,0,-155
7886,1,1,692,1456,764
7887,1,0,21,0,-21
7888,0,0,22,0,-22
7889,1,1,570,1218,648
7890,1,0,3,0,-3
7891,0,0,212,0,-212
7892,0,0,88,0,-88
7893,1,0,70,0,-70
7894,0,0,11,0,-11
7895,1,0,76,0,-76
7896,1,0,2,0,-2
7897,1,1,261,1663,1402
7898,1,1,517,1215,698
7899,1,1,848,1463,615
7900,1,1,383,1225,842
7901,0,0,67,0,-67
7902,1,1,418,1372,954
7903,1,0,44,0,-44
7904,1,0,0,0,0
7905,0,0,31,0,-31
7906,0,0,25,0,-25
7907,1,1,59,1209,1150
7908,1,1,320,1358,1038
7909,1,0,3,0,-3
7910,1,1,564,1208,644
7911,1,0,1,0,-1
7912,1,1,952,1917,965
7913,1,0,2,0,-2
7914,0,0,33,0,-33
7915,1,0,25,0,-25
7916,0,0,232,0,-232
7917,1,1,682,3052,2370
7918,0,0,62,0,-62
7919,1,1,582,1287,705
7920,0,0,99,0,-99
7921,1,1,327,1896,1569
7922,0,0,57,0,-57
7923,1,1,115,1901,1786
7924,0,0,38,0,-38
7925,0,0,1,0,-1
7926,0,0,60,0,-60
7927,1,1,138,1580,1442
7928,1,0,28,0,-28
7929,1,1,77,2333,2256
7930,1,1,364,2091,1727
7931,0,0,71,0,-71
7932,1,0,1,0,-1
7933,0,0,267,0,-267
7934,1,1,866,1261,395
7935,1,0,175,0,-175
7936,1,0,20,0,-20
7937,0,0,7,0,-7
7938,1,0,10,0,-10
7939,1,1,41,2171,2130
7940,0,0,13,0,-13
7941,1,1,96,1227,1131
7942,0,0,36,0,-36
7943,1,0,46,0,-46
7944,1,1,1412,1247,-165
7945,0,0,160,0,-160
7946,1,1,589,1282,693
7947,0,0,59,0,-59
7948,1,1,590,1253,663
7949,1,0,162,0,-162
7950,1,0,188,0,-188
7951,0,0,151,0,-151
7952,1,0,47,0,-47
7953,1,0,4,0,-4
7954,1,1,827,1431,604
7955,1,1,87,1211,1124
7956,1,1,129,1368,1239
7957,0,0,45,0,-45
7958,1,0,23,0,-23
7959,1,0,79,0,-79
7960,0,0,118,0,-118
7961,1,0,33,0,-33
7962,0,0,62,0,-62
7963,0,0,6,0,-6
7964,1,0,44,0,-44
7965,1,1,213,1218,1005
7966,0,0,15,0,-15
7967,1,1,292,1224,932
7968,1,0,46,0,-46
7969,0,0,23,0,-23
7970,0,0,178,0,-178
7971,0,0,0,0,0
7972,0,0,75,0,-75
7973,1,1,51,1588,1537
7974,0,0,19,0,-19
7975,1,1,260,1733,1473
7976,0,0,17,0,-17
7977,1,0,75,0,-75
7978,1,1,401,3137,2736
7979,1,0,67,0,-67
7980,1,0,21,0,-21
7981,1,0,25,0,-25
7982,1,0,1,0,-1
7983,1,0,20,0,-20
7984,0,0,38,0,-38
7985,0,0,12,0,-12
7986,0,0,100,0,-100
7987,1,0,39,0,-39
7988,1,1,129,1479,1350
7989,1,1,430,1241,811
7990,0,0,11,0,-11
7991,1,1,19,1666,1647
7992,1,1,54,1237,1183
7993,1,1,674,1422,748
7994,1,1,381,1252,871
7995,0,0,153,0,-153
7996,0,0,1,0,-1
7997,1,1,418,1585,1167
7998,1,1,1152,1403,251
7999,1,1,231,1336,1105
8000,1,0,89,0,-89
8001,1,0,71,0,-71
8002,0,0,73,0,-73
8003,1,1,170,1490,1320
8004,1,1,214,2209,1995
8005,0,0,15,0,-15
8006,0,0,24,0,-24
8007,1,1,594,1368,774
8008,1,0,51,0,-51
8009,0,0,33,0,-33
8010,1,0,89,0,-89
8011,0,0,0,0,0
8012,0,0,60,0,-60
8013,1,1,35,1548,1513
8014,0,0,37,0,-37
8015,1,0,2,0,-2
8016,0,0,22,0,-22
8017,1,0,7,0,-7
8018,0,0,32,0,-32
8019,0,0,45,0,-45
8020,1,0,264,0,-264
8021,0,0,11,0,-11
8022,0,0,7,0,-7
8023,1,1,168,1280,1112
8024,0,0,83,0,-83
8025,1,1,380,1276,896
8026,1,0,69,0,-69
8027,1,0,73,0,-73
8028,1,0,27,0,-27
8029,0,0,24,0,-24
8030,1,1,44,1201,1157
8031,1,1,215,1300,1085
8032,1,1,87,1792,1705
8033,1,1,191,1450,1259
8034,1,0,45,0,-45
8035,1,1,1158,1211,53
8036,1,1,136,2605,2469
8037,1,1,212,1227,1015
8038,0,0,48,0,-48
8039,1,0,75,0,-75
8040,1,1,591,1853,1262
8041,1,0,86,0,-86
8042,1,0,77,0,-77
8043,0,0,123,0,-123
8044,1,0,16,0,-16
8045,0,0,49,0,-49
8046,1,0,51,0,-51
8047,0,0,6,0,-6
8048,1,0,46,0,-46
8049,0,0,27,0,-27
8050,1,0,156,0,-156
8051,1,0,51,0,-51
8052,1,1,137,1217,1080
8053,0,0,21,0,-21
8054,1,0,75,0,-75
8055,0,0,11,0,-11
8056,0,0,9,0,-9
8057,1,0,11,0,-11
8058,1,1,195,1532,1337
8059,1,1,248,1265,1017
8060,1,0,123,0,-123
8061,1,0,89,0,-89
8062,1,1,285,1893,1608
8063,0,0,30,0,-30
8064,1,1,963,1656,693
8065,0,0,104,0,-104
8066,0,0,32,0,-32
8067,0,0,48,0,-48
8068,1,1,150,1631,1481
8069,1,1,359,1264,905
8070,1,0,23,0,-23
8071,1,1,238,1292,1054
8072,1,1,524,1278,754
8073,1,0,29,0,-29
8074,1,1,894,1235,341
8075,0,0,48,0,-48
8076,0,0,110,0,-110
8077,0,0,19,0,-19
8078,0,0,8,0,-8
8079,0,0,60,0,-60
8080,1,0,117,0,-117
8081,0,0,21,0,-21
8082,1,1,634,1286,652
8083,0,0,137,0,-137
8084,0,0,58,0,-58
8085,1,0,26,0,-26
8086,1,1,794,1441,647
8087,1,1,214,1878,1664
8088,1,1,58,1322,1264
8089,1,1,904,1413,509
8090,1,0,20,0,-20
8091,1,1,37,1964,1927
8092,1,0,24,0,-24
8093,1,0,20,0,-20
8094,1,1,181,1545,1364
8095,0,0,86,0,-86
8096,1,1,955,1810,855
8097,0,0,1,0,-1
8098,1,1,909,1415,506
8099,0,0,61,0,-61
8100,1,1,1161,1481,320
8101,1,0,32,0,-32
8102,1,0,2,0,-2
8103,1,0,46,0,-46
8104,1,1,156,1210,1054
8105,0,0,24,0,-24
8106,1,1,149,1218,1069
8107,0,0,22,0,-22
8108,1,1,283,2036,1753
8109,1,0,15,0,-15
8110,1,1,990,1631,641
8111,0,0,2,0,-2
8112,1,1,840,1470,630
8113,1,0,71,0,-71
8114,1,0,82,0,-82
8115,1,1,476,1288,812
8116,1,1,200,1309,1109
8117,1,0,42,0,-42
8118,1,1,1369,1729,360
8119,0,0,11,0,-11
8120,1,0,197,0,-197
8121,1,0,11,0,-11
8122,1,0,13,0,-13
8123,1,0,54,0,-54
8124,1,0,40,0,-40
8125,1,0,3,0,-3
8126,0,0,26,0,-26
8127,1,1,402,1338,936
8128,1,1,93,1518,1425
8129,0,0,36,0,-36
8130,1,1,327,1704,1377
8131,0,0,14,0,-14
8132,1,0,31,0,-31
8133,1,1,162,3000,2838
8134,1,0,199,0,-199
8135,0,0,7,0,-7
8136,0,0,3,0,-3
8137,1,0,39,0,-39
8138,1,1,496,1445,949
8139,1,0,4,0,-4
8140,1,0,77,0,-77
8141,0,0,15,0,-15
8142,1,0,6,0,-6
8143,1,1,838,1382,544
8144,0,0,4,0,-4
8145,1,0,14,0,-14
8146,0,0,36,0,-36
8147,1,0,54,0,-54
8148,1,1,397,1259,862
8149,0,0,21,0,-21
8150,1,1,23,1251,1228
8151,0,0,97,0,-97
8152,0,0,58,0,-58
8153,0,0,0,0,0
8154,0,0,114,0,-114
8155,0,0,76,0,-76
8156,1,1,289,1544,1255
8157,1,1,107,2209,2102
8158,1,0,125,0,-125
8159,1,1,1066,1788,722
8160,0,0,138,0,-138
8161,1,0,20,0,-20
8162,1,0,33,0,-33
8163,0,0,36,0,-36
8164,1,0,17,0,-17
8165,1,0,7,0,-7
8166,1,0,134,0,-134
8167,1,1,890,1564,674
8168,0,0,181,0,-181
8169,0,0,32,0,-32
8170,1,0,3,0,-3
8171,0,0,17,0,-17
8172,1,1,511,1428,917
8173,0,0,2,0,-2
8174,1,0,6,0,-6
8175,0,0,123,0,-123
8176,1,0,123,0,-123
8177,1,0,116,0,-116
8178,1,1,85,1805,1720
8179,1,0,26,0,-26
8180,1,1,275,1312,1037
8181,1,0,82,0,-82
8182,0,0,4,0,-4
8183,1,0,97,0,-97
8184,1,1,491,1611,1120
8185,1,0,10,0,-10
8186,1,0,17,0,-17
8187,0,0,51,0,-51
8188,1,0,54,0,-54
8189,0,0,12,0,-12
8190,0,0,33,0,-33
8191,1,0,161,0,-161
8192,1,0,9,0,-9
8193,1,0,48,0,-48
8194,1,0,17,0,-17
8195,0,0,115,0,-115
8196,1,1,184,1291,1107
8197,1,1,74,1454,1380
8198,0,0,2,0,-2
8199,1,0,57,0,-57
8200,1,1,294,1278,984
8201,0,0,14,0,-14
8202,0,0,66,0,-66
8203,1,0,18,0,-18
8204,0,0,1,0,-1
8205,0,0,123,0,-123
8206,0,0,41,0,-41
8207,0,0,17,0,-17
8208,1,1,1475,1455,-20
8209,0,0,95,0,-95
8210,1,1,440,1787,1347
8211,1,1,143,1242,1099
8212,0,0,21,0,-21
8213,1,1,148,1641,1493
8214,0,0,153,0,-153
8215,1,0,1,0,-1
8216,1,0,22,0,-22
8217,0,0,53,0,-53
8218,0,0,4,0,-4
8219,0,0,100,0,-100
8220,1,1,968,1835,867
8221,1,1,77,1816,1739
8222,1,1,483,1209,726
8223,0,0,122,0,-122
8224,1,1,271,1514,1243
8225,0,0,137,0,-137
8226,1,1,245,1256,1011
8227,0,0,18,0,-18
8228,1,1,213,1443,1230
8229,0,0,152,0,-152
8230,1,1,592,1372,780
8231,0,0,31,0,-31
8232,0,0,60,0,-60
8233,0,0,70,0,-70
8234,0,0,99,0,-99
8235,0,0,16,0,-16
8236,1,1,764,1241,477
8237,1,0,197,0,-197
8238,1,0,58,0,-58
8239,0,0,36,0,-36
8240,1,0,35,0,-35
8241,0,0,94,0,-94
8242,0,0,8,0,-8
8243,1,1,146,1582,1436
8244,1,0,44,0,-44
8245,0,0,25,0,-25
8246,1,0,22,0,-22
8247,1,0,9,0,-9
8248,0,0,25,0,-25
8249,1,1,71,1875,1804
8250,1,1,417,1317,900
8251,1,1,853,1681,828
8252,1,0,14,0,-14
8253,0,0,12,0,-12
8254,0,0,165,0,-165
8255,0,0,12,0,-12
8256,0,0,33,0,-33
8257,0,0,1,0,-1
8258,0,0,195,0,-195
8259,1,0,152,0,-152
8260,0,0,14,0,-14
8261,1,1,807,2728,1921
8262,0,0,68,0,-68
8263,1,0,1,0,-1
8264,1,0,41,0,-41
8265,0,0,80,0,-80
8266,0,0,51,0,-51
8267,1,0,179,0,-179
8268,1,1,119,1657,1538
8269,0,0,138,0,-138
8270,1,1,275,2160,1885
8271,0,0,75,0,-75
8272,1,1,202,1215,1013
8273,1,0,29,0,-29
8274,1,0,10,0,-10
8275,1,1,393,2330,1937
8276,1,1,360,2665,2305
8277,0,0,19,0,-19
8278,0,0,36,0,-36
8279,0,0,51,0,-51
8280,1,0,141,0,-141
8281,1,1,530,1477,947
8282,0,0,29,0,-29
8283,0,0,28,0,-28
8284,1,0,42,0,-42
8285,0,0,16,0,-16
8286,1,1,1742,1209,-533
8287,1,1,275,1602,1327
8288,1,1,450,1434,984
8289,1,1,384,1337,953
8290,1,0,3,0,-3
8291,0,0,76,0,-76
8292,0,0,49,0,-49
8293,1,0,31,0,-31
8294,1,0,57,0,-57
8295,1,0,62,0,-62
8296,0,0,141,0,-141
8297,1,0,94,0,-94
8298,1,0,9,0,-9
8299,1,0,64,0,-64
8300,0,0,156,0,-156
8301,0,0,9,0,-9
8302,0,0,9,0,-9
8303,1,0,4,0,-4
8304,1,1,374,1889,1515
8305,1,1,624,1480,856
8306,1,0,53,0,-53
8307,0,0,15,0,-15
8308,1,1,150,1732,1582
8309,1,1,271,1515,1244
8310,1,1,116,1321,1205
8311,1,1,4140,1644,-2496
8312,0,0,45,0,-45
8313,1,1,442,1246,804
8314,0,0,84,0,-84
8315,1,1,1189,1847,658
8316,1,0,216,0,-216
8317,1,0,4,0,-4
8318,0,0,84,0,-84
8319,1,0,6,0,-6
8320,1,1,192,1433,1241
8321,1,0,76,0,-76
8322,1,1,176,1612,1436
8323,0,0,29,0,-29
8324,1,1,649,1334,685
8325,0,0,7,0,-7
8326,1,1,1512,1214,-298
8327,1,0,29,0,-29
8328,0,0,35,0,-35
8329,1,0,17,0,-17
8330,0,0,40,0,-40
8331,0,0,86,0,-86
8332,0,0,24,0,-24
8333,1,1,142,1203,1061
8334,1,0,67,0,-67
8335,0,0,12,0,-12
8336,0,0,12,0,-12
8337,1,1,320,1213,893
8338,0,0,15,0,-15
8339,0,0,79,0,-79
8340,0,0,37,0,-37
8341,0,0,39,0,-39
8342,1,0,8,0,-8
8343,1,1,130,1254,1124
8344,0,0,10,0,-10
8345,1,0,101,0,-101
8346,0,0,26,0,-26
8347,1,1,1170,1483,313
8348,1,1,398,1431,1033
8349,1,1,1053,3841,2788
8350,1,0,104,0,-104
8351,0,0,50,0,-50
8352,1,1,232,1269,1037
8353,1,1,744,1279,535
8354,1,1,604,1346,742
8355,0,0,11,0,-11
8356,1,0,20,0,-20
8357,0,0,30,0,-30
8358,1,0,107,0,-107
8359,1,0,37,0,-37
8360,0,0,29,0,-29
8361,0,0,34,0,-34
8362,0,0,66,0,-66
8363,1,0,11,0,-11
8364,1,1,2842,1233,-1609
8365,1,0,260,0,-260
8366,0,0,77,0,-77
8367,0,0,20,0,-20
8368,1,1,256,2412,2156
8369,0,0,38,0,-38
8370,1,0,15,0,-15
8371,1,0,30,0,-30
8372,1,1,56,1341,1285
8373,1,1,147,1316,1169
8374,0,0,42,0,-42
8375,1,1,92,1443,1351
8376,0,0,7,0,-7
8377,1,0,23,0,-23
8378,0,0,7,0,-7
8379,1,0,253,0,-253
8380,1,0,18,0,-18
8381,1,1,57,1221,1164
8382,1,0,16,0,-16
8383,0,0,108,0,-108
8384,1,1,769,1228,459
8385,1,0,55,0,-55
8386,1,0,28,0,-28
8387,1,1,463,1402,939
8388,0,0,112,0,-112
8389,1,0,33,0,-33
8390,1,1,860,1527,667
8391,1,1,100,1452,1352
8392,1,0,10,0,-10
8393,1,1,2589,1214,-1375
8394,1,1,965,1205,240
8395,0,0,47,0,-47
8396,0,0,86,0,-86
8397,0,0,53,0,-53
8398,1,1,89,1786,1697
8399,1,1,18,1200,1182
8400,1,0,6,0,-6
8401,0,0,11,0,-11
8402,1,0,91,0,-91
8403,1,1,550,1804,1254
8404,0,0,57,0,-57
8405,1,1,193,1482,1289
8406,0,0,52,0,-52
8407,0,0,77,0,-77
8408,0,0,4,0,-4
8409,0,0,87,0,-87
8410,0,0,5,0,-5
8411,1,1,674,1851,1177
8412,1,1,149,1584,1435
8413,1,0,8,0,-8
8414,0,0,22,0,-22
8415,1,1,116,1991,1875
8416,0,0,124,0,-124
8417,1,0,179,0,-179
8418,1,1,104,1817,1713
8419,1,1,1872,1990,118
8420,1,1,1147,1415,268
8421,0,0,42,0,-42
8422,0,0,79,0,-79
8423,0,0,8,0,-8
8424,1,1,695,1428,733
8425,1,0,16,0,-16
8426,1,0,28,0,-28
8427,1,1,1329,1340,11
8428,0,0,27,0,-27
8429,1,1,574,1938,1364
8430,1,1,1089,1475,386
8431,0,0,55,0,-55
8432,0,0,31,0,-31
8433,0,0,29,0,-29
8434,1,0,43,0,-43
8435,1,1,1010,1626,616
8436,1,0,21,0,-21
8437,0,0,1,0,-1
8438,0,0,52,0,-52
8439,0,0,40,0,-40
8440,1,0,160,0,-160
8441,0,0,246,0,-246
8442,1,1,154,1604,1450
8443,1,0,36,0,-36
8444,1,0,33,0,-33
8445,1,1,219,2023,1804
8446,1,0,81,0,-81
8447,0,0,37,0,-37
8448,1,1,200,1269,1069
8449,0,0,81,0,-81
8450,1,1,1204,1545,341
8451,1,0,102,0,-102
8452,1,1,257,2034,1777
8453,1,1,196,1210,1014
8454,1,1,87,1274,1187
8455,0,0,38,0,-38
8456,1,1,147,1383,1236
8457,1,1,326,3307,2981
8458,0,0,13,0,-13
8459,1,0,4,0,-4
8460,1,0,29,0,-29
8461,0,0,23,0,-23
8462,1,1,155,1303,1148
8463,1,1,175,1704,1529
8464,0,0,4,0,-4
8465,1,1,909,2359,1450
8466,1,0,44,0,-44
8467,1,0,19,0,-19
8468,1,0,18,0,-18
8469,1,0,54,0,-54
8470,0,0,22,0,-22
8471,1,0,23,0,-23
8472,0,0,22,0,-22
8473,1,1,180,2146,1966
8474,1,1,1033,2317,1284
8475,1,0,45,0,-45
8476,1,0,65,0,-65
8477,0,0,36,0,-36
8478,1,1,394,1448,1054
8479,0,0,67,0,-67
8480,0,0,17,0,-17
8481,1,1,394,1582,1188
8482,1,0,32,0,-32
8483,1,0,2,0,-2
8484,1,0,5,0,-5
8485,1,0,81,0,-81
8486,1,1,628,1368,740
8487,1,1,476,1293,817
8488,1,0,62,0,-62
8489,1,1,298,1442,1144
8490,1,1,1132,1335,203
8491,1,1,49,1261,1212
8492,0,0,34,0,-34
8493,1,1,994,2798,1804
8494,1,0,5,0,-5
8495,1,1,160,1265,1105
8496,0,0,53,0,-53
8497,0,0,8,0,-8
8498,1,1,259,1643,1384
8499,1,0,21,0,-21
8500,1,1,197,1435,1238
8501,0,0,6,0,-6
8502,0,0,166,0,-166
8503,1,1,494,1279,785
8504,1,1,89,2031,1942
8505,0,0,12,0,-12
8506,1,0,192,0,-192
8507,0,0,20,0,-20
8508,1,1,180,1369,1189
8509,1,1,206,1267,1061
8510,0,0,0,0,0
8511,0,0,8,0,-8
8512,1,1,414,1382,968
8513,0,0,8,0,-8
8514,1,0,28,0,-28
8515,1,1,989,1694,705
8516,1,0,115,0,-115
8517,1,1,203,1307,1104
8518,1,0,48,0,-48
8519,1,0,32,0,-32
8520,1,1,812,1449,637
8521,0,0,9,0,-9
8522,0,0,57,0,-57
8523,1,0,197,0,-197
8524,1,1,579,2101,1522
8525,1,1,682,1666,984
8526,0,0,52,0,-52
8527,0,0,18,0,-18
8528,1,0,175,0,-175
8529,1,0,8,0,-8
8530,1,0,141,0,-141
8531,1,0,117,0,-117
8532,1,1,323,1525,1202
8533,1,1,934,1532,598
8534,1,1,101,1335,1234
8535,0,0,86,0,-86
8536,0,0,63,0,-63
8537,1,0,42,0,-42
8538,1,1,546,2462,1916
8539,0,0,46,0,-46
8540,1,1,962,1870,908
8541,0,0,10,0,-10
8542,1,0,5,0,-5
8543,0,0,6,0,-6
8544,0,0,38,0,-38
8545,1,0,28,0,-28
8546,1,1,2686,1491,-1195
8547,1,0,40,0,-40
8548,1,0,62,0,-62
8549,0,0,143,0,-143
8550,1,0,0,0,0
8551,1,1,185,1526,1341
8552,1,0,95,0,-95
8553,0,0,3,0,-3
8554,0,0,12,0,-12
8555,1,1,816,1489,673
8556,1,1,417,1215,798
8557,0,0,75,0,-75
8558,0,0,42,0,-42
8559,0,0,19,0,-19
8560,1,1,248,1240,992
8561,1,1,313,1600,1287
8562,1,1,1099,1254,155
8563,0,0,4,0,-4
8564,1,0,2,0,-2
8565,1,0,50,0,-50
8566,0,0,2,0,-2
8567,1,1,643,1828,1185
8568,1,0,65,0,-65
8569,1,0,75,0,-75
8570,1,1,1214,1899,685
8571,1,1,432,7804,7372
8572,1,1,1611,2634,1023
8573,0,0,16,0,-16
8574,1,1,687,1286,599
8575,1,0,22,0,-22
8576,1,0,77,0,-77
8577,0,0,41,0,-41
8578,0,0,86,0,-86
8579,1,0,5,0,-5
8580,0,0,2,0,-2
8581,1,0,24,0,-24
8582,0,0,64,0,-64
8583,1,1,311,1399,1088
8584,1,0,10,0,-10
8585,1,1,227,1811,1584
8586,0,0,12,0,-12
8587,1,0,8,0,-8
8588,1,0,88,0,-88
8589,1,1,619,1279,660
8590,1,0,69,0,-69
8591,1,0,46,0,-46
8592,0,0,31,0,-31
8593,1,1,1241,1324,83
8594,0,0,6,0,-6
8595,0,0,140,0,-140
8596,1,0,2,0,-2
8597,1,0,27,0,-27
8598,1,1,71,1397,1326
8599,0,0,76,0,-76
8600,0,0,24,0,-24
8601,1,1,336,1258,922
8602,1,1,1246,2468,1222
8603,1,0,45,0,-45
8604,1,0,115,0,-115
8605,0,0,0,0,0
8606,1,0,10,0,-10
8607,0,0,101,0,-101
8608,1,1,238,1246,1008
8609,0,0,15,0,-15
8610,0,0,31,0,-31
8611,1,1,380,1304,924
8612,1,1,1182,1924,742
8613,1,0,70,0,-70
8614,1,0,38,0,-38
8615,1,1,1782,2313,531
8616,1,1,538,1271,733
8617,0,0,27,0,-27
8618,1,1,204,1265,1061
8619,0,0,93,0,-93
8620,1,0,12,0,-12
8621,1,0,10,0,-10
8622,1,0,9,0,-9
8623,0,0,3,0,-3
8624,0,0,121,0,-121
8625,0,0,107,0,-107
8626,0,0,58,0,-58
8627,0,0,6,0,-6
8628,0,0,23,0,-23
8629,1,0,44,0,-44
8630,0,0,97,0,-97
8631,1,1,90,1416,1326
8632,1,0,35,0,-35
8633,1,0,15,0,-15
8634,1,1,2060,4287,2227
8635,1,1,123,1261,1138
8636,0,0,2,0,-2
8637,0,0,156,0,-156
8638,1,0,40,0,-40
8639,1,1,104,1514,1410
8640,1,1,460,1526,1066
8641,1,1,231,1470,1239
8642,0,0,44,0,-44
8643,0,0,28,0,-28
8644,1,1,200,1435,1235
8645,1,1,359,1619,1260
8646,1,1,98,2193,2095
8647,0,0,6,0,-6
8648,0,0,55,0,-55
8649,0,0,160,0,-160
8650,1,1,71,3147,3076
8651,0,0,29,0,-29
8652,0,0,21,0,-21
8653,1,0,1,0,-1
8654,0,0,122,0,-122
8655,1,0,173,0,-173
8656,1,0,111,0,-111
8657,1,1,1040,1371,331
8658,1,0,39,0,-39
8659,1,1,130,1278,1148
8660,1,1,63,1352,1289
8661,0,0,135,0,-135
8662,1,0,181,0,-181
8663,1,0,44,0,-44
8664,1,1,258,1426,1168
8665,1,1,712,1206,494
8666,1,1,110,1936,1826
8667,1,1,1328,1214,-114
8668,0,0,57,0,-57
8669,1,1,150,1410,1260
8670,1,1,172,1227,1055
8671,1,0,13,0,-13
8672,1,1,1076,2114,1038
8673,0,0,6,0,-6
8674,1,0,25,0,-25
8675,1,0,24,0,-24
8676,0,0,32,0,-32
8677,1,1,1755,1233,-522
8678,0,0,20,0,-20
8679,1,0,65,0,-65
8680,1,0,85,0,-85
8681,1,0,24,0,-24
8682,0,0,15,0,-15
8683,0,0,53,0,-53
8684,1,1,469,1549,1080
8685,1,1,682,1417,735
8686,1,0,70,0,-70
8687,1,1,648,2027,1379
8688,0,0,9,0,-9
8689,1,1,409,1227,818
8690,0,0,4,0,-4
8691,0,0,50,0,-50
8692,1,0,63,0,-63
8693,1,0,160,0,-160
8694,0,0,9,0,-9
8695,1,1,234,2999,2765
8696,0,0,3,0,-3
8697,1,0,5,0,-5
8698,0,0,26,0,-26
8699,0,0,3,0,-3
8700,0,0,110,0,-110
8701,0,0,27,0,-27
8702,0,0,46,0,-46
8703,1,0,33,0,-33
8704,0,0,18,0,-18
8705,1,1,690,2020,1330
8706,0,0,20,0,-20
8707,1,1,756,1579,823
8708,1,0,4,0,-4
8709,0,0,51,0,-51
8710,1,1,296,1567,1271
8711,1,1,76,1529,1453
8712,1,1,484,1912,1428
8713,1,0,8,0,-8
8714,0,0,32,0,-32
8715,1,0,38,0,-38
8716,0,0,60,0,-60
8717,1,0,25,0,-25
8718,1,1,243,1459,1216
8719,0,0,2,0,-2
8720,0,0,82,0,-82
8721,0,0,174,0,-174
8722,0,0,56,0,-56
8723,1,1,630,1280,650
8724,1,1,137,1248,1111
8725,0,0,96,0,-96
8726,0,0,2,0,-2
8727,1,0,82,0,-82
8728,0,0,25,0,-25
8729,1,0,18,0,-18
8730,1,1,1804,1285,-519
8731,0,0,88,0,-88
8732,0,0,38,0,-38
8733,0,0,25,0,-25
8734,1,0,153,0,-153
8735,1,0,123,0,-123
8736,1,1,236,1417,1181
8737,0,0,32,0,-32
8738,1,1,265,1392,1127
8739,0,0,28,0,-28
8740,0,0,116,0,-116
8741,0,0,25,0,-25
8742,1,0,7,0,-7
8743,0,0,33,0,-33
8744,1,0,59,0,-59
8745,1,0,86,0,-86
8746,0,0,85,0,-85
8747,0,0,126,0,-126
8748,0,0,4,0,-4
8749,1,0,45,0,-45
8750,1,1,1107,1251,144
8751,1,0,15,0,-15
8752,0,0,19,0,-19
8753,0,0,35,0,-35
8754,1,0,116,0,-116
8755,1,0,161,0,-161
8756,0,0,21,0,-21
8757,0,0,7,0,-7
8758,1,0,53,0,-53
8759,1,1,351,2213,1862
8760,0,0,103,0,-103
8761,1,0,108,0,-108
8762,1,0,34,0,-34
8763,0,0,96,0,-96
8764,0,0,0,0,0
8765,1,0,4,0,-4
8766,1,1,733,1273,540
8767,1,1,1699,1287,-412
8768,1,0,16,0,-16
8769,0,0,42,0,-42
8770,1,1,48,1521,1473
8771,0,0,15,0,-15
8772,0,0,14,0,-14
8773,1,0,34,0,-34
8774,0,0,58,0,-58
8775,0,0,62,0,-62
8776,0,0,77,0,-77
8777,1,1,1217,1247,30
8778,1,0,1,0,-1
8779,0,0,17,0,-17
8780,1,1,267,1214,947
8781,0,0,4,0,-4
8782,0,0,223,0,-223
8783,1,1,322,1305,983
8784,1,1,1134,1201,67
8785,1,0,7,0,-7
8786,1,1,233,1480,1247
8787,0,0,21,0,-21
8788,0,0,30,0,-30
8789,0,0,79,0,-79
8790,0,0,84,0,-84
8791,1,1,244,1392,1148
8792,1,1,13,1820,1807
8793,1,1,1489,1237,-252
8794,1,1,546,1969,1423
8795,1,1,152,1695,1543
8796,0,0,2,0,-2
8797,1,1,32,2384,2352
8798,1,1,228,4947,4719
8799,1,0,2,0,-2
8800,0,0,4,0,-4
8801,1,0,2,0,-2
8802,1,1,562,1412,850
8803,0,0,76,0,-76
8804,0,0,128,0,-128
8805,1,1,61,1282,1221
8806,1,0,53,0,-53
8807,1,1,100,2631,2531
8808,1,1,715,1449,734
8809,1,1,24,1268,1244
8810,0,0,57,0,-57
8811,0,0,1,0,-1
8812,1,0,3,0,-3
8813,0,0,10,0,-10
8814,1,0,49,0,-49
8815,0,0,50,0,-50
8816,0,0,70,0,-70
8817,1,0,152,0,-152
8818,0,0,2,0,-2
8819,1,1,409,1365,956
8820,1,0,50,0,-50
8821,0,0,63,0,-63
8822,1,1,162,1242,1080
8823,0,0,4,0,-4
8824,1,1,483,1406,923
8825,1,1,1029,1382,353
8826,1,1,526,1217,691
8827,0,0,120,0,-120
8828,1,0,218,0,-218
8829,0,0,10,0,-10
8830,1,1,26,1656,1630
8831,1,0,19,0,-19
8832,1,0,6,0,-6
8833,1,1,91,1306,1215
8834,1,1,713,1238,525
8835,1,0,1,0,-1
8836,1,1,136,1676,1540
8837,1,0,6,0,-6
8838,1,0,13,0,-13
8839,0,0,12,0,-12
8840,1,0,45,0,-45
8841,1,0,21,0,-21
8842,1,1,111,1201,1090
8843,0,0,31,0,-31
8844,1,0,7,0,-7
8845,1,0,6,0,-6
8846,1,0,9,0,-9
8847,0,0,21,0,-21
8848,1,0,5,0,-5
8849,1,1,65,5259,5194
8850,1,0,11,0,-11
8851,1,0,30,0,-30
8852,1,0,21,0,-21
8853,1,1,1389,6945,5556
8854,0,0,59,0,-59
8855,1,1,216,1890,1674
8856,1,1,509,1214,705
8857,1,0,7,0,-7
8858,1,1,650,1592,942
8859,1,0,3,0,-3
8860,1,1,146,1335,1189
8861,1,1,810,1609,799
8862,1,1,992,1240,248
8863,1,0,131,0,-131
8864,0,0,54,0,-54
8865,0,0,59,0,-59
8866,0,0,12,0,-12
8867,0,0,6,0,-6
8868,1,0,57,0,-57
8869,1,1,1024,1310,286
8870,0,0,33,0,-33
8871,1,1,172,1424,1252
8872,0,0,10,0,-10
8873,1,1,443,1244,801
8874,1,0,80,0,-80
8875,0,0,40,0,-40
8876,1,1,900,1549,649
8877,1,0,52,0,-52
8878,1,1,769,1454,685
8879,1,1,691,1407,716
8880,1,0,129,0,-129
8881,1,1,68,1452,1384
8882,1,1,278,2011,1733
8883,1,1,366,1511,1145
8884,1,0,187,0,-187
8885,0,0,144,0,-144
8886,0,0,96,0,-96
8887,0,0,115,0,-115
8888,1,1,1031,1344,313
8889,1,0,48,0,-48
8890,1,1,189,1407,1218
8891,0,0,200,0,-200
8892,0,0,60,0,-60
8893,1,0,119,0,-119
8894,1,1,473,1259,786
8895,0,0,7,0,-7
8896,1,0,4,0,-4
8897,1,0,17,0,-17
8898,1,0,31,0,-31
8899,1,0,38,0,-38
8900,0,0,15,0,-15
8901,0,0,25,0,-25
8902,1,0,49,0,-49
8903,1,1,194,1522,1328
8904,1,0,17,0,-17
8905,1,1,213,1284,1071
8906,1,1,160,1284,1124
8907,1,1,233,1446,1213
8908,1,0,16,0,-16
8909,1,1,592,1452,860
8910,1,0,5,0,-5
8911,0,0,61,0,-61
8912,0,0,3,0,-3
8913,0,0,47,0,-47
8914,0,0,70,0,-70
8915,0,0,34,0,-34
8916,1,0,24,0,-24
8917,1,0,21,0,-21
8918,1,0,13,0,-13
8919,0,0,9,0,-9
8920,0,0,41,0,-41
8921,1,0,3,0,-3
8922,0,0,12,0,-12
8923,0,0,61,0,-61
8924,1,1,109,1951,1842
8925,0,0,14,0,-14
8926,1,0,20,0,-20
8927,0,0,53,0,-53
8928,0,0,137,0,-137
8929,0,0,58,0,-58
8930,1,1,323,1249,926
8931,1,0,47,0,-47
8932,1,0,8,0,-8
8933,1,0,29,0,-29
8934,1,0,2,0,-2
8935,0,0,54,0,-54
8936,0,0,16,0,-16
8937,1,1,2057,1450,-607
8938,1,1,555,1455,900
8939,1,0,1,0,-1
8940,1,0,25,0,-25
8941,0,0,14,0,-14
8942,0,0,13,0,-13
8943,0,0,35,0,-35
8944,0,0,125,0,-125
8945,1,0,83,0,-83
8946,0,0,59,0,-59
8947,0,0,15,0,-15
8948,1,1,496,1201,705
8949,1,1,320,1298,978
8950,0,0,6,0,-6
8951,1,0,37,0,-37
8952,1,0,69,0,-69
8953,1,0,23,0,-23
8954,0,0,28,0,-28
8955,0,0,3,0,-3
8956,1,1,90,1445,1355
8957,0,0,2,0,-2
8958,1,0,38,0,-38
8959,0,0,15,0,-15
8960,0,0,21,0,-21
8961,0,0,2,0,-2
8962,1,0,93,0,-93
8963,1,0,18,0,-18
8964,0,0,122,0,-122
8965,0,0,220,0,-220
8966,1,1,864,1241,377
8967,0,0,13,0,-13
8968,1,0,28,0,-28
8969,1,0,90,0,-90
8970,1,1,838,1518,680
8971,0,0,35,0,-35
8972,1,1,89,1237,1148
8973,1,1,140,1217,1077
8974,1,1,278,1423,1145
8975,1,0,21,0,-21
8976,0,0,26,0,-26
8977,1,1,1144,1618,474
8978,1,0,20,0,-20
8979,1,0,29,0,-29
8980,1,1,1008,1856,848
8981,1,1,156,1283,1127
8982,1,1,948,1212,264
8983,1,0,50,0,-50
8984,0,0,15,0,-15
8985,1,1,228,1695,1467
8986,1,1,418,1297,879
8987,1,1,444,1573,1129
8988,1,0,23,0,-23
8989,1,0,7,0,-7
8990,0,0,7,0,-7
8991,0,0,105,0,-105
8992,1,0,252,0,-252
8993,1,1,851,1368,517
8994,0,0,34,0,-34
8995,0,0,75,0,-75
8996,1,1,111,1513,1402
8997,1,1,242,1492,1250
8998,0,0,5,0,-5
8999,0,0,25,0,-25
9000,0,0,11,0,-11
9001,0,0,0,0,0
9002,1,1,193,1266,1073
9003,0,0,4,0,-4
9004,1,0,8,0,-8
9005,1,1,54,1458,1404
9006,1,0,106,0,-106
9007,1,0,68,0,-68
9008,1,1,970,1539,569
9009,1,0,33,0,-33
9010,0,0,5,0,-5
9011,1,1,169,2092,1923
9012,1,1,227,1430,1203
9013,1,0,7,0,-7
9014,1,0,68,0,-68
9015,0,0,58,0,-58
9016,0,0,36,0,-36
9017,1,0,0,0,0
9018,1,0,1,0,-1
9019,1,0,126,0,-126
9020,0,0,58,0,-58
9021,0,0,25,0,-25
9022,1,0,105,0,-105
9023,0,0,8,0,-8
9024,0,0,7,0,-7
9025,0,0,116,0,-116
9026,0,0,17,0,-17
9027,0,0,20,0,-20
9028,1,1,298,2054,1756
9029,1,1,58,2348,2290
9030,0,0,78,0,-78
9031,0,0,54,0,-54
9032,1,0,18,0,-18
9033,1,0,90,0,-90
9034,0,0,4,0,-4
9035,0,0,7,0,-7
9036,1,0,29,0,-29
9037,0,0,57,0,-57
9038,0,0,18,0,-18
9039,0,0,51,0,-51
9040,0,0,193,0,-193
9041,0,0,6,0,-6
9042,1,0,12,0,-12
9043,1,1,67,2389,2322
9044,1,0,95,0,-95
9045,1,1,278,1631,1353
9046,0,0,35,0,-35
9047,0,0,3,0,-3
9048,1,1,604,1271,667
9049,1,1,1254,1465,211
9050,1,0,53,0,-53
9051,0,0,63,0,-63
9052,1,1,494,2874,2380
9053,1,0,1,0,-1
9054,1,0,92,0,-92
9055,1,0,234,0,-234
9056,1,0,8,0,-8
9057,1,1,263,3555,3292
9058,0,0,13,0,-13
9059,1,0,145,0,-145
9060,0,0,50,0,-50
9061,1,1,137,1269,1132
9062,1,1,178,2068,1890
9063,1,1,1280,1235,-45
9064,1,1,574,1210,636
9065,0,0,11,0,-11
9066,1,1,355,1486,1131
9067,1,0,77,0,-77
9068,1,0,178,0,-178
9069,1,1,379,1368,989
9070,0,0,7,0,-7
9071,1,1,466,1352,886
9072,0,0,17,0,-17
9073,0,0,18,0,-18
9074,0,0,80,0,-80
9075,1,0,78,0,-78
9076,0,0,0,0,0
9077,0,0,27,0,-27
9078,1,1,131,1518,1387
9079,0,0,108,0,-108
9080,1,0,21,0,-21
9081,1,0,52,0,-52
9082,1,1,274,1734,1460
9083,0,0,10,0,-10
9084,0,0,44,0,-44
9085,0,0,52,0,-52
9086,1,1,405,1256,851
9087,0,0,39,0,-39
9088,1,1,441,1691,1250
9089,0,0,53,0,-53
9090,1,0,41,0,-41
9091,1,0,25,0,-25
9092,1,1,858,2314,1456
9093,1,0,84,0,-84
9094,1,0,126,0,-126
9095,1,1,187,1227,1040
9096,0,0,52,0,-52
9097,0,0,85,0,-85
9098,0,0,85,0,-85
9099,1,1,202,1427,1225
9100,1,1,70,1594,1524
9101,1,0,17,0,-17
9102,1,0,1,0,-1
9103,0,0,60,0,-60
9104,1,1,369,1306,937
9105,1,0,23,0,-23
9106,1,1,780,1521,741
9107,0,0,4,0,-4
9108,1,1,262,1846,1584
9109,0,0,42,0,-42
9110,1,1,365,1424,1059
9111,1,1,759,3055,2296
9112,1,0,0,0,0
9113,1,1,641,1489,848
9114,1,1,275,1380,1105
9115,0,0,12,0,-12
9116,1,1,67,1253,1186
9117,1,1,1536,1423,-113
9118,1,1,1961,1535,-426
9119,0,0,16,0,-16
9120,0,0,42,0,-42
9121,0,0,93,0,-93
9122,1,1,448,1290,842
9123,1,1,1663,1270,-393
9124,1,1,485,1211,726
9125,1,0,1,0,-1
9126,1,1,540,1270,730
9127,0,0,25,0,-25
9128,1,1,95,1922,1827
9129,1,1,608,1733,1125
9130,0,0,77,0,-77
9131,0,0,11,0,-11
9132,1,0,128,0,-128
9133,1,1,619,1263,644
9134,0,0,25,0,-25
9135,1,0,63,0,-63
9136,1,1,569,1424,855
9137,1,1,689,1209,520
9138,0,0,57,0,-57
9139,1,1,132,1704,1572
9140,1,1,370,1523,1153
9141,1,1,673,1425,752
9142,1,0,151,0,-151
9143,1,1,569,1203,634
9144,0,0,2,0,-2
9145,0,0,28,0,-28
9146,0,0,86,0,-86
9147,1,0,58,0,-58
9148,0,0,2,0,-2
9149,1,1,43,1313,1270
9150,0,0,7,0,-7
9151,1,1,46,2119,2073
9152,0,0,0,0,0
9153,0,0,163,0,-163
9154,1,1,75,1761,1686
9155,1,1,545,1573,1028
9156,0,0,33,0,-33
9157,0,0,32,0,-32
9158,1,1,410,1213,803
9159,1,1,32,3506,3474
9160,1,1,1009,4499,3490
9161,0,0,11,0,-11
9162,1,1,289,1227,938
9163,1,1,104,1404,1300
9164,1,1,168,1251,1083
9165,0,0,57,0,-57
9166,0,0,82,0,-82
9167,0,0,67,0,-67
9168,1,0,134,0,-134
9169,0,0,21,0,-21
9170,1,1,1344,1932,588
9171,0,0,31,0,-31
9172,1,0,39,0,-39
9173,1,0,86,0,-86
9174,0,0,17,0,-17
9175,1,1,81,1374,1293
9176,1,1,286,1217,931
9177,0,0,23,0,-23
9178,1,0,201,0,-201
9179,1,1,266,1274,1008
9180,1,1,646,1681,1035
9181,1,1,240,1354,1114
9182,1,0,46,0,-46
9183,0,0,28,0,-28
9184,0,0,9,0,-9
9185,0,0,6,0,-6
9186,0,0,37,0,-37
9187,1,0,94,0,-94
9188,1,1,286,1259,973
9189,1,0,19,0,-19
9190,1,1,55,1296,1241
9191,1,1,280,1409,1129
9192,0,0,71,0,-71
9193,1,1,256,1280,1024
9194,1,1,594,1660,1066
9195,0,0,23,0,-23
9196,1,1,327,1225,898
9197,1,0,2,0,-2
9198,1,1,157,1423,1266
9199,1,1,115,1511,1396
9200,1,0,75,0,-75
9201,0,0,24,0,-24
9202,1,0,25,0,-25
9203,0,0,40,0,-40
9204,1,0,73,0,-73
9205,1,1,1622,1652,30
9206,1,0,193,0,-193
9207,1,0,41,0,-41
9208,1,0,39,0,-39
9209,1,0,353,0,-353
9210,1,1,856,2695,1839
9211,0,0,51,0,-51
9212,1,0,67,0,-67
9213,0,0,11,0,-11
9214,1,0,98,0,-98
9215,0,0,48,0,-48
9216,1,0,61,0,-61
9217,1,1,285,1408,1123
9218,0,0,37,0,-37
9219,1,1,271,1740,1469
9220,1,0,7,0,-7
9221,1,0,0,0,0
9222,1,1,314,1483,1169
9223,0,0,44,0,-44
9224,1,1,1066,1466,400
9225,0,0,78,0,-78
9226,1,1,325,1571,1246
9227,0,0,92,0,-92
9228,1,1,75,1784,1709
9229,0,0,6,0,-6
9230,1,1,341,1518,1177
9231,1,0,1,0,-1
9232,0,0,177,0,-177
9233,0,0,4,0,-4
9234,1,1,205,1403,1198
9235,1,0,26,0,-26
9236,1,1,78,1392,1314
9237,0,0,23,0,-23
9238,1,1,52,1345,1293
9239,1,1,445,1217,772
9240,1,0,7,0,-7
9241,1,1,828,2123,1295
9242,1,0,29,0,-29
9243,1,0,48,0,-48
9244,0,0,46,0,-46
9245,1,1,160,1287,1127
9246,1,0,5,0,-5
9247,1,0,49,0,-49
9248,0,0,51,0,-51
9249,0,0,42,0,-42
9250,0,0,19,0,-19
9251,1,0,19,0,-19
9252,1,1,30,1499,1469
9253,1,1,64,1240,1176
9254,0,0,93,0,-93
9255,0,0,25,0,-25
9256,1,0,12,0,-12
9257,0,0,64,0,-64
9258,0,0,165,0,-165
9259,1,1,131,1205,1074
9260,1,0,51,0,-51
9261,1,1,526,1517,991
9262,1,1,293,1215,922
9263,1,0,16,0,-16
9264,0,0,45,0,-45
9265,1,0,57,0,-57
9266,0,0,61,0,-61
9267,0,0,0,0,0
9268,0,0,4,0,-4
9269,0,0,238,0,-238
9270,1,0,21,0,-21
9271,1,1,430,1443,1013
9272,1,1,167,1410,1243
9273,0,0,19,0,-19
9274,0,0,21,0,-21
9275,0,0,32,0,-32
9276,1,1,358,1248,890
9277,1,0,31,0,-31
9278,0,0,11,0,-11
9279,0,0,22,0,-22
9280,0,0,7,0,-7
9281,0,0,41,0,-41
9282,1,0,92,0,-92
9283,0,0,26,0,-26
9284,0,0,108,0,-108
9285,0,0,30,0,-30
9286,0,0,13,0,-13
9287,0,0,40,0,-40
9288,0,0,74,0,-74
9289,1,1,929,1927,998
9290,1,0,173,0,-173
9291,1,0,62,0,-62
9292,0,0,60,0,-60
9293,1,0,8,0,-8
9294,1,1,217,1216,999
9295,0,0,12,0,-12
9296,1,1,1504,1792,288
9297,0,0,14,0,-14
9298,1,1,337,1905,1568
9299,0,0,20,0,-20
9300,1,0,70,0,-70
9301,0,0,97,0,-97
9302,1,1,222,1264,1042
9303,1,0,77,0,-77
9304,1,0,31,0,-31
9305,1,1,462,1425,963
9306,1,0,9,0,-9
9307,1,1,376,1202,826
9308,1,0,37,0,-37
9309,1,1,137,1234,1097
9310,1,1,1441,1701,260
9311,0,0,76,0,-76
9312,0,0,20,0,-20
9313,1,1,122,1378,1256
9314,1,0,18,0,-18
9315,1,0,15,0,-15
9316,0,0,78,0,-78
9317,1,1,713,1218,505
9318,0,0,21,0,-21
9319,0,0,8,0,-8
9320,1,1,1782,2196,414
9321,1,1,456,1238,782
9322,1,0,20,0,-20
9323,1,0,22,0,-22
9324,1,0,61,0,-61
9325,1,0,163,0,-163
9326,0,0,90,0,-90
9327,0,0,87,0,-87
9328,0,0,192,0,-192
9329,0,0,31,0,-31
9330,0,0,109,0,-109
9331,0,0,4,0,-4
9332,0,0,9,0,-9
9333,1,1,44,1582,1538
9334,0,0,5,0,-5
9335,1,0,86,0,-86
9336,0,0,16,0,-16
9337,0,0,10,0,-10
9338,1,1,340,1415,1075
9339,0,0,27,0,-27
9340,0,0,80,0,-80
9341,0,0,1,0,-1
9342,1,0,99,0,-99
9343,1,0,155,0,-155
9344,1,1,59,1651,1592
9345,1,0,2,0,-2
9346,1,1,98,3439,3341
9347,1,1,578,1694,1116
9348,0,0,30,0,-30
9349,0,0,37,0,-37
9350,0,0,55,0,-55
9351,1,0,88,0,-88
9352,1,1,487,1323,836
9353,1,1,153,1317,1164
9354,0,0,68,0,-68
9355,1,1,322,1201,879
9356,1,0,2,0,-2
9357,0,0,25,0,-25
9358,1,1,101,1489,1388
9359,1,0,112,0,-112
9360,0,0,13,0,-13
9361,1,0,131,0,-131
9362,0,0,13,0,-13
9363,1,0,85,0,-85
9364,1,0,21,0,-21
9365,1,0,62,0,-62
9366,1,1,615,1617,1002
9367,1,0,24,0,-24
9368,1,0,9,0,-9
9369,1,1,115,1213,1098
9370,1,0,76,0,-76
9371,1,0,22,0,-22
9372,0,0,9,0,-9
9373,0,0,89,0,-89
9374,1,1,346,1324,978
9375,1,0,18,0,-18
9376,1,0,37,0,-37
9377,1,0,24,0,-24
9378,0,0,23,0,-23
9379,1,1,841,1383,542
9380,1,0,35,0,-35
9381,0,0,72,0,-72
9382,0,0,26,0,-26
9383,1,1,427,1241,814
9384,0,0,25,0,-25
9385,1,0,54,0,-54
9386,0,0,31,0,-31
9387,1,0,36,0,-36
9388,0,0,65,0,-65
9389,1,1,411,1297,886
9390,1,0,27,0,-27
9391,1,1,590,1225,635
9392,1,0,0,0,0
9393,1,0,45,0,-45
9394,0,0,126,0,-126
9395,1,0,65,0,-65
9396,1,0,34,0,-34
9397,0,0,13,0,-13
9398,0,0,0,0,0
9399,0,0,127,0,-127
9400,0,0,61,0,-61
9401,0,0,15,0,-15
9402,1,1,95,1301,1206
9403,1,1,213,2561,2348
9404,1,0,55,0,-55
9405,1,0,40,0,-40
9406,0,0,15,0,-15
9407,0,0,2,0,-2
9408,1,0,4,0,-4
9409,1,1,913,1251,338
9410,1,1,611,2111,1500
9411,0,0,7,0,-7
9412,1,0,50,0,-50
9413,1,0,7,0,-7
9414,1,1,24,1281,1257
9415,1,1,67,1251,1184
9416,0,0,31,0,-31
9417,0,0,25,0,-25
9418,1,1,438,2539,2101
9419,1,1,108,1655,1547
9420,1,0,10,0,-10
9421,1,0,130,0,-130
9422,1,1,58,1669,1611
9423,1,1,111,1573,1462
9424,1,1,709,1556,847
9425,0,0,56,0,-56
9426,0,0,27,0,-27
9427,0,0,50,0,-50
9428,1,0,111,0,-111
9429,1,0,103,0,-103
9430,0,0,40,0,-40
9431,0,0,152,0,-152
9432,1,1,28,1384,1356
9433,1,1,437,1237,800
9434,0,0,211,0,-211
9435,0,0,12,0,-12
9436,1,0,5,0,-5
9437,0,0,19,0,-19
9438,1,0,39,0,-39
9439,1,0,74,0,-74
9440,0,0,41,0,-41
9441,0,0,6,0,-6
9442,1,0,25,0,-25
9443,0,0,111,0,-111
9444,0,0,12,0,-12
9445,0,0,118,0,-118
9446,0,0,12,0,-12
9447,0,0,3,0,-3
9448,1,1,641,1354,713
9449,0,0,3,0,-3
9450,1,0,4,0,-4
9451,1,0,230,0,-230
9452,1,1,322,1241,919
9453,0,0,44,0,-44
9454,1,0,63,0,-63
9455,0,0,46,0,-46
9456,1,1,829,1775,946
9457,1,1,756,1359,603
9458,1,1,1529,1720,191
9459,1,1,1168,1571,403
9460,1,1,413,1475,1062
9461,1,0,1,0,-1
9462,1,0,98,0,-98
9463,1,0,6,0,-6
9464,0,0,186,0,-186
9465,0,0,88,0,-88
9466,1,0,0,0,0
9467,0,0,26,0,-26
9468,1,0,53,0,-53
9469,1,0,115,0,-115
9470,0,0,7,0,-7
9471,0,0,46,0,-46
9472,0,0,10,0,-10
9473,0,0,70,0,-70
9474,1,0,63,0,-63
9475,1,0,176,0,-176
9476,1,1,182,1420,1238
9477,1,1,56,1529,1473
9478,1,1,227,1447,1220
9479,1,0,126,0,-126
9480,1,0,81,0,-81
9481,1,1,93,1301,1208
9482,1,0,56,0,-56
9483,1,0,76,0,-76
9484,0,0,65,0,-65
9485,1,1,129,1515,1386
9486,1,0,4,0,-4
9487,0,0,11,0,-11
9488,1,1,126,1626,1500
9489,0,0,87,0,-87
9490,1,0,51,0,-51
9491,1,1,1547,1278,-269
9492,1,0,54,0,-54
9493,1,0,239,0,-239
9494,1,0,50,0,-50
9495,1,1,666,1209,543
9496,0,0,5,0,-5
9497,1,0,1,0,-1
9498,1,0,14,0,-14
9499,1,0,44,0,-44
9500,1,0,15,0,-15
9501,1,0,58,0,-58
9502,1,1,224,1223,999
9503,0,0,37,0,-37
9504,0,0,14,0,-14
9505,1,1,149,1963,1814
9506,1,1,1732,1274,-458
9507,1,1,353,1781,1428
9508,1,1,1131,1497,366
9509,0,0,181,0,-181
9510,1,1,282,1278,996
9511,0,0,7,0,-7
9512,1,1,616,1514,898
9513,0,0,10,0,-10
9514,1,0,20,0,-20
9515,0,0,38,0,-38
9516,0,0,31,0,-31
9517,0,0,42,0,-42
9518,0,0,24,0,-24
9519,0,0,28,0,-28
9520,1,0,68,0,-68
9521,0,0,3,0,-3
9522,1,1,288,1484,1196
9523,0,0,0,0,0
9524,0,0,27,0,-27
9525,1,1,123,1316,1193
9526,1,0,109,0,-109
9527,0,0,74,0,-74
9528,1,0,4,0,-4
9529,1,1,335,2243,1908
9530,0,0,92,0,-92
9531,1,1,734,1550,816
9532,1,0,4,0,-4
9533,1,1,545,1337,792
9534,0,0,7,0,-7
9535,1,1,146,1904,1758
9536,0,0,47,0,-47
9537,1,0,69,0,-69
9538,0,0,92,0,-92
9539,1,0,0,0,0
9540,1,0,111,0,-111
9541,1,1,182,1259,1077
9542,1,1,211,1937,1726
9543,1,0,11,0,-11
9544,1,1,665,1215,550
9545,1,1,111,1795,1684
9546,0,0,12,0,-12
9547,0,0,9,0,-9
9548,0,0,55,0,-55
9549,1,0,25,0,-25
9550,1,0,169,0,-169
9551,0,0,88,0,-88
9552,1,0,15,0,-15
9553,1,1,477,1583,1106
9554,0,0,3,0,-3
9555,1,0,38,0,-38
9556,1,1,167,1228,1061
9557,0,0,101,0,-101
9558,0,0,11,0,-11
9559,0,0,76,0,-76
9560,1,0,24,0,-24
9561,0,0,90,0,-90
9562,0,0,58,0,-58
9563,0,0,39,0,-39
9564,1,0,73,0,-73
9565,1,1,618,1731,1113
9566,1,1,446,1262,816
9567,0,0,58,0,-58
9568,1,1,57,1837,1780
9569,0,0,18,0,-18
9570,0,0,86,0,-86
9571,1,0,39,0,-39
9572,0,0,96,0,-96
9573,1,1,146,1426,1280
9574,1,0,23,0,-23
9575,1,0,18,0,-18
9576,1,0,9,0,-9
9577,0,0,15,0,-15
9578,0,0,72,0,-72
9579,1,1,474,1839,1365
9580,1,1,600,1889,1289
9581,1,0,7,0,-7
9582,1,1,894,1215,321
9583,1,1,163,1233,1070
9584,0,0,40,0,-40
9585,1,1,278,1411,1133
9586,0,0,4,0,-4
9587,1,0,8,0,-8
9588,1,0,0,0,0
9589,0,0,59,0,-59
9590,0,0,7,0,-7
9591,1,1,30,3853,3823
9592,1,0,64,0,-64
9593,0,0,18,0,-18
9594,1,1,478,1243,765
9595,0,0,23,0,-23
9596,0,0,16,0,-16
9597,1,0,64,0,-64
9598,0,0,0,0,0
9599,1,0,82,0,-82
9600,1,1,101,1229,1128
9601,1,0,28,0,-28
9602,1,1,238,1239,1001
9603,0,0,33,0,-33
9604,0,0,8,0,-8
9605,1,0,111,0,-111
9606,1,1,310,1817,1507
9607,1,1,237,1696,1459
9608,1,1,650,1442,792
9609,0,0,99,0,-99
9610,1,0,6,0,-6
9611,1,1,901,1241,340
9612,0,0,138,0,-138
9613,1,0,6,0,-6
9614,1,1,559,1239,680
9615,1,1,776,1975,1199
9616,1,1,370,1447,1077
9617,0,0,56,0,-56
9618,1,1,550,1400,850
9619,1,0,87,0,-87
9620,1,1,902,1474,572
9621,0,0,37,0,-37
9622,0,0,206,0,-206
9623,1,0,35,0,-35
9624,1,1,618,1254,636
9625,1,1,1364,1414,50
9626,1,0,85,0,-85
9627,0,0,10,0,-10
9628,0,0,57,0,-57
9629,0,0,41,0,-41
9630,0,0,24,0,-24
9631,0,0,1,0,-1
9632,1,1,351,1316,965
9633,1,0,11,0,-11
9634,0,0,21,0,-21
9635,0,0,1,0,-1
9636,0,0,97,0,-97
9637,0,0,82,0,-82
9638,1,1,466,1307,841
9639,1,0,16,0,-16
9640,0,0,51,0,-51
9641,1,1,348,1460,1112
9642,1,0,7,0,-7
9643,1,1,203,1264,1061
9644,1,1,247,1315,1068
9645,0,0,100,0,-100
9646,0,0,32,0,-32
9647,0,0,130,0,-130
9648,0,0,47,0,-47
9649,1,1,414,1402,988
9650,0,0,18,0,-18
9651,0,0,18,0,-18
9652,1,0,35,0,-35
9653,0,0,77,0,-77
9654,0,0,151,0,-151
9655,0,0,2,0,-2
9656,0,0,18,0,-18
9657,0,0,134,0,-134
9658,0,0,1,0,-1
9659,1,0,84,0,-84
9660,1,0,55,0,-55
9661,0,0,103,0,-103
9662,1,0,43,0,-43
9663,1,1,465,1675,1210
9664,0,0,18,0,-18
9665,1,1,536,1435,899
9666,1,0,61,0,-61
9667,1,0,146,0,-146
9668,1,1,1822,1634,-188
9669,1,1,97,1323,1226
9670,1,1,238,1552,1314
9671,1,0,56,0,-56
9672,1,0,122,0,-122
9673,1,0,23,0,-23
9674,0,0,139,0,-139
9675,0,0,34,0,-34
9676,1,0,1,0,-1
9677,1,1,237,1296,1059
9678,1,1,148,1301,1153
9679,0,0,42,0,-42
9680,0,0,4,0,-4
9681,0,0,192,0,-192
9682,1,1,393,1240,847
9683,0,0,47,0,-47
9684,1,0,51,0,-51
9685,0,0,2,0,-2
9686,1,0,23,0,-23
9687,0,0,5,0,-5
9688,0,0,47,0,-47
9689,1,1,566,1545,979
9690,0,0,18,0,-18
9691,1,1,26,1240,1214
9692,0,0,1,0,-1
9693,0,0,1,0,-1
9694,1,0,47,0,-47
9695,1,0,13,0,-13
9696,1,1,299,1231,932
9697,0,0,21,0,-21
9698,0,0,142,0,-142
9699,0,0,114,0,-114
9700,1,0,57,0,-57
9701,1,1,630,1290,660
9702,1,1,638,1293,655
9703,1,1,82,1696,1614
9704,0,0,52,0,-52
9705,0,0,110,0,-110
9706,0,0,50,0,-50
9707,0,0,151,0,-151
9708,0,0,112,0,-112
9709,0,0,90,0,-90
9710,1,0,44,0,-44
9711,0,0,36,0,-36
9712,1,0,2,0,-2
9713,1,1,214,1272,1058
9714,0,0,61,0,-61
9715,0,0,24,0,-24
9716,0,0,17,0,-17
9717,1,1,159,1565,1406
9718,0,0,27,0,-27
9719,1,1,864,1730,866
9720,1,1,625,2499,1874
9721,1,0,5,0,-5
9722,1,1,345,1233,888
9723,1,0,18,0,-18
9724,0,0,57,0,-57
9725,0,0,33,0,-33
9726,1,1,190,1250,1060
9727,0,0,25,0,-25
9728,0,0,5,0,-5
9729,1,1,212,2517,2305
9730,1,1,880,1357,477
9731,1,1,1089,1574,485
9732,1,0,91,0,-91
9733,0,0,7,0,-7
9734,1,1,1228,1525,297
9735,1,1,2086,1307,-779
9736,1,0,12,0,-12
9737,1,1,854,1260,406
9738,0,0,35,0,-35
9739,1,0,48,0,-48
9740,0,0,43,0,-43
9741,1,0,6,0,-6
9742,0,0,39,0,-39
9743,1,1,343,1405,1062
9744,1,1,23,1889,1866
9745,1,1,927,1458,531
9746,1,0,81,0,-81
9747,1,1,2314,1338,-976
9748,0,0,32,0,-32
9749,0,0,43,0,-43
9750,0,0,42,0,-42
9751,1,1,202,3571,3369
9752,1,1,372,1272,900
9753,1,0,28,0,-28
9754,0,0,32,0,-32
9755,1,1,725,1286,561
9756,1,1,193,1740,1547
9757,1,1,158,1616,1458
9758,1,0,3,0,-3
9759,1,0,13,0,-13
9760,1,0,279,0,-279
9761,1,0,38,0,-38
9762,1,0,41,0,-41
9763,1,1,356,1698,1342
9764,1,0,4,0,-4
9765,1,0,46,0,-46
9766,0,0,20,0,-20
9767,0,0,34,0,-34
9768,0,0,17,0,-17
9769,0,0,7,0,-7
9770,1,0,79,0,-79
9771,1,0,8,0,-8
9772,1,0,51,0,-51
9773,1,1,86,2447,2361
9774,1,1,1326,1219,-107
9775,0,0,8,0,-8
9776,1,0,12,0,-12
9777,1,0,45,0,-45
9778,1,1,348,2496,2148
9779,1,1,358,1267,909
9780,1,1,180,1956,1776
9781,1,0,123,0,-123
9782,0,0,26,0,-26
9783,1,0,45,0,-45
9784,1,0,8,0,-8
9785,0,0,58,0,-58
9786,1,1,185,2056,1871
9787,0,0,1,0,-1
9788,0,0,19,0,-19
9789,1,0,26,0,-26
9790,0,0,2,0,-2
9791,1,0,279,0,-279
9792,0,0,3,0,-3
9793,1,1,437,1241,804
9794,1,0,4,0,-4
9795,1,0,182,0,-182
9796,1,0,3,0,-3
9797,0,0,31,0,-31
9798,1,0,17,0,-17
9799,1,0,30,0,-30
9800,0,0,95,0,-95
9801,1,0,17,0,-17
9802,1,0,35,0,-35
9803,0,0,128,0,-128
9804,1,0,23,0,-23
9805,0,0,32,0,-32
9806,0,0,7,0,-7
9807,1,0,150,0,-150
9808,1,0,8,0,-8
9809,1,1,133,1412,1279
9810,0,0,31,0,-31
9811,1,0,20,0,-20
9812,1,0,38,0,-38
9813,0,0,107,0,-107
9814,1,0,44,0,-44
9815,1,1,84,1321,1237
9816,1,0,96,0,-96
9817,0,0,17,0,-17
9818,0,0,185,0,-185
9819,0,0,19,0,-19
9820,1,1,855,1240,385
9821,0,0,209,0,-209
9822,0,0,10,0,-10
9823,1,1,273,1319,1046
9824,1,1,94,1393,1299
9825,1,1,160,1343,1183
9826,1,0,16,0,-16
9827,1,1,32,1695,1663
9828,1,0,16,0,-16
9829,0,0,5,0,-5
9830,0,0,184,0,-184
9831,1,1,847,1973,1126
9832,1,1,976,1312,336
9833,1,1,350,1612,1262
9834,0,0,75,0,-75
9835,0,0,30,0,-30
9836,0,0,39,0,-39
9837,1,0,86,0,-86
9838,1,0,33,0,-33
9839,1,1,325,1200,875
9840,0,0,8,0,-8
9841,1,1,134,1466,1332
9842,1,0,9,0,-9
9843,0,0,111,0,-111
9844,1,0,25,0,-25
9845,1,1,351,1249,898
9846,0,0,137,0,-137
9847,1,0,40,0,-40
9848,0,0,48,0,-48
9849,1,1,359,1462,1103
9850,0,0,19,0,-19
9851,0,0,4,0,-4
9852,1,1,264,1587,1323
9853,1,1,532,1243,711
9854,0,0,162,0,-162
9855,1,1,60,1459,1399
9856,0,0,2,0,-2
9857,0,0,7,0,-7
9858,0,0,7,0,-7
9859,1,0,21,0,-21
9860,1,1,1325,2496,1171
9861,1,0,1,0,-1
9862,1,0,29,0,-29
9863,1,1,1345,1732,387
9864,1,0,17,0,-17
9865,0,0,20,0,-20
9866,1,0,70,0,-70
9867,1,0,31,0,-31
9868,1,0,14,0,-14
9869,0,0,32,0,-32
9870,0,0,24,0,-24
9871,1,0,45,0,-45
9872,0,0,17,0,-17
9873,0,0,16,0,-16
9874,1,0,33,0,-33
9875,1,0,28,0,-28
9876,1,0,62,0,-62
9877,0,0,82,0,-82
9878,1,0,3,0,-3
9879,1,1,263,1320,1057
9880,0,0,72,0,-72
9881,0,0,47,0,-47
9882,1,1,150,1234,1084
9883,0,0,21,0,-21
9884,1,1,324,1633,1309
9885,1,0,3,0,-3
9886,1,1,42,1201,1159
9887,0,0,23,0,-23
9888,1,0,7,0,-7
9889,1,1,1150,1554,404
9890,1,0,47,0,-47
9891,0,0,0,0,0
9892,1,0,42,0,-42
9893,1,0,5,0,-5
9894,1,1,129,1337,1208
9895,0,0,22,0,-22
9896,1,0,7,0,-7
9897,1,1,429,1233,804
9898,1,0,16,0,-16
9899,1,0,139,0,-139
9900,0,0,126,0,-126
9901,1,1,431,1394,963
9902,0,0,47,0,-47
9903,0,0,9,0,-9
9904,1,0,103,0,-103
9905,0,0,68,0,-68
9906,0,0,42,0,-42
9907,1,0,100,0,-100
9908,1,0,11,0,-11
9909,1,0,108,0,-108
9910,0,0,79,0,-79
9911,1,1,651,1302,651
9912,1,0,14,0,-14
9913,0,0,48,0,-48
9914,1,1,383,1684,1301
9915,1,1,406,2023,1617
9916,0,0,3,0,-3
9917,1,0,8,0,-8
9918,1,1,434,1475,1041
9919,1,1,382,1359,977
9920,1,0,69,0,-69
9921,0,0,90,0,-90
9922,1,1,1140,1598,458
9923,1,1,176,1688,1512
9924,1,0,70,0,-70
9925,1,1,31,1377,1346
9926,1,1,2147,1532,-615
9927,0,0,120,0,-120
9928,0,0,50,0,-50
9929,0,0,62,0,-62
9930,1,0,75,0,-75
9931,1,0,141,0,-141
9932,1,0,61,0,-61
9933,1,0,117,0,-117
9934,1,1,1851,1355,-496
9935,1,1,354,1249,895
9936,0,0,9,0,-9
9937,1,1,1109,2046,937
9938,1,1,747,2087,1340
9939,1,1,816,1567,751
9940,1,0,51,0,-51
9941,1,1,123,1312,1189
9942,1,0,68,0,-68
9943,0,0,26,0,-26
9944,0,0,21,0,-21
9945,0,0,42,0,-42
9946,0,0,17,0,-17
9947,1,0,80,0,-80
9948,0,0,187,0,-187
9949,1,0,42,0,-42
9950,0,0,56,0,-56
9951,1,1,382,1549,1167
9952,1,0,29,0,-29
9953,1,0,34,0,-34
9954,1,1,743,1697,954
9955,0,0,26,0,-26
9956,1,0,129,0,-129
9957,0,0,89,0,-89
9958,1,1,26,1773,1747
9959,1,0,36,0,-36
9960,0,0,13,0,-13
9961,1,0,64,0,-64
9962,1,0,110,0,-110
9963,1,0,61,0,-61
9964,1,1,1265,2378,1113
9965,0,0,41,0,-41
9966,1,1,128,1387,1259
9967,1,1,1237,1380,143
9968,1,1,42,1221,1179
9969,1,0,24,0,-24
9970,0,0,30,0,-30
9971,0,0,35,0,-35
9972,0,0,30,0,-30
9973,0,0,0,0,0
9974,0,0,158,0,-158
9975,1,0,85,0,-85
9976,1,1,91,1253,1162
9977,1,0,53,0,-53
9978,1,1,348,2255,1907
9979,0,0,29,0,-29
9980,1,1,1624,1366,-258
9981,1,1,466,1307,841
9982,0,0,8,0,-8
9983,1,0,129,0,-129
9984,1,1,1177,2660,1483
9985,1,1,921,1236,315
9986,1,0,9,0,-9
9987,0,0,164,0,-164
9988,1,0,194,0,-194
9989,0,0,42,0,-42
9990,0,0,9,0,-9
9991,1,1,402,2222,1820
9992,0,0,8,0,-8
9993,0,0,79,0,-79
9994,0,0,6,0,-6
9995,0,0,162,0,-162
9996,0,0,32,0,-32
9997,1,1,441,1519,1078
9998,1,0,7,0,-7
9999,1,1,1536,2596,1060
10000,1,1,561,2743,2182
10001,0,0,2,0,-2
10002,1,1,598,1213,615
10003,1,0,215,0,-215
10004,0,0,15,0,-15
10005,1,1,472,1657,1185
10006,0,0,104,0,-104
10007,1,0,54,0,-54
10008,1,0,15,0,-15
10009,1,1,125,1390,1265
10010,1,1,364,1311,947
10011,0,0,40,0,-40
10012,1,0,181,0,-181
10013,1,1,507,3054,2547
10014,1,1,148,1603,1455
10015,1,1,604,1272,668
10016,0,0,0,0,0
10017,0,0,67,0,-67
10018,0,0,166,0,-166
10019,0,0,92,0,-92
10020,0,0,94,0,-94
10021,0,0,90,0,-90
10022,1,0,71,0,-71
10023,0,0,1,0,-1
10024,0,0,5,0,-5
10025,0,0,10,0,-10
10026,0,0,33,0,-33
10027,1,0,75,0,-75
10028,1,1,204,1438,1234
10029,0,0,82,0,-82
10030,1,1,1060,1204,144
10031,1,0,51,0,-51
10032,0,0,21,0,-21
10033,0,0,9,0,-9
10034,1,1,188,2023,1835
10035,1,1,189,1345,1156
10036,1,1,160,1225,1065
10037,0,0,32,0,-32
10038,1,1,333,1337,1004
10039,1,1,500,1287,787
10040,1,1,204,1405,1201
10041,1,1,572,1313,741
10042,1,0,56,0,-56
10043,0,0,7,0,-7
10044,0,0,35,0,-35
10045,1,0,51,0,-51
10046,0,0,25,0,-25
10047,1,0,3,0,-3
10048,0,0,51,0,-51
10049,1,1,820,1507,687
10050,0,0,165,0,-165
10051,0,0,40,0,-40
10052,0,0,122,0,-122
10053,1,1,304,1943,1639
10054,1,0,14,0,-14
10055,0,0,0,0,0
10056,1,0,77,0,-77
10057,1,0,52,0,-52
10058,1,1,314,1214,900
10059,0,0,13,0,-13
10060,0,0,27,0,-27
10061,0,0,36,0,-36
10062,0,0,57,0,-57
10063,1,1,374,1587,1213
10064,1,1,497,1877,1380
10065,1,1,164,2713,2549
10066,1,0,13,0,-13
10067,0,0,32,0,-32
10068,0,0,1,0,-1
10069,1,0,7,0,-7
10070,1,1,1072,1277,205
10071,1,0,80,0,-80
10072,1,0,44,0,-44
10073,1,1,2173,1421,-752
10074,1,0,36,0,-36
10075,1,0,45,0,-45
10076,0,0,2,0,-2
10077,0,0,2,0,-2
10078,1,0,56,0,-56
10079,1,0,30,0,-30
10080,1,1,1368,1312,-56
10081,1,1,904,1650,746
10082,0,0,32,0,-32
10083,1,0,47,0,-47
10084,0,0,37,0,-37
10085,0,0,7,0,-7
10086,1,1,62,1470,1408
10087,0,0,3,0,-3
10088,0,0,22,0,-22
10089,0,0,2,0,-2
10090,0,0,18,0,-18
10091,1,1,212,2653,2441
10092,1,0,34,0,-34
10093,1,1,1139,1263,124
10094,1,1,515,2170,1655
10095,1,0,3,0,-3
10096,0,0,2,0,-2
10097,0,0,27,0,-27
10098,0,0,35,0,-35
10099,1,1,1484,1346,-138
10100,1,0,1,0,-1
10101,1,0,22,0,-22
10102,0,0,14,0,-14
10103,1,1,617,1262,645
10104,0,0,13,0,-13
10105,1,0,78,0,-78
10106,1,0,60,0,-60
10107,0,0,11,0,-11
10108,1,1,562,1201,639
10109,0,0,37,0,-37
10110,1,0,77,0,-77
10111,1,1,132,1436,1304
10112,1,0,42,0,-42
10113,1,0,1,0,-1
10114,1,0,13,0,-13
10115,1,0,35,0,-35
10116,0,0,36,0,-36
10117,1,1,319,1443,1124
10118,0,0,5,0,-5
10119,1,0,26,0,-26
10120,1,0,13,0,-13
10121,0,0,0,0,0
10122,0,0,21,0,-21
10123,0,0,28,0,-28
10124,0,0,30,0,-30
10125,1,1,330,1581,1251
10126,1,1,71,2186,2115
10127,1,0,135,0,-135
10128,0,0,31,0,-31
10129,1,1,436,2694,2258
10130,0,0,21,0,-21
10131,1,0,21,0,-21
10132,1,1,729,2067,1338
10133,1,0,18,0,-18
10134,1,0,158,0,-158
10135,0,0,3,0,-3
10136,0,0,39,0,-39
10137,1,0,127,0,-127
10138,1,0,0,0,0
10139,0,0,27,0,-27
10140,1,0,47,0,-47
10141,1,0,63,0,-63
10142,1,1,929,1392,463
10143,1,0,117,0,-117
10144,0,0,98,0,-98
10145,1,1,669,1218,549
10146,1,1,881,2014,1133
10147,0,0,53,0,-53
10148,1,0,10,0,-10
10149,1,0,40,0,-40
10150,0,0,45,0,-45
10151,0,0,54,0,-54
10152,0,0,29,0,-29
10153,0,0,41,0,-41
10154,0,0,127,0,-127
10155,1,1,399,2274,1875
10156,0,0,123,0,-123
10157,0,0,29,0,-29
10158,1,1,373,1345,972
10159,0,0,52,0,-52
10160,1,1,104,1245,1141
10161,0,0,0,0,0
10162,1,0,82,0,-82
10163,0,0,15,0,-15
10164,0,0,6,0,-6
10165,1,1,973,1478,505
10166,0,0,43,0,-43
10167,0,0,11,0,-11
10168,0,0,211,0,-211
10169,0,0,31,0,-31
10170,0,0,12,0,-12
10171,0,0,25,0,-25
10172,1,0,9,0,-9
10173,1,0,25,0,-25
10174,1,1,1652,1272,-380
10175,1,1,136,1323,1187
10176,1,0,9,0,-9
10177,1,1,111,1518,1407
10178,1,1,519,2069,1550
10179,0,0,16,0,-16
10180,0,0,133,0,-133
10181,1,0,3,0,-3
10182,0,0,28,0,-28
10183,1,1,165,1522,1357
10184,1,1,679,1548,869
10185,0,0,24,0,-24
10186,1,1,750,1230,480
10187,1,1,873,2633,1760
10188,0,0,10,0,-10
10189,1,1,737,1818,1081
10190,0,0,14,0,-14
10191,1,0,154,0,-154
10192,0,0,159,0,-159
10193,0,0,34,0,-34
10194,1,0,28,0,-28
10195,0,0,105,0,-105
10196,1,0,23,0,-23
10197,1,1,788,1211,423
10198,1,0,15,0,-15
10199,1,0,143,0,-143
10200,0,0,81,0,-81
10201,0,0,79,0,-79
10202,0,0,82,0,-82
10203,1,0,25,0,-25
10204,1,0,16,0,-16
10205,1,1,55,1238,1183
10206,1,1,650,1786,1136
10207,0,0,14,0,-14
10208,0,0,84,0,-84
10209,0,0,15,0,-15
10210,1,0,77,0,-77
10211,1,1,1749,2809,1060
10212,1,1,129,1861,1732
10213,0,0,9,0,-9
10214,1,1,744,1603,859
10215,1,0,24,0,-24
10216,0,0,29,0,-29
10217,1,1,607,1416,809
10218,1,0,117,0,-117
10219,0,0,86,0,-86
10220,1,1,831,1470,639
10221,1,0,36,0,-36
10222,1,1,840,1237,397
10223,0,0,13,0,-13
10224,1,0,136,0,-136
10225,0,0,23,0,-23
10226,0,0,79,0,-79
10227,0,0,65,0,-65
10228,1,1,228,1359,1131
10229,1,1,105,1439,1334
10230,1,0,42,0,-42
10231,1,1,179,1266,1087
10232,1,0,3,0,-3
10233,0,0,130,0,-130
10234,1,0,112,0,-112
10235,1,1,849,1965,1116
10236,1,0,77,0,-77
10237,1,1,625,1273,648
10238,1,1,789,3645,2856
10239,1,0,36,0,-36
10240,1,0,66,0,-66
10241,0,0,7,0,-7
10242,1,0,142,0,-142
10243,0,0,7,0,-7
10244,0,0,108,0,-108
10245,0,0,12,0,-12
10246,0,0,112,0,-112
10247,0,0,69,0,-69
10248,1,0,3,0,-3
10249,1,1,127,1469,1342
10250,1,0,18,0,-18
10251,1,0,5,0,-5
10252,1,0,64,0,-64
10253,0,0,26,0,-26
10254,1,0,5,0,-5
10255,0,0,0,0,0
10256,1,0,35,0,-35
10257,0,0,13,0,-13
10258,0,0,3,0,-3
10259,1,1,176,1446,1270
10260,1,1,87,1833,1746
10261,0,0,67,0,-67
10262,0,0,96,0,-96
10263,0,0,16,0,-16
10264,0,0,45,0,-45
10265,0,0,87,0,-87
10266,0,0,2,0,-2
10267,1,0,127,0,-127
10268,0,0,156,0,-156
10269,1,1,229,1449,1220
10270,1,1,244,1221,977
10271,0,0,90,0,-90
10272,1,0,38,0,-38
10273,1,0,8,0,-8
10274,0,0,31,0,-31
10275,1,1,253,2332,2079
10276,0,0,21,0,-21
10277,1,0,3,0,-3
10278,1,1,466,1728,1262
10279,1,0,11,0,-11
10280,1,1,823,1574,751
10281,1,0,5,0,-5
10282,1,0,15,0,-15
10283,0,0,245,0,-245
10284,1,1,797,1725,928
10285,1,0,60,0,-60
10286,0,0,10,0,-10
10287,1,1,769,1352,583
10288,1,0,82,0,-82
10289,1,1,472,3813,3341
10290,1,1,402,1364,962
10291,0,0,216,0,-216
10292,1,0,11,0,-11
10293,1,0,40,0,-40
10294,1,1,240,1322,1082
10295,0,0,78,0,-78
10296,1,0,14,0,-14
10297,0,0,192,0,-192
10298,1,1,102,1490,1388
10299,1,0,18,0,-18
10300,1,0,42,0,-42
10301,1,0,8,0,-8
10302,0,0,32,0,-32
10303,0,0,20,0,-20
10304,1,1,315,1271,956
10305,0,0,52,0,-52
10306,1,0,15,0,-15
10307,1,0,0,0,0
10308,1,0,27,0,-27
10309,1,0,96,0,-96
10310,0,0,12,0,-12
10311,1,0,100,0,-100
10312,1,0,100,0,-100
10313,1,1,723,2354,1631
10314,0,0,51,0,-51
10315,1,1,367,1308,941
10316,0,0,86,0,-86
10317,1,1,515,2765,2250
10318,0,0,75,0,-75
10319,0,0,63,0,-63
10320,1,0,62,0,-62
10321,1,0,39,0,-39
10322,1,0,52,0,-52
10323,1,1,892,1513,621
10324,1,1,436,1710,1274
10325,1,0,50,0,-50
10326,0,0,15,0,-15
10327,0,0,61,0,-61
10328,1,0,65,0,-65
10329,1,0,20,0,-20
10330,1,1,110,1722,1612
10331,0,0,32,0,-32
10332,1,1,146,1290,1144
10333,1,1,293,2059,1766
10334,1,1,280,1220,940
10335,1,1,43,1344,1301
10336,0,0,51,0,-51
10337,0,0,23,0,-23
10338,1,0,49,0,-49
10339,0,0,9,0,-9
10340,1,1,303,1425,1122
10341,0,0,1,0,-1
10342,0,0,79,0,-79
10343,1,1,465,1455,990
10344,1,1,135,1307,1172
10345,1,0,65,0,-65
10346,1,1,1472,1264,-208
10347,1,1,194,1716,1522
10348,0,0,17,0,-17
10349,0,0,57,0,-57
10350,1,1,387,1933,1546
10351,1,0,3,0,-3
10352,1,0,36,0,-36
10353,1,0,2,0,-2
10354,1,1,36,2680,2644
10355,0,0,82,0,-82
10356,1,1,405,1393,988
10357,1,0,70,0,-70
10358,1,0,9,0,-9
10359,1,0,20,0,-20
10360,0,0,85,0,-85
10361,0,0,199,0,-199
10362,1,0,282,0,-282
10363,0,0,15,0,-15
10364,1,0,19,0,-19
10365,1,1,277,1210,933
10366,1,1,101,1232,1131
10367,0,0,7,0,-7
10368,1,0,119,0,-119
10369,1,0,45,0,-45
10370,0,0,48,0,-48
10371,1,1,504,1235,731
10372,0,0,21,0,-21
10373,0,0,26,0,-26
10374,0,0,16,0,-16
10375,1,1,220,1387,1167
10376,0,0,17,0,-17
10377,0,0,13,0,-13
10378,0,0,12,0,-12
10379,1,1,1441,1336,-105
10380,0,0,5,0,-5
10381,1,0,12,0,-12
10382,0,0,90,0,-90
10383,1,1,407,1427,1020
10384,0,0,3,0,-3
10385,0,0,5,0,-5
10386,0,0,3,0,-3
10387,1,1,74,1223,1149
10388,0,0,40,0,-40
10389,1,1,1250,1710,460
10390,1,0,21,0,-21
10391,0,0,25,0,-25
10392,1,1,267,1200,933
10393,0,0,49,0,-49
10394,0,0,4,0,-4
10395,1,0,51,0,-51
10396,1,1,265,1520,1255
10397,0,0,76,0,-76
10398,1,0,18,0,-18
10399,1,1,319,1751,1432
10400,0,0,36,0,-36
10401,1,0,4,0,-4
10402,0,0,42,0,-42
10403,0,0,0,0,0
10404,0,0,16,0,-16
10405,1,1,492,1612,1120
10406,1,1,81,2281,2200
10407,1,0,50,0,-50
10408,1,0,29,0,-29
10409,1,0,84,0,-84
10410,0,0,3,0,-3
10411,0,0,6,0,-6
10412,1,1,1217,1275,58
10413,0,0,55,0,-55
10414,1,0,8,0,-8
10415,1,1,233,1686,1453
10416,1,1,162,1899,1737
10417,1,0,13,0,-13
10418,1,0,75,0,-75
10419,0,0,80,0,-80
10420,1,0,10,0,-10
10421,1,1,663,1382,719
10422,1,1,1224,1395,171
10423,1,1,1326,1349,23
10424,1,0,12,0,-12
10425,1,0,68,0,-68
10426,0,0,259,0,-259
10427,0,0,99,0,-99
10428,0,0,14,0,-14
10429,1,1,969,1306,337
10430,0,0,244,0,-244
10431,1,0,17,0,-17
10432,1,0,30,0,-30
10433,1,1,685,1219,534
10434,1,0,20,0,-20
10435,1,0,77,0,-77
10436,0,0,149,0,-149
10437,1,0,186,0,-186
10438,1,0,174,0,-174
10439,1,1,132,3002,2870
10440,0,0,36,0,-36
10441,0,0,60,0,-60
10442,1,0,18,0,-18
10443,0,0,6,0,-6
10444,1,1,1236,1219,-17
10445,1,0,68,0,-68
10446,0,0,67,0,-67
10447,1,0,38,0,-38
10448,1,0,16,0,-16
10449,1,0,123,0,-123
10450,0,0,21,0,-21
10451,0,0,17,0,-17
10452,1,1,1342,1357,15
10453,0,0,67,0,-67
10454,0,0,30,0,-30
10455,0,0,3,0,-3
10456,0,0,3,0,-3
10457,0,0,48,0,-48
10458,0,0,103,0,-103
10459,0,0,67,0,-67
10460,1,0,32,0,-32
10461,1,0,35,0,-35
10462,0,0,8,0,-8
10463,1,0,46,0,-46
10464,1,0,52,0,-52
10465,1,0,70,0,-70
10466,1,1,468,1255,787
10467,0,0,4,0,-4
10468,1,0,80,0,-80
10469,1,1,800,1735,935
10470,1,0,53,0,-53
10471,1,0,79,0,-79
10472,0,0,11,0,-11
10473,1,1,541,3785,3244
10474,0,0,5,0,-5
10475,0,0,14,0,-14
10476,0,0,48,0,-48
10477,1,1,209,1419,1210
10478,0,0,25,0,-25
10479,0,0,9,0,-9
10480,0,0,11,0,-11
10481,0,0,2,0,-2
10482,0,0,69,0,-69
10483,1,1,2561,1265,-1296
10484,1,0,126,0,-126
10485,0,0,46,0,-46
10486,0,0,16,0,-16
10487,0,0,3,0,-3
10488,0,0,22,0,-22
10489,1,1,300,1786,1486
10490,1,1,236,1253,1017
10491,1,0,65,0,-65
10492,1,1,118,1853,1735
10493,1,1,129,1283,1154
10494,1,0,31,0,-31
10495,1,1,316,1739,1423
10496,1,0,69,0,-69
10497,1,0,9,0,-9
10498,1,0,14,0,-14
10499,1,0,21,0,-21
10500,0,0,49,0,-49
10501,1,1,171,1739,1568
10502,1,1,2344,1502,-842
10503,1,0,13,0,-13
10504,1,1,60,1291,1231
10505,1,0,84,0,-84
10506,0,0,24,0,-24
10507,1,1,1609,1754,145
10508,0,0,58,0,-58
10509,1,1,323,1455,1132
10510,1,0,27,0,-27
10511,1,0,88,0,-88
10512,0,0,32,0,-32
10513,0,0,27,0,-27
10514,1,0,68,0,-68
10515,0,0,59,0,-59
10516,0,0,142,0,-142
10517,1,1,126,2496,2370
10518,0,0,74,0,-74
10519,1,1,621,1312,691
10520,0,0,8,0,-8
10521,0,0,8,0,-8
10522,1,0,20,0,-20
10523,1,1,592,1237,645
10524,0,0,32,0,-32
10525,1,0,44,0,-44
10526,0,0,68,0,-68
10527,1,0,126,0,-126
10528,0,0,71,0,-71
10529,1,0,44,0,-44
10530,1,0,29,0,-29
10531,0,0,1,0,-1
10532,0,0,24,0,-24
10533,0,0,64,0,-64
10534,0,0,99,0,-99
10535,1,0,21,0,-21
10536,0,0,3,0,-3
10537,0,0,241,0,-241
10538,1,1,679,1836,1157
10539,0,0,53,0,-53
10540,1,0,20,0,-20
10541,0,0,37,0,-37
10542,0,0,77,0,-77
10543,0,0,30,0,-30
10544,0,0,8,0,-8
10545,1,1,1489,1572,83
10546,1,1,684,1234,550
10547,0,0,44,0,-44
10548,1,1,534,1325,791
10549,0,0,3,0,-3
10550,1,1,833,1216,383
10551,1,0,84,0,-84
10552,0,0,91,0,-91
10553,0,0,21,0,-21
10554,1,1,1150,1354,204
10555,1,1,559,1666,1107
10556,1,1,404,1204,800
10557,0,0,31,0,-31
10558,0,0,19,0,-19
10559,1,1,685,1265,580
10560,0,0,31,0,-31
10561,1,1,285,1430,1145
10562,1,0,33,0,-33
10563,1,0,9,0,-9
10564,0,0,13,0,-13
10565,0,0,13,0,-13
10566,1,0,14,0,-14
10567,0,0,44,0,-44
10568,0,0,26,0,-26
10569,1,0,5,0,-5
10570,1,0,34,0,-34
10571,0,0,5,0,-5
10572,1,0,101,0,-101
10573,1,1,910,1270,360
10574,1,0,38,0,-38
10575,1,1,1139,1223,84
10576,0,0,174,0,-174
10577,1,0,7,0,-7
10578,1,0,6,0,-6
10579,0,0,111,0,-111
10580,0,0,100,0,-100
10581,1,1,83,1393,1310
10582,1,0,91,0,-91
10583,1,0,61,0,-61
10584,1,0,8,0,-8
10585,1,1,68,1448,1380
10586,1,1,532,1475,943
10587,1,1,912,1444,532
10588,1,1,287,1502,1215
10589,1,1,212,1948,1736
10590,1,0,157,0,-157
10591,1,1,514,1854,1340
10592,1,1,1215,1535,320
10593,0,0,127,0,-127
10594,1,0,57,0,-57
10595,1,1,1072,1215,143
10596,1,1,58,1501,1443
10597,1,1,155,2195,2040
10598,0,0,62,0,-62
10599,1,1,449,1513,1064
10600,0,0,50,0,-50
10601,1,0,21,0,-21
10602,1,0,82,0,-82
10603,0,0,1,0,-1
10604,1,0,25,0,-25
10605,1,1,183,1647,1464
10606,0,0,22,0,-22
10607,0,0,1,0,-1
10608,1,1,944,2632,1688
10609,0,0,20,0,-20
10610,1,1,31,1342,1311
10611,0,0,44,0,-44
10612,1,0,115,0,-115
10613,0,0,102,0,-102
10614,1,1,657,1560,903
10615,0,0,1,0,-1
10616,0,0,201,0,-201
10617,1,0,98,0,-98
10618,1,1,319,1220,901
10619,1,0,23,0,-23
10620,1,1,70,1463,1393
10621,1,0,88,0,-88
10622,0,0,42,0,-42
10623,1,1,124,1298,1174
10624,1,0,32,0,-32
10625,0,0,62,0,-62
10626,1,0,45,0,-45
10627,0,0,96,0,-96
10628,0,0,1,0,-1
10629,0,0,18,0,-18
10630,0,0,19,0,-19
10631,1,1,134,2089,1955
10632,1,1,219,1234,1015
10633,1,0,66,0,-66
10634,1,0,1,0,-1
10635,1,1,289,1311,1022
10636,1,1,915,1600,685
10637,1,1,1058,2012,954
10638,0,0,106,0,-106
10639,0,0,40,0,-40
10640,1,0,28,0,-28
10641,0,0,5,0,-5
10642,1,0,6,0,-6
10643,1,1,407,1541,1134
10644,1,1,647,1764,1117
10645,0,0,42,0,-42
10646,1,1,1415,2584,1169
10647,1,1,113,1238,1125
10648,1,1,1036,1487,451
10649,1,0,35,0,-35
10650,1,0,16,0,-16
10651,1,1,432,1223,791
10652,0,0,58,0,-58
10653,1,0,103,0,-103
10654,1,1,1409,1352,-57
10655,1,1,176,1383,1207
10656,0,0,63,0,-63
10657,1,0,140,0,-140
10658,1,1,440,1584,1144
10659,1,1,59,3090,3031
10660,0,0,2,0,-2
10661,0,0,73,0,-73
10662,0,0,1,0,-1
10663,0,0,70,0,-70
10664,1,0,55,0,-55
10665,0,0,92,0,-92
10666,1,1,241,1448,1207
10667,1,1,822,1774,952
10668,0,0,24,0,-24
10669,0,0,8,0,-8
10670,1,0,154,0,-154
10671,1,0,76,0,-76
10672,1,0,141,0,-141
10673,1,0,129,0,-129
10674,1,0,42,0,-42
10675,0,0,93,0,-93
10676,1,1,212,2012,1800
10677,1,1,952,1929,977
10678,1,1,22,1242,1220
10679,1,1,220,1664,1444
10680,0,0,28,0,-28
10681,1,0,3,0,-3
10682,1,1,22,1466,1444
10683,1,0,1,0,-1
10684,1,1,366,1463,1097
10685,1,1,987,1374,387
10686,0,0,97,0,-97
10687,1,1,114,1216,1102
10688,1,1,189,1293,1104
10689,1,1,782,1587,805
10690,0,0,27,0,-27
10691,1,0,130,0,-130
10692,0,0,101,0,-101
10693,0,0,7,0,-7
10694,1,1,759,1719,960
10695,1,0,0,0,0
10696,0,0,54,0,-54
10697,1,1,1700,1781,81
10698,0,0,65,0,-65
10699,1,1,2101,1303,-798
10700,1,1,635,1281,646
10701,1,0,128,0,-128
10702,0,0,0,0,0
10703,0,0,36,0,-36
10704,0,0,53,0,-53
10705,1,1,1144,1431,287
10706,1,0,56,0,-56
10707,1,0,38,0,-38
10708,1,0,21,0,-21
10709,0,0,47,0,-47
10710,1,0,43,0,-43
10711,1,0,1,0,-1
10712,1,0,142,0,-142
10713,1,0,0,0,0
10714,1,1,550,1314,764
10715,0,0,95,0,-95
10716,0,0,15,0,-15
10717,0,0,18,0,-18
10718,1,1,56,1253,1197
10719,1,1,939,1772,833
10720,0,0,105,0,-105
10721,1,0,25,0,-25
10722,1,1,151,1619,1468
10723,1,0,164,0,-164
10724,0,0,64,0,-64
10725,1,0,77,0,-77
10726,0,0,56,0,-56
10727,0,0,1,0,-1
10728,0,0,134,0,-134
10729,0,0,10,0,-10
10730,1,0,14,0,-14
10731,0,0,196,0,-196
10732,1,1,632,1663,1031
10733,1,0,37,0,-37
10734,1,0,66,0,-66
10735,1,0,193,0,-193
10736,1,0,77,0,-77
10737,1,0,24,0,-24
10738,0,0,73,0,-73
10739,0,0,67,0,-67
10740,0,0,9,0,-9
10741,0,0,93,0,-93
10742,1,0,72,0,-72
10743,1,0,109,0,-109
10744,0,0,66,0,-66
10745,1,1,312,1376,1064
10746,1,0,14,0,-14
10747,0,0,59,0,-59
10748,1,0,44,0,-44
10749,1,1,1037,1534,497
10750,0,0,11,0,-11
10751,0,0,134,0,-134
10752,1,1,690,1291,601
10753,0,0,48,0,-48
10754,1,0,26,0,-26
10755,1,1,1259,1303,44
10756,1,1,517,1428,911
10757,0,0,27,0,-27
10758,0,0,43,0,-43
10759,1,1,806,1588,782
10760,0,0,7,0,-7
10761,1,1,940,2267,1327
10762,1,1,42,1270,1228
10763,0,0,11,0,-11
10764,1,0,10,0,-10
10765,1,0,37,0,-37
10766,1,1,374,1360,986
10767,1,0,81,0,-81
10768,1,1,84,1307,1223
10769,1,1,98,1581,1483
10770,0,0,224,0,-224
10771,0,0,9,0,-9
10772,1,1,598,1388,790
10773,1,1,507,4870,4363
10774,0,0,14,0,-14
10775,1,0,83,0,-83
10776,1,1,1124,1531,407
10777,0,0,0,0,0
10778,1,0,89,0,-89
10779,1,0,2,0,-2
10780,1,1,472,1558,1086
10781,1,0,6,0,-6
10782,1,0,100,0,-100
10783,1,0,25,0,-25
10784,1,1,309,1237,928
10785,0,0,45,0,-45
10786,1,0,11,0,-11
10787,1,1,116,1450,1334
10788,1,0,226,0,-226
10789,0,0,90,0,-90
10790,0,0,65,0,-65
10791,0,0,46,0,-46
10792,0,0,82,0,-82
10793,1,1,1224,1482,258
10794,1,0,36,0,-36
10795,1,1,716,1236,520
10796,1,1,209,1410,1201
10797,0,0,1,0,-1
10798,1,1,906,1367,461
10799,1,0,74,0,-74
10800,1,1,143,1230,1087
10801,1,0,192,0,-192
10802,0,0,101,0,-101
10803,1,0,129,0,-129
10804,1,0,16,0,-16
10805,0,0,27,0,-27
10806,1,1,240,1332,1092
10807,1,1,2289,1247,-1042
10808,0,0,3,0,-3
10809,1,1,829,1553,724
10810,1,0,3,0,-3
10811,1,1,103,2327,2224
10812,1,0,42,0,-42
10813,1,0,54,0,-54
10814,0,0,45,0,-45
10815,0,0,28,0,-28
10816,1,1,309,1393,1084
10817,1,1,1014,1206,192
10818,0,0,11,0,-11
10819,1,1,145,2822,2677
10820,0,0,0,0,0
10821,1,0,93,0,-93
10822,1,1,409,1666,1257
10823,1,1,370,1418,1048
10824,0,0,96,0,-96
10825,1,1,661,1284,623
10826,0,0,223,0,-223
10827,1,1,717,3479,2762
10828,0,0,25,0,-25
10829,0,0,17,0,-17
10830,1,0,39,0,-39
10831,0,0,54,0,-54
10832,1,1,1792,1361,-431
10833,1,1,550,2420,1870
10834,0,0,35,0,-35
10835,1,1,1024,1603,579
10836,1,1,1540,1272,-268
10837,0,0,17,0,-17
10838,0,0,77,0,-77
10839,1,0,15,0,-15
10840,1,0,8,0,-8
10841,1,0,127,0,-127
10842,1,0,24,0,-24
10843,0,0,11,0,-11
10844,1,1,57,1586,1529
10845,1,0,22,0,-22
10846,1,0,13,0,-13
10847,0,0,145,0,-145
10848,1,1,33,1332,1299
10849,0,0,6,0,-6
10850,1,1,2433,1322,-1111
10851,0,0,15,0,-15
10852,0,0,54,0,-54
10853,0,0,36,0,-36
10854,0,0,1,0,-1
10855,1,1,111,1803,1692
10856,0,0,14,0,-14
10857,0,0,11,0,-11
10858,1,1,196,2147,1951
10859,0,0,85,0,-85
10860,0,0,40,0,-40
10861,0,0,26,0,-26
10862,0,0,30,0,-30
10863,1,0,37,0,-37
10864,0,0,7,0,-7
10865,1,1,334,1465,1131
10866,0,0,12,0,-12
10867,1,0,46,0,-46
10868,0,0,35,0,-35
10869,1,0,39,0,-39
10870,0,0,20,0,-20
10871,1,0,10,0,-10
10872,1,0,7,0,-7
10873,1,0,30,0,-30
10874,0,0,23,0,-23
10875,1,0,5,0,-5
10876,0,0,32,0,-32
10877,0,0,91,0,-91
10878,0,0,38,0,-38
10879,1,1,1435,1212,-223
10880,1,1,101,1316,1215
10881,0,0,89,0,-89
10882,0,0,85,0,-85
10883,0,0,94,0,-94
10884,0,0,12,0,-12
10885,0,0,46,0,-46
10886,0,0,29,0,-29
10887,1,1,238,1629,1391
10888,0,0,17,0,-17
10889,1,1,46,1295,1249
10890,1,0,23,0,-23
10891,1,0,11,0,-11
10892,1,1,298,1373,1075
10893,1,1,1555,2048,493
10894,0,0,59,0,-59
10895,1,1,1006,1685,679
10896,1,0,31,0,-31
10897,1,1,620,1271,651
10898,0,0,0,0,0
10899,0,0,9,0,-9
10900,0,0,74,0,-74
10901,1,1,653,2124,1471
10902,1,0,20,0,-20
10903,1,1,274,1593,1319
10904,1,0,50,0,-50
10905,0,0,38,0,-38
10906,1,1,151,1613,1462
10907,1,1,100,1218,1118
10908,0,0,83,0,-83
10909,0,0,27,0,-27
10910,1,1,28,2312,2284
10911,0,0,41,0,-41
10912,0,0,40,0,-40
10913,1,0,43,0,-43
10914,0,0,3,0,-3
10915,1,0,187,0,-187
10916,1,1,463,1392,929
10917,1,0,55,0,-55
10918,1,1,889,1413,524
10919,1,0,31,0,-31
10920,0,0,108,0,-108
10921,1,1,176,1307,1131
10922,1,1,789,1527,738
10923,1,0,20,0,-20
10924,0,0,3,0,-3
10925,1,0,20,0,-20
10926,0,0,70,0,-70
10927,1,1,884,1319,435
10928,1,1,494,1399,905
10929,0,0,61,0,-61
10930,0,0,211,0,-211
10931,0,0,5,0,-5
10932,1,0,150,0,-150
10933,0,0,58,0,-58
10934,1,0,31,0,-31
10935,1,1,549,1519,970
10936,0,0,5,0,-5
10937,1,1,569,1696,1127
10938,1,1,198,1386,1188
10939,1,1,909,3833,2924
10940,1,0,64,0,-64
10941,0,0,2,0,-2
10942,0,0,4,0,-4
10943,0,0,22,0,-22
10944,1,0,66,0,-66
10945,1,1,84,1727,1643
10946,0,0,22,0,-22
10947,0,0,46,0,-46
10948,0,0,33,0,-33
10949,1,0,9,0,-9
10950,0,0,41,0,-41
10951,0,0,17,0,-17
10952,1,0,30,0,-30
10953,1,0,12,0,-12
10954,0,0,12,0,-12
10955,1,1,731,2250,1519
10956,1,0,106,0,-106
10957,1,1,203,1337,1134
10958,1,1,236,1280,1044
10959,1,1,195,1242,1047
10960,1,0,2,0,-2
10961,1,1,494,1536,1042
10962,0,0,59,0,-59
10963,0,0,9,0,-9
10964,1,0,76,0,-76
10965,1,0,50,0,-50
10966,0,0,65,0,-65
10967,1,0,9,0,-9
10968,1,0,18,0,-18
10969,0,0,2,0,-2
10970,0,0,115,0,-115
10971,0,0,86,0,-86
10972,0,0,23,0,-23
10973,0,0,21,0,-21
10974,1,1,348,1300,952
10975,1,0,53,0,-53
10976,0,0,87,0,-87
10977,0,0,114,0,-114
10978,0,0,21,0,-21
10979,0,0,58,0,-58
10980,1,0,44,0,-44
10981,0,0,15,0,-15
10982,1,1,50,1345,1295
10983,1,0,19,0,-19
10984,1,1,189,1201,1012
10985,1,0,20,0,-20
10986,0,0,10,0,-10
10987,0,0,19,0,-19
10988,1,0,69,0,-69
10989,1,0,86,0,-86
10990,1,1,90,1353,1263
10991,0,0,24,0,-24
10992,1,1,58,1943,1885
10993,1,1,152,1370,1218
10994,0,0,129,0,-129
10995,0,0,81,0,-81
10996,0,0,19,0,-19
10997,0,0,159,0,-159
10998,0,0,35,0,-35
10999,0,0,206,0,-206
11000,1,1,783,2100,1317
11001,0,0,14,0,-14
11002,1,1,315,1454,1139
11003,1,1,483,2590,2107
11004,1,1,29,1243,1214
11005,1,1,309,2468,2159
11006,1,0,86,0,-86
11007,1,0,53,0,-53
11008,0,0,25,0,-25
11009,0,0,12,0,-12
11010,1,1,429,1300,871
11011,0,0,9,0,-9
11012,0,0,4,0,-4
11013,1,0,79,0,-79
11014,1,0,4,0,-4
11015,0,0,114,0,-114
11016,0,0,3,0,-3
11017,1,0,175,0,-175
11018,1,1,190,1273,1083
11019,1,0,7,0,-7
11020,0,0,126,0,-126
11021,1,1,559,1220,661
11022,0,0,61,0,-61
11023,0,0,24,0,-24
11024,1,1,313,1247,934
11025,0,0,16,0,-16
11026,0,0,155,0,-155
11027,0,0,10,0,-10
11028,1,0,141,0,-141
11029,1,0,30,0,-30
11030,1,1,317,1537,1220
11031,1,1,602,1299,697
11032,0,0,42,0,-42
11033,0,0,47,0,-47
11034,0,0,96,0,-96
11035,1,1,111,1568,1457
11036,0,0,60,0,-60
11037,0,0,67,0,-67
11038,1,1,258,1355,1097
11039,0,0,39,0,-39
11040,0,0,66,0,-66
11041,1,0,160,0,-160
11042,1,1,317,1428,1111
11043,0,0,3,0,-3
11044,0,0,7,0,-7
11045,0,0,102,0,-102
11046,1,0,1,0,-1
11047,0,0,9,0,-9
11048,1,0,55,0,-55
11049,1,1,2001,1329,-672
11050,1,0,66,0,-66
11051,1,1,416,2224,1808
11052,0,0,156,0,-156
11053,0,0,15,0,-15
11054,0,0,55,0,-55
11055,1,0,20,0,-20
11056,1,0,26,0,-26
11057,1,1,392,2360,1968
11058,1,1,106,1341,1235
11059,1,0,80,0,-80
11060,1,1,867,1404,537
11061,0,0,44,0,-44
11062,0,0,21,0,-21
11063,1,1,849,1248,399
11064,0,0,26,0,-26
11065,1,0,241,0,-241
11066,0,0,23,0,-23
11067,1,0,77,0,-77
11068,0,0,160,0,-160
11069,1,0,258,0,-258
11070,1,1,550,1258,708
11071,1,0,66,0,-66
11072,1,0,22,0,-22
11073,1,0,12,0,-12
11074,1,1,711,1565,854
11075,0,0,43,0,-43
11076,1,1,627,1231,604
11077,1,1,311,1449,1138
11078,1,0,73,0,-73
11079,1,0,1,0,-1
11080,0,0,7,0,-7
11081,1,1,751,1444,693
11082,1,0,0,0,0
11083,1,1,176,1268,1092
11084,1,1,1255,1735,480
11085,1,1,1048,1313,265
11086,1,0,4,0,-4
11087,1,0,174,0,-174
11088,0,0,18,0,-18
11089,0,0,8,0,-8
11090,1,0,66,0,-66
11091,1,0,54,0,-54
11092,1,1,1890,1297,-593
11093,1,0,64,0,-64
11094,1,1,615,1421,806
11095,0,0,35,0,-35
11096,1,1,380,1833,1453
11097,0,0,21,0,-21
11098,1,0,65,0,-65
11099,1,1,149,1280,1131
11100,0,0,50,0,-50
11101,1,0,134,0,-134
11102,0,0,348,0,-348
11103,0,0,8,0,-8
11104,1,1,440,1443,1003
11105,1,1,540,1476,936
11106,1,1,496,2013,1517
11107,1,1,845,1273,428
11108,0,0,3,0,-3
11109,0,0,9,0,-9
11110,0,0,79,0,-79
11111,0,0,63,0,-63
11112,0,0,34,0,-34
11113,0,0,19,0,-19
11114,1,0,10,0,-10
11115,1,1,1015,1233,218
11116,1,1,76,1275,1199
11117,1,0,5,0,-5
11118,1,1,417,1260,843
11119,1,0,21,0,-21
11120,1,0,33,0,-33
11121,1,0,13,0,-13
11122,1,1,272,1287,1015
11123,0,0,13,0,-13
11124,1,0,61,0,-61
11125,0,0,20,0,-20
11126,0,0,16,0,-16
11127,0,0,12,0,-12
11128,1,0,34,0,-34
11129,1,1,724,1225,501
11130,1,0,30,0,-30
11131,0,0,43,0,-43
11132,1,0,223,0,-223
11133,1,0,53,0,-53
11134,1,0,18,0,-18
11135,0,0,266,0,-266
11136,1,0,87,0,-87
11137,1,1,806,1356,550
11138,1,0,0,0,0
11139,1,1,1393,1600,207
11140,1,0,8,0,-8
11141,1,1,405,1806,1401
11142,1,0,40,0,-40
11143,1,0,10,0,-10
11144,1,0,23,0,-23
11145,0,0,88,0,-88
11146,1,0,73,0,-73
11147,1,1,693,1459,766
11148,1,1,613,5626,5013
11149,0,0,61,0,-61
11150,0,0,86,0,-86
11151,1,1,170,1918,1748
11152,0,0,11,0,-11
11153,0,0,16,0,-16
11154,1,1,289,1229,940
11155,1,1,358,1696,1338
11156,1,1,20,1400,1380
11157,0,0,1,0,-1
11158,1,1,134,1212,1078
11159,1,0,40,0,-40
11160,0,0,15,0,-15
11161,0,0,44,0,-44
11162,1,0,13,0,-13
11163,0,0,48,0,-48
11164,0,0,195,0,-195
11165,1,0,2,0,-2
11166,1,1,503,1413,910
11167,0,0,38,0,-38
11168,1,0,57,0,-57
11169,0,0,42,0,-42
11170,1,1,1109,1201,92
11171,0,0,24,0,-24
11172,0,0,5,0,-5
11173,0,0,32,0,-32
11174,1,1,186,2899,2713
11175,0,0,48,0,-48
11176,1,0,94,0,-94
11177,1,1,368,1262,894
11178,0,0,40,0,-40
11179,1,1,1345,1236,-109
11180,1,1,314,1600,1286
11181,1,0,185,0,-185
11182,0,0,38,0,-38
11183,0,0,47,0,-47
11184,1,1,19,1511,1492
11185,0,0,72,0,-72
11186,1,1,656,1366,710
11187,1,1,107,2403,2296
11188,1,0,27,0,-27
11189,0,0,15,0,-15
11190,0,0,34,0,-34
11191,1,0,31,0,-31
11192,1,0,52,0,-52
11193,0,0,4,0,-4
11194,1,0,11,0,-11
11195,1,0,69,0,-69
11196,1,0,37,0,-37
11197,1,0,67,0,-67
11198,0,0,71,0,-71
11199,0,0,30,0,-30
11200,0,0,22,0,-22
11201,0,0,18,0,-18
11202,1,1,395,1382,987
11203,1,0,13,0,-13
11204,0,0,59,0,-59
11205,0,0,1,0,-1
11206,0,0,25,0,-25
11207,0,0,59,0,-59
11208,0,0,42,0,-42
11209,1,1,1025,1232,207
11210,0,0,67,0,-67
11211,0,0,54,0,-54
11212,1,1,133,1213,1080
11213,0,0,1,0,-1
11214,1,0,32,0,-32
11215,0,0,3,0,-3
11216,1,1,184,2414,2230
11217,0,0,27,0,-27
11218,1,1,163,2962,2799
11219,0,0,2,0,-2
11220,1,0,0,0,0
11221,1,1,266,1744,1478
11222,0,0,118,0,-118
11223,0,0,2,0,-2
11224,1,0,50,0,-50
11225,1,1,11,1588,1577
11226,1,1,951,1255,304
11227,1,1,555,1455,900
11228,1,1,114,1244,1130
11229,0,0,7,0,-7
11230,0,0,21,0,-21
11231,1,0,1,0,-1
11232,1,0,44,0,-44
11233,1,1,682,1258,576
11234,0,0,31,0,-31
11235,1,0,25,0,-25
11236,1,0,101,0,-101
11237,0,0,66,0,-66
11238,0,0,80,0,-80
11239,0,0,29,0,-29
11240,0,0,4,0,-4
11241,1,0,86,0,-86
11242,0,0,12,0,-12
11243,1,0,25,0,-25
11244,1,1,245,1690,1445
11245,1,0,2,0,-2
11246,1,0,36,0,-36
11247,0,0,19,0,-19
11248,1,1,258,1337,1079
11249,0,0,104,0,-104
11250,0,0,37,0,-37
11251,1,1,520,1475,955
11252,0,0,14,0,-14
11253,1,0,63,0,-63
11254,0,0,58,0,-58
11255,1,1,122,1229,1107
11256,1,1,63,1539,1476
11257,0,0,19,0,-19
11258,0,0,69,0,-69
11259,0,0,4,0,-4
11260,0,0,102,0,-102
11261,0,0,126,0,-126
11262,1,0,99,0,-99
11263,1,0,76,0,-76
11264,1,0,37,0,-37
11265,1,0,112,0,-112
11266,0,0,50,0,-50
11267,1,1,128,1410,1282
11268,1,1,152,2613,2461
11269,0,0,8,0,-8
11270,0,0,6,0,-6
11271,0,0,32,0,-32
11272,0,0,60,0,-60
11273,1,1,204,2136,1932
11274,0,0,54,0,-54
11275,1,1,774,1388,614
11276,1,0,82,0,-82
11277,0,0,8,0,-8
11278,1,1,201,2795,2594
11279,1,1,197,2475,2278
11280,0,0,31,0,-31
11281,0,0,51,0,-51
11282,1,1,182,1252,1070
11283,0,0,49,0,-49
11284,1,0,47,0,-47
11285,0,0,88,0,-88
11286,0,0,0,0,0
11287,0,0,121,0,-121
11288,1,1,699,1592,893
11289,1,1,611,1750,1139
11290,0,0,4,0,-4
11291,0,0,8,0,-8
11292,0,0,111,0,-111
11293,0,0,123,0,-123
11294,0,0,80,0,-80
11295,1,1,409,1571,1162
11296,1,0,0,0,0
11297,0,0,30,0,-30
11298,0,0,24,0,-24
11299,0,0,28,0,-28
11300,0,0,7,0,-7
11301,1,1,222,1377,1155
11302,1,1,944,1250,306
11303,0,0,11,0,-11
11304,0,0,16,0,-16
11305,0,0,27,0,-27
11306,0,0,46,0,-46
11307,1,0,12,0,-12
11308,0,0,40,0,-40
11309,1,0,153,0,-153
11310,1,1,563,1921,1358
11311,1,1,1374,1619,245
11312,0,0,31,0,-31
11313,1,0,95,0,-95
11314,0,0,7,0,-7
11315,0,0,22,0,-22
11316,1,1,858,1875,1017
11317,0,0,1,0,-1
11318,1,0,5,0,-5
11319,1,1,543,1263,720
11320,0,0,102,0,-102
11321,0,0,68,0,-68
11322,1,1,196,1366,1170
11323,0,0,71,0,-71
11324,0,0,8,0,-8
11325,1,0,28,0,-28
11326,1,1,134,1507,1373
11327,1,0,57,0,-57
11328,1,1,660,1580,920
11329,1,0,129,0,-129
11330,0,0,34,0,-34
11331,1,1,172,1242,1070
11332,0,0,4,0,-4
11333,1,0,3,0,-3
11334,0,0,36,0,-36
11335,0,0,21,0,-21
11336,1,1,204,1277,1073
11337,1,0,120,0,-120
11338,1,1,440,1237,797
11339,1,0,27,0,-27
11340,0,0,173,0,-173
11341,0,0,30,0,-30
11342,0,0,3,0,-3
11343,0,0,44,0,-44
11344,0,0,14,0,-14
11345,0,0,19,0,-19
11346,1,0,38,0,-38
11347,0,0,84,0,-84
11348,1,1,243,1238,995
11349,0,0,29,0,-29
11350,0,0,39,0,-39
11351,1,1,219,1213,994
11352,1,1,386,1323,937
11353,0,0,141,0,-141
11354,0,0,9,0,-9
11355,1,0,105,0,-105
11356,1,1,160,1222,1062
11357,1,1,315,1203,888
11358,1,0,26,0,-26
11359,0,0,6,0,-6
11360,1,1,282,1591,1309
11361,1,1,333,1413,1080
11362,1,1,91,2697,2606
11363,1,0,55,0,-55
11364,1,0,20,0,-20
11365,1,0,117,0,-117
11366,1,0,2,0,-2
11367,0,0,5,0,-5
11368,0,0,53,0,-53
11369,1,1,729,1380,651
11370,1,0,91,0,-91
11371,1,0,119,0,-119
11372,0,0,122,0,-122
11373,1,1,316,1495,1179
11374,1,0,153,0,-153
11375,1,1,824,1582,758
11376,0,0,25,0,-25
11377,1,0,13,0,-13
11378,0,0,32,0,-32
11379,0,0,41,0,-41
11380,1,0,96,0,-96
11381,0,0,19,0,-19
11382,1,1,453,1266,813
11383,1,1,1072,1651,579
11384,0,0,50,0,-50
11385,1,1,194,2125,1931
11386,1,1,370,1263,893
11387,1,1,179,1456,1277
11388,1,1,884,1437,553
11389,0,0,30,0,-30
11390,1,1,169,2302,2133
11391,0,0,13,0,-13
11392,0,0,59,0,-59
11393,0,0,119,0,-119
11394,0,0,7,0,-7
11395,0,0,110,0,-110
11396,1,0,74,0,-74
11397,1,1,2476,2010,-466
11398,1,0,21,0,-21
11399,1,0,18,0,-18
11400,0,0,277,0,-277
11401,0,0,14,0,-14
11402,1,1,886,1344,458
11403,1,0,6,0,-6
11404,1,0,29,0,-29
11405,1,1,846,1235,389
11406,1,1,22,1295,1273
11407,1,0,61,0,-61
11408,1,0,33,0,-33
11409,1,0,3,0,-3
11410,1,1,292,1295,1003
11411,1,0,32,0,-32
11412,0,0,64,0,-64
11413,1,1,335,1809,1474
11414,0,0,7,0,-7
11415,0,0,146,0,-146
11416,1,1,1502,1619,117
11417,0,0,74,0,-74
11418,1,1,181,1262,1081
11419,1,0,1,0,-1
11420,0,0,13,0,-13
11421,1,0,233,0,-233
11422,1,1,332,2533,2201
11423,1,0,173,0,-173
11424,0,0,9,0,-9
11425,1,0,238,0,-238
11426,1,0,26,0,-26
11427,1,0,29,0,-29
11428,1,0,0,0,0
11429,1,0,85,0,-85
11430,1,0,10,0,-10
11431,1,0,16,0,-16
11432,1,0,89,0,-89
11433,1,1,323,1334,1011
11434,1,0,4,0,-4
11435,1,0,17,0,-17
11436,1,1,236,1207,971
11437,1,0,110,0,-110
11438,1,1,151,1316,1165
11439,0,0,79,0,-79
11440,1,0,53,0,-53
11441,1,1,631,2467,1836
11442,0,0,99,0,-99
11443,0,0,81,0,-81
11444,1,1,112,1204,1092
11445,1,0,41,0,-41
11446,0,0,30,0,-30
11447,1,0,76,0,-76
11448,0,0,15,0,-15
11449,1,0,22,0,-22
11450,1,0,11,0,-11
11451,1,1,441,1373,932
11452,1,0,49,0,-49
11453,1,1,170,1262,1092
11454,0,0,98,0,-98
11455,0,0,3,0,-3
11456,0,0,65,0,-65
11457,1,1,1019,1805,786
11458,1,0,119,0,-119
11459,1,1,474,1345,871
11460,0,0,32,0,-32
11461,1,0,26,0,-26
11462,1,1,2020,2312,292
11463,0,0,14,0,-14
11464,0,0,20,0,-20
11465,1,1,259,1553,1294
11466,1,0,238,0,-238
11467,0,0,3,0,-3
11468,1,1,88,1280,1192
11469,0,0,0,0,0
11470,1,1,351,1506,1155
11471,1,0,133,0,-133
11472,0,0,124,0,-124
11473,0,0,95,0,-95
11474,0,0,3,0,-3
11475,1,0,16,0,-16
11476,0,0,15,0,-15
11477,1,0,101,0,-101
11478,1,0,21,0,-21
11479,0,0,15,0,-15
11480,1,1,694,1618,924
11481,1,1,105,1272,1167
11482,0,0,6,0,-6
11483,0,0,112,0,-112
11484,1,1,515,1222,707
11485,0,0,19,0,-19
11486,1,0,29,0,-29
11487,0,0,15,0,-15
11488,1,1,60,2158,2098
11489,0,0,10,0,-10
11490,1,0,61,0,-61
11491,1,1,626,1519,893
11492,0,0,64,0,-64
11493,1,0,19,0,-19
11494,1,1,302,1839,1537
11495,1,0,1,0,-1
11496,0,0,35,0,-35
11497,0,0,21,0,-21
11498,1,0,379,0,-379
11499,0,0,9,0,-9
11500,0,0,24,0,-24
11501,1,0,79,0,-79
11502,1,1,1435,1622,187
11503,1,0,86,0,-86
11504,1,1,73,1355,1282
11505,0,0,16,0,-16
11506,0,0,22,0,-22
11507,1,1,379,1356,977
11508,1,0,83,0,-83
11509,1,0,32,0,-32
11510,1,1,942,1994,1052
11511,0,0,78,0,-78
11512,1,1,10,1378,1368
11513,1,0,9,0,-9
11514,1,0,75,0,-75
11515,1,1,556,1385,829
11516,1,1,107,1927,1820
11517,1,1,1365,1307,-58
11518,1,1,1249,1275,26
11519,1,0,28,0,-28
11520,1,0,17,0,-17
11521,0,0,56,0,-56
11522,1,1,640,1866,1226
11523,0,0,7,0,-7
11524,0,0,47,0,-47
11525,1,0,49,0,-49
11526,1,0,18,0,-18
11527,1,0,23,0,-23
11528,1,1,308,1204,896
11529,0,0,8,0,-8
11530,0,0,34,0,-34
11531,1,0,22,0,-22
11532,0,0,22,0,-22
11533,0,0,26,0,-26
11534,0,0,3,0,-3
11535,0,0,41,0,-41
11536,1,0,18,0,-18
11537,0,0,5,0,-5
11538,1,1,721,2088,1367
11539,1,1,749,1292,543
11540,0,0,48,0,-48
11541,1,0,33,0,-33
11542,1,0,54,0,-54
11543,1,1,97,1222,1125
11544,1,0,12,0,-12
11545,0,0,47,0,-47
11546,0,0,29,0,-29
11547,1,0,6,0,-6
11548,0,0,14,0,-14
11549,1,1,407,1210,803
11550,0,0,129,0,-129
11551,0,0,13,0,-13
11552,0,0,14,0,-14
11553,0,0,69,0,-69
11554,1,0,5,0,-5
11555,1,0,0,0,0
11556,0,0,21,0,-21
11557,1,0,16,0,-16
11558,1,1,349,1472,1123
11559,0,0,109,0,-109
11560,1,0,39,0,-39
11561,1,1,781,1555,774
11562,1,1,775,1404,629
11563,1,0,23,0,-23
11564,0,0,30,0,-30
11565,0,0,11,0,-11
11566,1,1,1395,1992,597
11567,0,0,36,0,-36
11568,1,1,1458,2364,906
11569,0,0,177,0,-177
11570,1,0,25,0,-25
11571,1,0,8,0,-8
11572,1,1,1079,1349,270
11573,1,1,598,1272,674
11574,0,0,147,0,-147
11575,1,0,27,0,-27
11576,0,0,3,0,-3
11577,0,0,19,0,-19
11578,1,1,346,1413,1067
11579,0,0,40,0,-40
11580,1,0,4,0,-4
11581,1,1,202,1650,1448
11582,1,0,43,0,-43
11583,0,0,5,0,-5
11584,1,0,84,0,-84
11585,0,0,124,0,-124
11586,1,0,98,0,-98
11587,1,1,85,1303,1218
11588,1,0,3,0,-3
11589,0,0,76,0,-76
11590,1,1,101,1535,1434
11591,0,0,0,0,0
11592,1,0,38,0,-38
11593,1,1,50,1796,1746
11594,1,1,368,1523,1155
11595,0,0,83,0,-83
11596,1,1,218,1383,1165
11597,0,0,18,0,-18
11598,0,0,6,0,-6
11599,1,1,311,1856,1545
11600,1,0,152,0,-152
11601,0,0,100,0,-100
11602,0,0,6,0,-6
11603,0,0,28,0,-28
11604,1,1,32,1464,1432
11605,1,0,248,0,-248
11606,0,0,37,0,-37
11607,1,1,657,2290,1633
11608,0,0,6,0,-6
11609,0,0,110,0,-110
11610,1,0,156,0,-156
11611,1,1,93,1312,1219
11612,0,0,27,0,-27
11613,1,0,67,0,-67
11614,0,0,128,0,-128
11615,1,1,231,1417,1186
11616,0,0,72,0,-72
11617,1,1,101,1233,1132
11618,0,0,43,0,-43
11619,1,0,54,0,-54
11620,0,0,7,0,-7
11621,1,1,139,1501,1362
11622,1,0,75,0,-75
11623,0,0,76,0,-76
11624,0,0,229,0,-229
11625,1,0,9,0,-9
11626,1,0,44,0,-44
11627,0,0,22,0,-22
11628,1,1,667,1365,698
11629,1,1,67,1284,1217
11630,1,1,257,2950,2693
11631,1,0,61,0,-61
11632,0,0,46,0,-46
11633,1,1,261,2474,2213
11634,1,1,259,2172,1913
11635,1,1,185,1439,1254
11636,0,0,7,0,-7
11637,1,1,1547,1456,-91
11638,1,1,192,1281,1089
11639,1,1,685,1271,586
11640,1,0,2,0,-2
11641,1,1,607,1400,793
11642,0,0,51,0,-51
11643,0,0,50,0,-50
11644,1,1,139,1674,1535
11645,1,1,581,1307,726
11646,1,0,18,0,-18
11647,1,1,1207,1278,71
11648,0,0,54,0,-54
11649,0,0,78,0,-78
11650,1,1,127,1230,1103
11651,0,0,90,0,-90
11652,0,0,38,0,-38
11653,1,0,131,0,-131
11654,0,0,14,0,-14
11655,1,1,723,1342,619
11656,1,1,593,1228,635
11657,1,1,176,1547,1371
11658,1,0,4,0,-4
11659,1,0,39,0,-39
11660,0,0,37,0,-37
11661,0,0,31,0,-31
11662,0,0,26,0,-26
11663,1,1,237,1336,1099
11664,1,0,16,0,-16
11665,0,0,13,0,-13
11666,1,1,100,1297,1197
11667,1,1,283,2480,2197
11668,0,0,107,0,-107
11669,0,0,91,0,-91
11670,1,1,300,1722,1422
11671,1,1,221,1594,1373
11672,1,1,638,1546,908
11673,1,0,38,0,-38
11674,0,0,31,0,-31
11675,0,0,53,0,-53
11676,0,0,30,0,-30
11677,1,0,9,0,-9
11678,0,0,5,0,-5
11679,0,0,192,0,-192
11680,1,1,728,1253,525
11681,0,0,17,0,-17
11682,1,0,29,0,-29
11683,1,0,69,0,-69
11684,0,0,42,0,-42
11685,0,0,149,0,-149
11686,0,0,13,0,-13
11687,1,0,0,0,0
11688,0,0,20,0,-20
11689,0,0,138,0,-138
11690,0,0,77,0,-77
11691,1,0,34,0,-34
11692,1,1,1122,1216,94
11693,1,1,118,2954,2836
11694,1,0,64,0,-64
11695,1,1,1251,1280,29
11696,1,1,312,1455,1143
11697,0,0,61,0,-61
11698,1,0,15,0,-15
11699,0,0,2,0,-2
11700,1,0,66,0,-66
11701,0,0,2,0,-2
11702,1,1,1281,1355,74
11703,0,0,44,0,-44
11704,1,1,1940,1369,-571
11705,0,0,96,0,-96
11706,1,0,123,0,-123
11707,1,0,55,0,-55
11708,1,0,5,0,-5
11709,1,1,1146,1295,149
11710,0,0,7,0,-7
11711,1,1,322,1357,1035
11712,0,0,3,0,-3
11713,1,1,441,1291,850
11714,0,0,23,0,-23
11715,1,1,123,1315,1192
11716,1,0,18,0,-18
11717,1,0,26,0,-26
11718,1,0,70,0,-70
11719,1,1,25,1758,1733
11720,1,1,165,1818,1653
11721,1,1,354,1438,1084
11722,1,0,20,0,-20
11723,1,0,82,0,-82
11724,1,1,256,1305,1049
11725,1,1,370,1469,1099
11726,0,0,40,0,-40
11727,0,0,43,0,-43
11728,1,1,512,3325,2813
11729,1,0,70,0,-70
11730,0,0,19,0,-19
11731,0,0,3,0,-3
11732,1,0,48,0,-48
11733,1,0,22,0,-22
11734,1,0,5,0,-5
11735,1,0,49,0,-49
11736,1,1,417,1524,1107
11737,1,0,13,0,-13
11738,0,0,70,0,-70
11739,0,0,6,0,-6
11740,1,1,803,1467,664
11741,1,1,159,1585,1426
11742,0,0,15,0,-15
11743,1,1,326,1672,1346
11744,0,0,16,0,-16
11745,1,1,180,1264,1084
11746,1,1,453,1251,798
11747,1,0,14,0,-14
11748,1,1,228,1465,1237
11749,1,0,23,0,-23
11750,1,1,322,1260,938
11751,1,0,8,0,-8
11752,1,1,794,1356,562
11753,1,0,35,0,-35
11754,1,1,359,1405,1046
11755,1,0,2,0,-2
11756,1,1,488,1259,771
11757,1,1,395,1534,1139
11758,1,1,471,1413,942
11759,0,0,153,0,-153
11760,0,0,65,0,-65
11761,0,0,63,0,-63
11762,0,0,65,0,-65
11763,0,0,7,0,-7
11764,1,0,21,0,-21
11765,0,0,83,0,-83
11766,1,0,39,0,-39
11767,1,1,1292,1271,-21
11768,1,0,1,0,-1
11769,1,0,18,0,-18
11770,1,0,46,0,-46
11771,1,0,12,0,-12
11772,1,0,163,0,-163
11773,1,0,106,0,-106
11774,0,0,20,0,-20
11775,0,0,68,0,-68
11776,0,0,2,0,-2
11777,1,0,29,0,-29
11778,1,0,186,0,-186
11779,1,1,239,2150,1911
11780,1,1,458,2447,1989
11781,1,1,150,1292,1142
11782,1,1,82,1207,1125
11783,1,1,738,2212,1474
11784,0,0,59,0,-59
11785,0,0,37,0,-37
11786,0,0,23,0,-23
11787,1,1,225,1615,1390
11788,1,0,6,0,-6
11789,0,0,8,0,-8
11790,1,0,68,0,-68
11791,1,0,6,0,-6
11792,1,1,546,1231,685
11793,0,0,47,0,-47
11794,1,1,827,1327,500
11795,1,0,50,0,-50
11796,0,0,19,0,-19
11797,1,0,25,0,-25
11798,1,1,583,1341,758
11799,1,0,31,0,-31
11800,0,0,53,0,-53
11801,1,0,109,0,-109
11802,1,1,293,1408,1115
11803,1,0,134,0,-134
11804,1,1,1526,2708,1182
11805,1,0,29,0,-29
11806,0,0,73,0,-73
11807,1,0,2,0,-2
11808,1,0,1,0,-1
11809,0,0,123,0,-123
11810,0,0,72,0,-72
11811,0,0,16,0,-16
11812,1,1,596,1724,1128
11813,0,0,89,0,-89
11814,1,1,421,1439,1018
11815,1,1,278,1269,991
11816,1,0,74,0,-74
11817,1,1,92,2288,2196
11818,1,1,936,1832,896
11819,1,0,133,0,-133
11820,0,0,12,0,-12
11821,1,0,28,0,-28
11822,0,0,18,0,-18
11823,1,0,29,0,-29
11824,1,1,26,1303,1277
11825,0,0,75,0,-75
11826,0,0,7,0,-7
11827,0,0,38,0,-38
11828,1,1,786,1213,427
11829,1,1,761,1627,866
11830,0,0,96,0,-96
11831,1,0,4,0,-4
11832,1,0,45,0,-45
11833,0,0,85,0,-85
11834,1,0,30,0,-30
11835,1,1,431,1268,837
11836,0,0,21,0,-21
11837,1,0,29,0,-29
11838,1,1,561,2017,1456
11839,1,1,577,1252,675
11840,0,0,2,0,-2
11841,1,1,2003,1782,-221
11842,0,0,145,0,-145
11843,1,0,24,0,-24
11844,1,1,630,1501,871
11845,1,0,13,0,-13
11846,1,1,185,1796,1611
11847,0,0,52,0,-52
11848,1,0,13,0,-13
11849,1,1,372,1919,1547
11850,0,0,22,0,-22
11851,1,0,25,0,-25
11852,1,0,231,0,-231
11853,1,1,427,1374,947
11854,1,1,1631,2042,411
11855,1,0,89,0,-89
11856,1,1,394,1354,960
11857,0,0,300,0,-300
11858,0,0,122,0,-122
11859,1,0,12,0,-12
11860,0,0,65,0,-65
11861,0,0,12,0,-12
11862,0,0,57,0,-57
11863,1,1,402,1392,990
11864,0,0,73,0,-73
11865,1,0,75,0,-75
11866,1,0,129,0,-129
11867,0,0,34,0,-34
11868,0,0,20,0,-20
11869,1,0,62,0,-62
11870,1,0,15,0,-15
11871,0,0,47,0,-47
11872,1,0,15,0,-15
11873,1,0,97,0,-97
11874,1,0,53,0,-53
11875,1,1,1303,1756,453
11876,0,0,38,0,-38
11877,1,1,75,1795,1720
11878,0,0,42,0,-42
11879,1,1,533,1282,749
11880,1,1,464,2355,1891
11881,1,1,228,1250,1022
11882,1,1,308,1647,1339
11883,1,1,228,1349,1121
11884,0,0,20,0,-20
11885,1,1,185,1576,1391
11886,1,1,658,1333,675
11887,0,0,49,0,-49
11888,1,1,151,1265,1114
11889,1,1,890,1245,355
11890,1,1,369,1330,961
11891,1,1,53,2489,2436
11892,1,0,74,0,-74
11893,1,1,1160,1842,682
11894,1,0,47,0,-47
11895,0,0,19,0,-19
11896,0,0,41,0,-41
11897,1,0,176,0,-176
11898,1,1,1248,1702,454
11899,1,0,110,0,-110
11900,0,0,20,0,-20
11901,1,1,249,1288,1039
11902,1,0,20,0,-20
11903,1,1,309,1236,927
11904,0,0,55,0,-55
11905,1,1,538,1323,785
11906,1,1,23,1356,1333
11907,1,1,713,1289,576
11908,0,0,71,0,-71
11909,1,1,847,1520,673
11910,1,0,2,0,-2
11911,0,0,22,0,-22
11912,0,0,46,0,-46
11913,1,1,88,2331,2243
11914,1,0,147,0,-147
11915,0,0,93,0,-93
11916,1,0,62,0,-62
11917,1,1,401,1227,826
11918,1,0,34,0,-34
11919,0,0,91,0,-91
11920,0,0,2,0,-2
11921,0,0,339,0,-339
11922,1,0,16,0,-16
11923,1,1,1161,1463,302
11924,0,0,209,0,-209
11925,0,0,44,0,-44
11926,1,1,549,1453,904
11927,1,0,30,0,-30
11928,0,0,103,0,-103
11929,0,0,37,0,-37
11930,1,0,69,0,-69
11931,1,0,294,0,-294
11932,1,1,229,1323,1094
11933,1,0,47,0,-47
11934,0,0,5,0,-5
11935,1,1,294,1677,1383
11936,1,1,165,2105,1940
11937,1,1,428,1252,824
11938,0,0,3,0,-3
11939,1,0,40,0,-40
11940,0,0,39,0,-39
11941,1,0,33,0,-33
11942,0,0,20,0,-20
11943,1,0,16,0,-16
11944,0,0,17,0,-17
11945,1,0,45,0,-45
11946,1,0,196,0,-196
11947,0,0,1,0,-1
11948,1,0,5,0,-5
11949,0,0,45,0,-45
11950,0,0,30,0,-30
11951,1,1,1121,1464,343
11952,0,0,112,0,-112
11953,1,1,243,1633,1390
11954,1,1,65,1562,1497
11955,1,1,81,1655,1574
11956,0,0,51,0,-51
11957,0,0,27,0,-27
11958,1,1,272,1987,1715
11959,1,0,58,0,-58
11960,1,1,656,1216,560
11961,0,0,82,0,-82
11962,1,1,232,1303,1071
11963,1,1,49,1457,1408
11964,1,1,250,2170,1920
11965,1,0,38,0,-38
11966,1,0,47,0,-47
11967,0,0,35,0,-35
11968,1,0,13,0,-13
11969,1,0,25,0,-25
11970,1,0,8,0,-8
11971,0,0,78,0,-78
11972,1,0,31,0,-31
11973,1,1,228,1542,1314
11974,0,0,7,0,-7
11975,0,0,13,0,-13
11976,1,1,141,1497,1356
11977,1,0,20,0,-20
11978,0,0,89,0,-89
11979,1,0,67,0,-67
11980,1,1,306,1211,905
11981,1,0,1,0,-1
11982,1,0,30,0,-30
11983,0,0,223,0,-223
11984,1,0,70,0,-70
11985,1,0,97,0,-97
11986,1,1,475,1891,1416
11987,1,1,105,1314,1209
11988,0,0,39,0,-39
11989,1,1,141,1348,1207
11990,0,0,83,0,-83
11991,0,0,3,0,-3
11992,1,0,10,0,-10
11993,1,1,471,1399,928
11994,1,0,197,0,-197
11995,1,0,14,0,-14
11996,1,1,311,1309,998
11997,1,1,422,2198,1776
11998,1,1,267,1284,1017
11999,0,0,133,0,-133
12000,1,0,9,0,-9
12001,1,0,12,0,-12
12002,1,1,142,1383,1241
12003,1,1,1826,2988,1162
12004,0,0,200,0,-200
12005,1,1,243,1418,1175
12006,1,0,57,0,-57
12007,1,0,2,0,-2
12008,1,1,1869,3222,1353
12009,1,1,197,3302,3105
12010,0,0,98,0,-98
12011,1,0,43,0,-43
12012,1,1,950,1405,455
12013,0,0,53,0,-53
12014,1,1,146,1733,1587
12015,0,0,31,0,-31
12016,0,0,19,0,-19
12017,1,1,405,1581,1176
12018,1,0,101,0,-101
12019,0,0,28,0,-28
12020,1,1,347,1256,909
12021,1,0,22,0,-22
12022,1,1,306,1216,910
12023,0,0,6,0,-6
12024,1,1,149,1443,1294
12025,0,0,39,0,-39
12026,0,0,5,0,-5
12027,1,1,1543,1893,350
12028,0,0,23,0,-23
12029,1,1,77,1644,1567
12030,0,0,47,0,-47
12031,1,0,44,0,-44
12032,1,1,2092,1216,-876
12033,1,0,61,0,-61
12034,0,0,35,0,-35
12035,0,0,3,0,-3
12036,0,0,2,0,-2
12037,0,0,32,0,-32
12038,0,0,54,0,-54
12039,1,1,469,7117,6648
12040,0,0,172,0,-172
12041,0,0,36,0,-36
12042,0,0,16,0,-16
12043,1,0,137,0,-137
12044,0,0,0,0,0
12045,1,0,78,0,-78
12046,1,0,17,0,-17
12047,1,1,138,1668,1530
12048,1,1,352,1282,930
12049,1,0,52,0,-52
12050,1,1,250,1356,1106
12051,0,0,16,0,-16
12052,0,0,5,0,-5
12053,1,1,162,1442,1280
12054,0,0,46,0,-46
12055,0,0,100,0,-100
12056,1,0,16,0,-16
12057,1,1,1022,1576,554
12058,1,0,11,0,-11
12059,1,1,1424,1434,10
12060,1,1,439,1310,871
12061,0,0,54,0,-54
12062,1,1,47,1381,1334
12063,1,1,142,1411,1269
12064,1,1,238,1217,979
12065,0,0,10,0,-10
12066,1,1,1214,1679,465
12067,0,0,12,0,-12
12068,0,0,102,0,-102
12069,0,0,31,0,-31
12070,0,0,37,0,-37
12071,1,1,147,1300,1153
12072,1,0,9,0,-9
12073,1,1,6,1480,1474
12074,1,1,1193,1206,13
12075,1,0,250,0,-250
12076,1,1,123,2306,2183
12077,1,0,18,0,-18
12078,0,0,8,0,-8
12079,1,1,158,1884,1726
12080,0,0,69,0,-69
12081,1,0,16,0,-16
12082,0,0,81,0,-81
12083,1,1,123,1230,1107
12084,0,0,4,0,-4
12085,0,0,7,0,-7
12086,1,0,103,0,-103
12087,1,1,655,1602,947
12088,0,0,11,0,-11
12089,1,0,17,0,-17
12090,0,0,63,0,-63
12091,1,1,1625,1609,-16
12092,1,0,2,0,-2
12093,0,0,16,0,-16
12094,0,0,31,0,-31
12095,0,0,19,0,-19
12096,1,0,2,0,-2
12097,1,1,531,1552,1021
12098,1,0,164,0,-164
12099,1,0,39,0,-39
12100,1,1,156,1368,1212
12101,1,0,45,0,-45
12102,0,0,7,0,-7
12103,0,0,38,0,-38
12104,1,1,183,1256,1073
12105,1,1,385,1614,1229
12106,0,0,102,0,-102
12107,1,0,4,0,-4
12108,0,0,0,0,0
12109,1,1,805,1671,866
12110,1,1,189,1522,1333
12111,0,0,14,0,-14
12112,1,1,900,1253,353
12113,0,0,33,0,-33
12114,1,1,57,1398,1341
12115,0,0,11,0,-11
12116,0,0,55,0,-55
12117,1,1,530,1748,1218
12118,0,0,15,0,-15
12119,0,0,83,0,-83
12120,1,0,35,0,-35
12121,1,0,126,0,-126
12122,1,1,1547,1454,-93
12123,1,0,23,0,-23
12124,1,1,1686,1296,-390
12125,1,1,415,1358,943
12126,1,0,83,0,-83
12127,1,1,122,2135,2013
12128,0,0,191,0,-191
12129,1,0,22,0,-22
12130,1,1,365,1267,902
12131,1,1,699,1585,886
12132,1,0,168,0,-168
12133,1,1,1128,1481,353
12134,1,1,523,1517,994
12135,1,0,197,0,-197
12136,1,1,71,1389,1318
12137,1,0,105,0,-105
12138,1,0,84,0,-84
12139,1,1,314,1324,1010
12140,0,0,148,0,-148
12141,1,1,8,1989,1981
12142,0,0,215,0,-215
12143,0,0,5,0,-5
12144,0,0,6,0,-6
12145,1,0,14,0,-14
12146,0,0,71,0,-71
12147,1,0,23,0,-23
12148,1,1,442,1514,1072
12149,1,0,37,0,-37
12150,1,0,114,0,-114
12151,0,0,106,0,-106
12152,1,0,169,0,-169
12153,0,0,96,0,-96
12154,0,0,5,0,-5
12155,0,0,58,0,-58
12156,0,0,31,0,-31
12157,1,1,294,1411,1117
12158,1,1,49,1270,1221
12159,0,0,248,0,-248
12160,0,0,21,0,-21
12161,1,1,1097,1397,300
12162,0,0,42,0,-42
12163,1,1,150,1408,1258
12164,0,0,236,0,-236
12165,1,1,743,1302,559
12166,1,0,61,0,-61
12167,0,0,124,0,-124
12168,1,0,39,0,-39
12169,1,0,11,0,-11
12170,0,0,160,0,-160
12171,1,1,194,1606,1412
12172,0,0,53,0,-53
12173,1,1,198,1211,1013
12174,0,0,3,0,-3
12175,1,1,541,1854,1313
12176,1,1,1107,1252,145
12177,0,0,142,0,-142
12178,1,1,128,1248,1120
12179,1,1,270,1438,1168
12180,0,0,18,0,-18
12181,1,1,189,1942,1753
12182,1,1,9,1918,1909
12183,0,0,62,0,-62
12184,0,0,3,0,-3
12185,0,0,71,0,-71
12186,1,1,245,1444,1199
12187,0,0,4,0,-4
12188,1,1,664,1244,580
12189,1,1,381,1324,943
12190,1,0,40,0,-40
12191,1,1,147,1260,1113
12192,1,0,13,0,-13
12193,1,1,426,1509,1083
12194,0,0,34,0,-34
12195,0,0,20,0,-20
12196,0,0,7,0,-7
12197,1,0,117,0,-117
12198,1,1,101,1205,1104
12199,0,0,0,0,0
12200,1,1,1016,1490,474
12201,1,1,986,1539,553
12202,1,0,11,0,-11
12203,0,0,22,0,-22
12204,0,0,6,0,-6
12205,0,0,100,0,-100
12206,1,0,82,0,-82
12207,0,0,149,0,-149
12208,1,1,272,1562,1290
12209,0,0,80,0,-80
12210,1,1,179,1511,1332
12211,1,1,483,1244,761
12212,1,1,491,1763,1272
12213,0,0,21,0,-21
12214,0,0,31,0,-31
12215,1,0,19,0,-19
12216,0,0,13,0,-13
12217,1,0,15,0,-15
12218,0,0,242,0,-242
12219,1,1,56,1532,1476
12220,1,0,2,0,-2
12221,0,0,49,0,-49
12222,1,0,166,0,-166
12223,0,0,38,0,-38
12224,1,1,142,1305,1163
12225,0,0,9,0,-9
12226,0,0,58,0,-58
12227,0,0,42,0,-42
12228,1,1,50,1540,1490
12229,1,1,89,6922,6833
12230,0,0,64,0,-64
12231,0,0,54,0,-54
12232,0,0,14,0,-14
12233,1,1,786,1259,473
12234,1,0,0,0,0
12235,1,0,86,0,-86
12236,1,0,146,0,-146
12237,0,0,22,0,-22
12238,0,0,17,0,-17
12239,1,0,31,0,-31
12240,1,1,1472,1333,-139
12241,1,1,331,1379,1048
12242,0,0,18,0,-18
12243,1,0,50,0,-50
12244,1,0,28,0,-28
12245,1,0,72,0,-72
12246,0,0,41,0,-41
12247,0,0,38,0,-38
12248,0,0,48,0,-48
12249,0,0,85,0,-85
12250,1,1,82,1325,1243
12251,1,1,139,2632,2493
12252,1,0,141,0,-141
12253,1,0,95,0,-95
12254,1,0,29,0,-29
12255,0,0,23,0,-23
12256,1,1,453,1949,1496
12257,1,1,518,1315,797
12258,0,0,10,0,-10
12259,1,0,43,0,-43
12260,0,0,7,0,-7
12261,0,0,30,0,-30
12262,0,0,8,0,-8
12263,1,0,146,0,-146
12264,0,0,133,0,-133
12265,1,0,50,0,-50
12266,1,0,18,0,-18
12267,1,1,636,1425,789
12268,1,0,94,0,-94
12269,1,1,718,1364,646
12270,1,1,104,1202,1098
12271,1,1,353,1831,1478
12272,1,0,154,0,-154
12273,0,0,1,0,-1
12274,1,0,10,0,-10
12275,0,0,15,0,-15
12276,1,1,752,1742,990
12277,0,0,8,0,-8
12278,1,0,75,0,-75
12279,1,0,73,0,-73
12280,0,0,15,0,-15
12281,1,0,20,0,-20
12282,0,0,245,0,-245
12283,1,0,9,0,-9
12284,1,1,1337,1997,660
12285,0,0,7,0,-7
12286,1,1,1208,1389,181
12287,0,0,10,0,-10
12288,0,0,29,0,-29
12289,0,0,30,0,-30
12290,1,1,770,1977,1207
12291,1,0,8,0,-8
12292,1,0,5,0,-5
12293,1,0,2,0,-2
12294,0,0,120,0,-120
12295,0,0,20,0,-20
12296,1,0,118,0,-118
12297,1,0,6,0,-6
12298,1,1,47,3406,3359
12299,1,1,644,1376,732
12300,1,0,27,0,-27
12301,1,1,95,1670,1575
12302,0,0,133,0,-133
12303,0,0,31,0,-31
12304,1,0,58,0,-58
12305,1,0,57,0,-57
12306,1,0,54,0,-54
12307,1,0,28,0,-28
12308,0,0,9,0,-9
12309,1,1,326,1311,985
12310,0,0,11,0,-11
12311,1,0,10,0,-10
12312,1,0,31,0,-31
12313,1,1,156,1579,1423
12314,1,0,98,0,-98
12315,1,0,23,0,-23
12316,0,0,42,0,-42
12317,1,1,793,1848,1055
12318,0,0,31,0,-31
12319,0,0,10,0,-10
12320,1,0,1,0,-1
12321,1,1,372,1403,1031
12322,0,0,24,0,-24
12323,1,0,90,0,-90
12324,0,0,38,0,-38
12325,1,0,29,0,-29
12326,0,0,160,0,-160
12327,0,0,83,0,-83
12328,0,0,4,0,-4
12329,1,1,70,2152,2082
12330,1,0,15,0,-15
12331,0,0,30,0,-30
12332,1,1,335,1370,1035
12333,1,0,4,0,-4
12334,0,0,0,0,0
12335,0,0,63,0,-63
12336,1,0,196,0,-196
12337,1,1,2423,1336,-1087
12338,0,0,70,0,-70
12339,1,1,269,1300,1031
12340,0,0,7,0,-7
12341,0,0,3,0,-3
12342,1,1,678,1220,542
12343,1,0,23,0,-23
12344,0,0,26,0,-26
12345,1,0,32,0,-32
12346,0,0,8,0,-8
12347,0,0,0,0,0
12348,1,1,317,1632,1315
12349,1,0,39,0,-39
12350,1,1,1416,1228,-188
12351,1,1,222,1872,1650
12352,1,0,2,0,-2
12353,0,0,63,0,-63
12354,0,0,16,0,-16
12355,1,1,262,1400,1138
12356,1,0,144,0,-144
12357,1,0,75,0,-75
12358,1,0,94,0,-94
12359,1,1,176,1714,1538
12360,0,0,32,0,-32
12361,1,0,9,0,-9
12362,0,0,13,0,-13
12363,1,0,17,0,-17
12364,0,0,127,0,-127
12365,1,0,86,0,-86
12366,0,0,8,0,-8
12367,1,1,244,1340,1096
12368,0,0,24,0,-24
12369,1,1,266,1402,1136
12370,0,0,3,0,-3
12371,0,0,97,0,-97
12372,0,0,5,0,-5
12373,1,1,417,1592,1175
12374,1,0,60,0,-60
12375,1,1,42,1471,1429
12376,1,0,59,0,-59
12377,0,0,41,0,-41
12378,0,0,4,0,-4
12379,1,0,89,0,-89
12380,0,0,21,0,-21
12381,0,0,28,0,-28
12382,1,0,71,0,-71
12383,1,1,181,1288,1107
12384,1,1,1067,1241,174
12385,1,1,51,1335,1284
12386,1,1,494,2113,1619
12387,1,0,38,0,-38
12388,1,1,105,1441,1336
12389,0,0,105,0,-105
12390,0,0,30,0,-30
12391,0,0,4,0,-4
12392,0,0,15,0,-15
12393,0,0,31,0,-31
12394,0,0,1,0,-1
12395,0,0,12,0,-12
12396,1,1,164,1303,1139
12397,1,0,86,0,-86
12398,1,0,91,0,-91
12399,1,1,1429,1515,86
12400,0,0,14,0,-14
12401,0,0,5,0,-5
12402,1,1,513,2745,2232
12403,1,0,52,0,-52
12404,0,0,229,0,-229
12405,0,0,8,0,-8
12406,0,0,30,0,-30
12407,0,0,38,0,-38
12408,0,0,4,0,-4
12409,1,1,970,1540,570
12410,0,0,86,0,-86
12411,1,0,25,0,-25
12412,1,1,91,1763,1672
12413,0,0,52,0,-52
12414,0,0,26,0,-26
12415,0,0,24,0,-24
12416,0,0,23,0,-23
12417,1,1,223,1220,997
12418,1,1,1944,1347,-597
12419,0,0,21,0,-21
12420,0,0,26,0,-26
12421,1,0,58,0,-58
12422,0,0,1,0,-1
12423,0,0,23,0,-23
12424,0,0,7,0,-7
12425,0,0,6,0,-6
12426,1,1,114,1547,1433
12427,1,1,222,1444,1222
12428,0,0,1,0,-1
12429,0,0,2,0,-2
12430,0,0,20,0,-20
12431,1,1,157,1464,1307
12432,1,0,78,0,-78
12433,1,0,39,0,-39
12434,1,0,29,0,-29
12435,1,0,23,0,-23
12436,0,0,3,0,-3
12437,1,1,108,1264,1156
12438,0,0,2,0,-2
12439,0,0,5,0,-5
12440,1,0,40,0,-40
12441,0,0,127,0,-127
12442,0,0,164,0,-164
12443,1,0,55,0,-55
12444,1,0,10,0,-10
12445,0,0,7,0,-7
12446,0,0,60,0,-60
12447,1,1,33,1215,1182
12448,0,0,13,0,-13
12449,1,1,494,1305,811
12450,0,0,45,0,-45
12451,1,1,299,1350,1051
12452,1,1,166,1386,1220
12453,0,0,218,0,-218
12454,0,0,15,0,-15
12455,0,0,34,0,-34
12456,0,0,2,0,-2
12457,0,0,1,0,-1
12458,1,0,19,0,-19
12459,0,0,37,0,-37
12460,1,0,26,0,-26
12461,1,1,126,1206,1080
12462,1,0,84,0,-84
12463,1,1,1170,2260,1090
12464,0,0,2,0,-2
12465,0,0,2,0,-2
12466,0,0,0,0,0
12467,1,1,422,1403,981
12468,1,1,1594,1774,180
12469,1,0,54,0,-54
12470,1,0,106,0,-106
12471,1,1,257,1292,1035
12472,0,0,53,0,-53
12473,1,1,272,1474,1202
12474,1,1,202,1752,1550
12475,1,1,423,2937,2514
12476,1,1,103,1819,1716
12477,1,1,837,1218,381
12478,1,0,14,0,-14
12479,0,0,7,0,-7
12480,1,0,3,0,-3
12481,1,1,328,3155,2827
12482,0,0,24,0,-24
12483,0,0,50,0,-50
12484,0,0,249,0,-249
12485,1,1,180,1278,1098
12486,0,0,79,0,-79
12487,1,1,2023,1342,-681
12488,0,0,5,0,-5
12489,1,0,14,0,-14
12490,1,1,1076,1513,437
12491,1,1,167,1581,1414
12492,1,1,434,1350,916
12493,0,0,50,0,-50
12494,1,0,48,0,-48
12495,1,1,140,1630,1490
12496,1,1,605,1703,1098
12497,1,1,468,2586,2118
12498,0,0,0,0,0
12499,0,0,108,0,-108
12500,0,0,243,0,-243
12501,0,0,51,0,-51
12502,1,0,3,0,-3
12503,1,1,387,1395,1008
12504,0,0,86,0,-86
12505,0,0,2,0,-2
12506,1,1,552,1233,681
12507,0,0,1,0,-1
12508,0,0,22,0,-22
12509,0,0,21,0,-21
12510,1,1,26,1256,1230
12511,1,0,39,0,-39
12512,0,0,0,0,0
12513,1,0,109,0,-109
12514,1,0,120,0,-120
12515,1,1,406,1408,1002
12516,1,0,15,0,-15
12517,1,1,390,1406,1016
12518,1,0,181,0,-181
12519,1,0,56,0,-56
12520,0,0,142,0,-142
12521,0,0,8,0,-8
12522,0,0,26,0,-26
12523,1,0,4,0,-4
12524,0,0,87,0,-87
12525,1,0,7,0,-7
12526,0,0,10,0,-10
12527,1,1,359,1232,873
12528,0,0,53,0,-53
12529,1,1,112,3789,3677
12530,1,0,31,0,-31
12531,0,0,55,0,-55
12532,0,0,26,0,-26
12533,0,0,19,0,-19
12534,1,0,79,0,-79
12535,1,0,73,0,-73
12536,1,0,149,0,-149
12537,1,0,12,0,-12
12538,1,1,206,1502,1296
12539,1,0,2,0,-2
12540,0,0,1,0,-1
12541,1,0,183,0,-183
12542,1,1,1106,2141,1035
12543,1,0,93,0,-93
12544,0,0,137,0,-137
12545,0,0,88,0,-88
12546,0,0,13,0,-13
12547,1,1,313,1711,1398
12548,1,0,59,0,-59
12549,1,1,184,1984,1800
12550,1,0,202,0,-202
12551,1,1,529,2373,1844
12552,1,1,165,1446,1281
12553,0,0,83,0,-83
12554,1,0,121,0,-121
12555,1,0,247,0,-247
12556,1,1,416,1776,1360
12557,1,1,912,2102,1190
12558,1,1,42,1426,1384
12559,0,0,18,0,-18
12560,1,0,88,0,-88
12561,1,0,54,0,-54
12562,1,1,360,1223,863
12563,1,0,8,0,-8
12564,1,1,114,1312,1198
12565,1,1,315,1497,1182
12566,0,0,10,0,-10
12567,1,0,9,0,-9
12568,1,1,333,1392,1059
12569,0,0,11,0,-11
12570,1,0,51,0,-51
12571,0,0,6,0,-6
12572,1,0,9,0,-9
12573,0,0,3,0,-3
12574,0,0,14,0,-14
12575,1,1,173,3793,3620
12576,1,0,83,0,-83
12577,1,0,0,0,0
12578,0,0,187,0,-187
12579,1,0,68,0,-68
12580,1,1,1658,1254,-404
12581,1,0,69,0,-69
12582,0,0,94,0,-94
12583,1,0,91,0,-91
12584,1,0,69,0,-69
12585,1,1,79,1686,1607
12586,1,1,131,1678,1547
12587,0,0,23,0,-23
12588,0,0,41,0,-41
12589,1,0,8,0,-8
12590,1,0,24,0,-24
12591,1,1,923,1313,390
12592,1,1,78,2704,2626
12593,1,1,69,1572,1503
12594,0,0,213,0,-213
12595,0,0,5,0,-5
12596,1,0,31,0,-31
12597,1,1,425,1519,1094
12598,0,0,73,0,-73
12599,1,0,1,0,-1
12600,1,1,114,1223,1109
12601,1,1,438,1296,858
12602,1,0,0,0,0
12603,1,0,154,0,-154
12604,0,0,5,0,-5
12605,0,0,4,0,-4
12606,1,1,906,1398,492
12607,0,0,13,0,-13
12608,1,0,0,0,0
12609,0,0,21,0,-21
12610,1,0,86,0,-86
12611,0,0,176,0,-176
12612,0,0,140,0,-140
12613,1,1,784,1452,668
12614,1,1,160,1369,1209
12615,1,1,487,1248,761
12616,1,0,2,0,-2
12617,0,0,20,0,-20
12618,1,0,121,0,-121
12619,1,0,40,0,-40
12620,0,0,20,0,-20
12621,1,0,28,0,-28
12622,0,0,156,0,-156
12623,1,1,485,1918,1433
12624,1,1,34,1213,1179
12625,1,0,1,0,-1
12626,0,0,18,0,-18
12627,0,0,166,0,-166
12628,1,1,294,1411,1117
12629,1,0,0,0,0
12630,1,1,254,2520,2266
12631,1,0,59,0,-59
12632,0,0,15,0,-15
12633,1,0,41,0,-41
12634,0,0,12,0,-12
12635,1,1,410,1382,972
12636,0,0,42,0,-42
12637,1,1,746,1750,1004
12638,0,0,13,0,-13
12639,1,1,417,1317,900
12640,0,0,115,0,-115
12641,1,1,241,1470,1229
12642,0,0,9,0,-9
12643,1,1,39,1592,1553
12644,1,1,243,1302,1059
12645,1,1,241,1312,1071
12646,0,0,4,0,-4
12647,1,1,504,1478,974
12648,0,0,28,0,-28
12649,1,0,90,0,-90
12650,0,0,84,0,-84
12651,1,0,81,0,-81
12652,0,0,9,0,-9
12653,1,0,5,0,-5
12654,0,0,21,0,-21
12655,0,0,8,0,-8
12656,1,1,70,1645,1575
12657,0,0,149,0,-149
12658,1,0,5,0,-5
12659,1,1,315,1780,1465
12660,1,1,56,1385,1329
12661,0,0,38,0,-38
12662,0,0,15,0,-15
12663,1,0,54,0,-54
12664,1,0,94,0,-94
12665,1,1,254,1238,984
12666,1,0,11,0,-11
12667,1,1,326,1341,1015
12668,1,0,8,0,-8
12669,1,0,18,0,-18
12670,0,0,179,0,-179
12671,0,0,186,0,-186
12672,0,0,26,0,-26
12673,0,0,37,0,-37
12674,0,0,44,0,-44
12675,1,0,199,0,-199
12676,1,0,16,0,-16
12677,1,1,208,1221,1013
12678,1,0,113,0,-113
12679,0,0,7,0,-7
12680,1,0,46,0,-46
12681,1,0,25,0,-25
12682,1,1,278,1426,1148
12683,1,1,227,1297,1070
12684,1,0,92,0,-92
12685,1,1,230,1875,1645
12686,1,1,367,1522,1155
12687,1,1,226,1404,1178
12688,1,0,19,0,-19
12689,1,1,185,1684,1499
12690,1,0,20,0,-20
12691,1,0,22,0,-22
12692,0,0,63,0,-63
12693,0,0,13,0,-13
12694,0,0,10,0,-10
12695,1,0,84,0,-84
12696,1,1,188,1343,1155
12697,1,0,27,0,-27
12698,1,0,29,0,-29
12699,0,0,85,0,-85
12700,1,0,174,0,-174
12701,0,0,12,0,-12
12702,0,0,20,0,-20
12703,1,1,473,2323,1850
12704,1,0,84,0,-84
12705,1,1,672,1571,899
12706,1,0,92,0,-92
12707,1,0,68,0,-68
12708,1,0,28,0,-28
12709,1,1,1309,3338,2029
12710,1,0,7,0,-7
12711,1,1,1211,1417,206
12712,0,0,39,0,-39
12713,1,0,14,0,-14
12714,1,0,58,0,-58
12715,1,1,915,1514,599
12716,1,0,2,0,-2
12717,1,0,3,0,-3
12718,1,0,50,0,-50
12719,0,0,86,0,-86
12720,1,0,52,0,-52
12721,0,0,22,0,-22
12722,0,0,34,0,-34
12723,0,0,18,0,-18
12724,1,1,402,1331,929
12725,1,0,50,0,-50
12726,1,0,75,0,-75
12727,1,1,259,1435,1176
12728,1,0,285,0,-285
12729,0,0,13,0,-13
12730,0,0,12,0,-12
12731,1,1,361,1357,996
12732,1,1,99,1602,1503
12733,1,0,50,0,-50
12734,1,0,64,0,-64
12735,1,1,307,1345,1038
12736,0,0,36,0,-36
12737,0,0,17,0,-17
12738,1,1,291,1490,1199
12739,0,0,80,0,-80
12740,1,0,247,0,-247
12741,0,0,22,0,-22
12742,1,0,3,0,-3
12743,1,1,460,2175,1715
12744,0,0,56,0,-56
12745,1,0,70,0,-70
12746,0,0,7,0,-7
12747,1,1,232,1637,1405
12748,0,0,135,0,-135
12749,0,0,11,0,-11
12750,0,0,70,0,-70
12751,0,0,42,0,-42
12752,0,0,52,0,-52
12753,1,0,36,0,-36
12754,0,0,7,0,-7
12755,1,0,43,0,-43
12756,0,0,8,0,-8
12757,0,0,25,0,-25
12758,0,0,84,0,-84
12759,1,0,11,0,-11
12760,0,0,3,0,-3
12761,1,1,97,1380,1283
12762,0,0,14,0,-14
12763,0,0,36,0,-36
12764,1,0,17,0,-17
12765,1,1,2160,1428,-732
12766,1,0,53,0,-53
12767,1,1,1540,1285,-255
12768,0,0,5,0,-5
12769,1,1,160,1672,1512
12770,1,0,156,0,-156
12771,1,1,572,1242,670
12772,0,0,29,0,-29
12773,0,0,1,0,-1
12774,1,0,30,0,-30
12775,1,1,286,2141,1855
12776,0,0,120,0,-120
12777,1,0,59,0,-59
12778,0,0,168,0,-168
12779,1,1,1584,3000,1416
12780,0,0,6,0,-6
12781,1,0,80,0,-80
12782,1,0,106,0,-106
12783,1,1,173,1372,1199
12784,0,0,16,0,-16
12785,1,0,11,0,-11
12786,1,1,361,1331,970
12787,0,0,306,0,-306
12788,0,0,23,0,-23
12789,1,1,62,1526,1464
12790,0,0,28,0,-28
12791,0,0,25,0,-25
12792,1,1,234,1531,1297
12793,0,0,32,0,-32
12794,0,0,100,0,-100
12795,1,0,57,0,-57
12796,1,1,518,1626,1108
12797,1,0,35,0,-35
12798,1,0,79,0,-79
12799,1,0,8,0,-8
12800,1,1,116,1261,1145
12801,1,1,47,1530,1483
12802,0,0,356,0,-356
12803,0,0,48,0,-48
12804,0,0,32,0,-32
12805,0,0,33,0,-33
12806,1,1,1064,1261,197
12807,0,0,48,0,-48
12808,1,1,126,1894,1768
12809,1,0,17,0,-17
12810,1,1,727,1207,480
12811,1,1,29,1319,1290
12812,1,1,430,1215,785
12813,0,0,23,0,-23
12814,0,0,11,0,-11
12815,0,0,87,0,-87
12816,0,0,31,0,-31
12817,1,1,459,2301,1842
12818,1,1,243,1391,1148
12819,1,0,111,0,-111
12820,1,1,560,1345,785
12821,1,1,1008,1274,266
12822,1,1,58,1249,1191
12823,0,0,36,0,-36
12824,0,0,166,0,-166
12825,1,0,32,0,-32
12826,0,0,51,0,-51
12827,1,0,5,0,-5
12828,0,0,0,0,0
12829,0,0,5,0,-5
12830,1,0,102,0,-102
12831,0,0,8,0,-8
12832,1,1,161,1231,1070
12833,0,0,9,0,-9
12834,0,0,142,0,-142
12835,1,0,33,0,-33
12836,0,0,17,0,-17
12837,1,0,44,0,-44
12838,1,0,14,0,-14
12839,1,1,1024,1665,641
12840,0,0,62,0,-62
12841,1,0,11,0,-11
12842,0,0,90,0,-90
12843,0,0,23,0,-23
12844,1,1,452,1299,847
12845,1,1,1280,2562,1282
12846,1,1,127,1496,1369
12847,0,0,53,0,-53
12848,1,0,60,0,-60
12849,0,0,4,0,-4
12850,0,0,28,0,-28
12851,1,1,1050,1318,268
12852,0,0,43,0,-43
12853,1,0,59,0,-59
12854,1,0,42,0,-42
12855,0,0,14,0,-14
12856,1,0,26,0,-26
12857,1,1,229,1211,982
12858,1,1,1090,2550,1460
12859,0,0,25,0,-25
12860,1,0,0,0,0
12861,0,0,19,0,-19
12862,1,1,72,1495,1423
12863,1,1,1292,1553,261
12864,0,0,3,0,-3
12865,1,1,1406,2687,1281
12866,1,1,202,1716,1514
12867,1,0,2,0,-2
12868,0,0,127,0,-127
12869,0,0,51,0,-51
12870,0,0,99,0,-99
12871,1,1,572,1392,820
12872,1,0,25,0,-25
12873,0,0,34,0,-34
12874,0,0,64,0,-64
12875,1,0,10,0,-10
12876,1,1,149,1800,1651
12877,1,1,107,1327,1220
12878,0,0,6,0,-6
12879,1,1,472,1295,823
12880,1,1,142,1595,1453
12881,0,0,56,0,-56
12882,1,0,42,0,-42
12883,1,1,108,1565,1457
12884,1,0,5,0,-5
12885,1,1,200,1376,1176
12886,1,0,63,0,-63
12887,0,0,2,0,-2
12888,1,1,117,1568,1451
12889,0,0,33,0,-33
12890,0,0,51,0,-51
12891,0,0,29,0,-29
12892,1,0,103,0,-103
12893,1,0,11,0,-11
12894,0,0,4,0,-4
12895,0,0,7,0,-7
12896,0,0,17,0,-17
12897,1,0,7,0,-7
12898,0,0,42,0,-42
12899,1,0,175,0,-175
12900,0,0,68,0,-68
12901,1,1,887,1201,314
12902,1,0,51,0,-51
12903,1,0,101,0,-101
12904,0,0,67,0,-67
12905,0,0,15,0,-15
12906,1,0,11,0,-11
12907,0,0,103,0,-103
12908,1,0,28,0,-28
12909,1,1,811,1523,712
12910,0,0,19,0,-19
12911,1,0,89,0,-89
12912,1,0,174,0,-174
12913,1,1,508,1245,737
12914,1,0,56,0,-56
12915,1,1,745,1284,539
12916,1,1,204,1398,1194
12917,1,0,63,0,-63
12918,1,1,944,1585,641
12919,0,0,21,0,-21
12920,1,0,6,0,-6
12921,1,1,395,1537,1142
12922,1,1,493,1409,916
12923,1,1,385,1236,851
12924,1,0,97,0,-97
12925,0,0,104,0,-104
12926,1,1,873,1287,414
12927,1,0,29,0,-29
12928,1,0,6,0,-6
12929,1,1,102,1375,1273
12930,1,1,1155,1463,308
12931,0,0,35,0,-35
12932,0,0,4,0,-4
12933,0,0,20,0,-20
12934,1,0,29,0,-29
12935,0,0,13,0,-13
12936,1,1,743,1306,563
12937,1,0,52,0,-52
12938,0,0,6,0,-6
12939,1,1,1427,1337,-90
12940,1,1,815,1383,568
12941,1,1,208,1271,1063
12942,1,1,67,1438,1371
12943,1,0,15,0,-15
12944,1,0,71,0,-71
12945,0,0,19,0,-19
12946,1,1,259,1441,1182
12947,0,0,100,0,-100
12948,1,1,198,1219,1021
12949,0,0,8,0,-8
12950,1,0,44,0,-44
12951,1,0,48,0,-48
12952,1,0,98,0,-98
12953,0,0,76,0,-76
12954,1,0,46,0,-46
12955,0,0,25,0,-25
12956,1,1,742,1225,483
12957,1,0,11,0,-11
12958,1,1,665,1637,972
12959,1,0,1,0,-1
12960,0,0,67,0,-67
12961,1,1,362,1424,1062
12962,1,0,59,0,-59
12963,1,0,6,0,-6
12964,1,1,331,1620,1289
12965,1,0,7,0,-7
12966,1,1,1085,1418,333
12967,1,0,2,0,-2
12968,0,0,208,0,-208
12969,1,1,59,1410,1351
12970,0,0,49,0,-49
12971,0,0,239,0,-239
12972,0,0,30,0,-30
12973,1,0,24,0,-24
12974,1,0,21,0,-21
12975,0,0,10,0,-10
12976,0,0,180,0,-180
12977,1,0,37,0,-37
12978,1,0,16,0,-16
12979,0,0,11,0,-11
12980,0,0,14,0,-14
12981,0,0,33,0,-33
12982,0,0,40,0,-40
12983,1,1,339,1226,887
12984,1,1,486,1320,834
12985,1,0,109,0,-109
12986,0,0,61,0,-61
12987,1,1,1323,1577,254
12988,1,0,30,0,-30
12989,0,0,45,0,-45
12990,0,0,27,0,-27
12991,1,0,253,0,-253
12992,0,0,34,0,-34
12993,0,0,108,0,-108
12994,0,0,35,0,-35
12995,0,0,35,0,-35
12996,0,0,44,0,-44
12997,0,0,44,0,-44
12998,1,0,76,0,-76
12999,1,1,453,1513,1060
13000,0,0,56,0,-56
13001,0,0,3,0,-3
13002,0,0,5,0,-5
13003,0,0,10,0,-10
13004,0,0,2,0,-2
13005,1,0,37,0,-37
13006,0,0,53,0,-53
13007,0,0,27,0,-27
13008,1,0,17,0,-17
13009,1,1,310,1266,956
13010,0,0,62,0,-62
13011,1,0,132,0,-132
13012,0,0,4,0,-4
13013,1,1,284,1360,1076
13014,1,0,21,0,-21
13015,1,1,206,1304,1098
13016,0,0,33,0,-33
13017,1,0,32,0,-32
13018,1,0,62,0,-62
13019,1,1,824,1279,455
13020,0,0,1,0,-1
13021,0,0,19,0,-19
13022,1,1,764,1534,770
13023,0,0,62,0,-62
13024,1,0,19,0,-19
13025,0,0,57,0,-57
13026,1,1,1171,1238,67
13027,0,0,17,0,-17
13028,0,0,238,0,-238
13029,0,0,15,0,-15
13030,1,1,103,1627,1524
13031,0,0,6,0,-6
13032,1,1,1156,1311,155
13033,1,0,48,0,-48
13034,1,0,4,0,-4
13035,1,1,462,2174,1712
13036,1,0,9,0,-9
13037,0,0,10,0,-10
13038,1,0,25,0,-25
13039,0,0,47,0,-47
13040,0,0,36,0,-36
13041,1,1,709,1374,665
13042,1,1,103,1394,1291
13043,0,0,3,0,-3
13044,0,0,3,0,-3
13045,1,0,79,0,-79
13046,1,0,130,0,-130
13047,0,0,53,0,-53
13048,1,0,78,0,-78
13049,0,0,8,0,-8
13050,1,1,120,1469,1349
13051,1,1,214,1230,1016
13052,1,1,169,2393,2224
13053,1,0,8,0,-8
13054,1,0,31,0,-31
13055,1,0,93,0,-93
13056,0,0,25,0,-25
13057,1,1,1095,1224,129
13058,0,0,41,0,-41
13059,1,1,378,1670,1292
13060,1,0,0,0,0
13061,1,0,104,0,-104
13062,0,0,10,0,-10
13063,1,1,405,1965,1560
13064,1,1,77,1308,1231
13065,0,0,25,0,-25
13066,1,1,466,1847,1381
13067,1,1,177,1227,1050
13068,1,0,12,0,-12
13069,0,0,18,0,-18
13070,1,1,26,1424,1398
13071,0,0,76,0,-76
13072,1,0,74,0,-74
13073,1,0,22,0,-22
13074,1,0,137,0,-137
13075,0,0,130,0,-130
13076,1,0,15,0,-15
13077,0,0,96,0,-96
13078,0,0,25,0,-25
13079,0,0,88,0,-88
13080,1,1,13,1279,1266
13081,1,1,667,4445,3778
13082,0,0,66,0,-66
13083,1,0,116,0,-116
13084,1,0,24,0,-24
13085,1,1,460,1551,1091
13086,0,0,99,0,-99
13087,1,1,158,1259,1101
13088,1,0,95,0,-95
13089,1,1,25,1555,1530
13090,0,0,54,0,-54
13091,0,0,145,0,-145
13092,0,0,250,0,-250
13093,1,0,158,0,-158
13094,1,0,5,0,-5
13095,1,1,378,1480,1102
13096,1,1,142,1470,1328
13097,0,0,2,0,-2
13098,1,0,15,0,-15
13099,1,0,82,0,-82
13100,0,0,27,0,-27
13101,0,0,38,0,-38
13102,1,0,39,0,-39
13103,1,0,0,0,0
13104,0,0,50,0,-50
13105,1,0,70,0,-70
13106,1,0,10,0,-10
13107,1,0,89,0,-89
13108,1,1,283,1791,1508
13109,1,1,1212,1232,20
13110,0,0,121,0,-121
13111,1,0,50,0,-50
13112,1,0,0,0,0
13113,1,0,13,0,-13
13114,0,0,129,0,-129
13115,1,1,873,1273,400
13116,0,0,3,0,-3
13117,0,0,19,0,-19
13118,1,0,153,0,-153
13119,1,1,405,1362,957
13120,1,0,13,0,-13
13121,0,0,40,0,-40
13122,0,0,26,0,-26
13123,1,0,22,0,-22
13124,0,0,74,0,-74
13125,0,0,122,0,-122
13126,0,0,27,0,-27
13127,1,0,196,0,-196
13128,1,1,336,1726,1390
13129,1,0,22,0,-22
13130,1,0,5,0,-5
13131,0,0,4,0,-4
13132,1,0,8,0,-8
13133,1,0,0,0,0
13134,1,1,1022,1249,227
13135,0,0,2,0,-2
13136,0,0,84,0,-84
13137,0,0,6,0,-6
13138,0,0,289,0,-289
13139,1,0,10,0,-10
13140,0,0,403,0,-403
13141,0,0,19,0,-19
13142,0,0,45,0,-45
13143,0,0,73,0,-73
13144,1,1,122,1959,1837
13145,1,1,336,2118,1782
13146,0,0,1,0,-1
13147,0,0,114,0,-114
13148,1,1,183,1445,1262
13149,0,0,32,0,-32
13150,1,0,50,0,-50
13151,0,0,25,0,-25
13152,0,0,50,0,-50
13153,1,1,405,2169,1764
13154,0,0,20,0,-20
13155,1,0,29,0,-29
13156,1,1,372,1730,1358
13157,0,0,7,0,-7
13158,0,0,57,0,-57
13159,1,0,207,0,-207
13160,1,1,154,1273,1119
13161,1,0,81,0,-81
13162,1,1,828,1244,416
13163,1,1,139,1810,1671
13164,1,0,100,0,-100
13165,1,1,733,1334,601
13166,1,0,74,0,-74
13167,0,0,27,0,-27
13168,0,0,13,0,-13
13169,0,0,64,0,-64
13170,1,1,855,1448,593
13171,1,1,1794,1967,173
13172,1,1,180,1218,1038
13173,1,1,119,1225,1106
13174,0,0,18,0,-18
13175,1,1,685,1436,751
13176,0,0,8,0,-8
13177,0,0,5,0,-5
13178,1,0,97,0,-97
13179,0,0,19,0,-19
13180,1,1,233,1621,1388
13181,1,1,540,1447,907
13182,1,0,34,0,-34
13183,0,0,18,0,-18
13184,0,0,17,0,-17
13185,0,0,105,0,-105
13186,1,0,29,0,-29
13187,1,1,66,1825,1759
13188,0,0,80,0,-80
13189,0,0,53,0,-53
13190,1,1,166,1645,1479
13191,1,1,225,1935,1710
13192,0,0,1,0,-1
13193,1,1,345,1380,1035
13194,1,1,418,2110,1692
13195,1,0,17,0,-17
13196,0,0,102,0,-102
13197,1,1,1683,1544,-139
13198,0,0,20,0,-20
13199,1,1,230,1502,1272
13200,0,0,5,0,-5
13201,1,0,37,0,-37
13202,0,0,18,0,-18
13203,1,0,74,0,-74
13204,1,0,159,0,-159
13205,1,1,231,1550,1319
13206,0,0,84,0,-84
13207,1,0,10,0,-10
13208,0,0,37,0,-37
13209,1,0,41,0,-41
13210,1,1,317,1402,1085
13211,1,0,12,0,-12
13212,0,0,69,0,-69
13213,1,0,69,0,-69
13214,1,1,867,1303,436
13215,1,1,2233,1300,-933
13216,1,1,320,2659,2339
13217,1,1,404,1317,913
13218,1,1,608,1306,698
13219,1,1,153,1648,1495
13220,1,1,527,1579,1052
13221,0,0,17,0,-17
13222,1,0,10,0,-10
13223,0,0,46,0,-46
13224,0,0,111,0,-111
13225,0,0,19,0,-19
13226,1,0,182,0,-182
13227,0,0,9,0,-9
13228,1,1,77,1979,1902
13229,1,1,58,1907,1849
13230,1,1,406,1387,981
13231,1,1,704,1263,559
13232,1,1,263,1519,1256
13233,1,1,106,1344,1238
13234,1,1,511,2665,2154
13235,0,0,7,0,-7
13236,0,0,81,0,-81
13237,1,0,20,0,-20
13238,0,0,49,0,-49
13239,1,1,339,1218,879
13240,1,0,53,0,-53
13241,0,0,102,0,-102
13242,0,0,5,0,-5
13243,1,0,162,0,-162
13244,0,0,12,0,-12
13245,0,0,24,0,-24
13246,1,0,63,0,-63
13247,0,0,22,0,-22
13248,1,1,1218,3758,2540
13249,1,1,140,1286,1146
13250,0,0,212,0,-212
13251,0,0,80,0,-80
13252,1,1,1049,1485,436
13253,0,0,21,0,-21
13254,1,0,3,0,-3
13255,1,1,116,1405,1289
13256,1,0,68,0,-68
13257,1,1,358,1387,1029
13258,0,0,17,0,-17
13259,0,0,36,0,-36
13260,1,1,326,1238,912
13261,0,0,9,0,-9
13262,0,0,100,0,-100
13263,0,0,34,0,-34
13264,1,0,12,0,-12
13265,1,1,204,2930,2726
13266,1,0,16,0,-16
13267,1,1,211,1344,1133
13268,1,1,148,1387,1239
13269,0,0,39,0,-39
13270,1,0,56,0,-56
13271,1,1,744,1273,529
13272,1,1,141,3056,2915
13273,0,0,6,0,-6
13274,0,0,10,0,-10
13275,0,0,130,0,-130
13276,0,0,22,0,-22
13277,0,0,14,0,-14
13278,1,0,25,0,-25
13279,1,0,14,0,-14
13280,1,1,155,1407,1252
13281,0,0,35,0,-35
13282,0,0,3,0,-3
13283,1,1,1302,1474,172
13284,1,0,51,0,-51
13285,0,0,1,0,-1
13286,1,0,26,0,-26
13287,0,0,1,0,-1
13288,1,1,193,2187,1994
13289,1,1,1533,1714,181
13290,1,0,0,0,0
13291,0,0,67,0,-67
13292,1,1,200,1646,1446
13293,0,0,3,0,-3
13294,0,0,28,0,-28
13295,1,1,170,1477,1307
13296,0,0,160,0,-160
13297,1,0,41,0,-41
13298,0,0,63,0,-63
13299,1,0,36,0,-36
13300,1,1,283,1363,1080
13301,0,0,11,0,-11
13302,0,0,21,0,-21
13303,1,1,899,1347,448
13304,1,0,55,0,-55
13305,0,0,27,0,-27
13306,1,0,7,0,-7
13307,0,0,5,0,-5
13308,0,0,44,0,-44
13309,1,0,40,0,-40
13310,1,1,866,1314,448
13311,1,0,42,0,-42
13312,0,0,21,0,-21
13313,1,0,122,0,-122
13314,1,1,253,1825,1572
13315,1,1,466,1437,971
13316,1,0,1,0,-1
13317,0,0,99,0,-99
13318,1,1,987,1338,351
13319,1,0,14,0,-14
13320,0,0,15,0,-15
13321,1,1,329,1989,1660
13322,1,1,786,1298,512
13323,1,0,70,0,-70
13324,1,1,1348,1631,283
13325,0,0,6,0,-6
13326,1,0,9,0,-9
13327,1,0,114,0,-114
13328,0,0,19,0,-19
13329,0,0,50,0,-50
13330,1,1,260,1203,943
13331,1,0,7,0,-7
13332,0,0,40,0,-40
13333,0,0,3,0,-3
13334,0,0,74,0,-74
13335,0,0,24,0,-24
13336,1,0,29,0,-29
13337,1,1,381,1348,967
13338,1,1,76,1213,1137
13339,0,0,233,0,-233
13340,0,0,21,0,-21
13341,1,0,70,0,-70
13342,1,0,6,0,-6
13343,0,0,94,0,-94
13344,1,0,59,0,-59
13345,1,1,663,1281,618
13346,1,1,636,1291,655
13347,0,0,65,0,-65
13348,0,0,193,0,-193
13349,0,0,29,0,-29
13350,0,0,0,0,0
13351,1,1,185,1341,1156
13352,1,0,23,0,-23
13353,0,0,19,0,-19
13354,0,0,40,0,-40
13355,1,1,512,1566,1054
13356,1,1,94,1241,1147
13357,1,0,2,0,-2
13358,1,0,9,0,-9
13359,0,0,25,0,-25
13360,1,1,296,1325,1029
13361,1,1,83,1461,1378
13362,1,1,282,1721,1439
13363,1,1,882,2106,1224
13364,1,1,322,1390,1068
13365,1,1,548,1378,830
13366,1,1,1351,1251,-100
13367,1,0,15,0,-15
13368,1,1,830,1253,423
13369,1,1,337,1462,1125
13370,0,0,16,0,-16
13371,0,0,27,0,-27
13372,1,0,36,0,-36
13373,1,1,1334,1234,-100
13374,1,1,205,1486,1281
13375,0,0,52,0,-52
13376,0,0,20,0,-20
13377,1,0,32,0,-32
13378,0,0,20,0,-20
13379,1,0,81,0,-81
13380,0,0,38,0,-38
13381,0,0,138,0,-138
13382,0,0,6,0,-6
13383,1,1,924,1228,304
13384,1,0,37,0,-37
13385,0,0,111,0,-111
13386,1,0,36,0,-36
13387,0,0,37,0,-37
13388,1,0,163,0,-163
13389,1,1,77,1604,1527
13390,1,0,9,0,-9
13391,0,0,46,0,-46
13392,0,0,6,0,-6
13393,1,0,39,0,-39
13394,1,0,2,0,-2
13395,1,0,24,0,-24
13396,1,1,171,1328,1157
13397,1,1,167,1770,1603
13398,1,0,186,0,-186
13399,1,0,44,0,-44
13400,1,0,73,0,-73
13401,0,0,55,0,-55
13402,1,1,691,1554,863
13403,1,0,11,0,-11
13404,0,0,41,0,-41
13405,0,0,10,0,-10
13406,1,0,3,0,-3
13407,0,0,38,0,-38
13408,1,1,312,1762,1450
13409,0,0,12,0,-12
13410,1,1,44,3098,3054
13411,1,0,1,0,-1
13412,1,1,199,1519,1320
13413,0,0,111,0,-111
13414,1,0,44,0,-44
13415,1,1,768,1594,826
13416,0,0,62,0,-62
13417,1,0,12,0,-12
13418,0,0,25,0,-25
13419,1,0,24,0,-24
13420,0,0,36,0,-36
13421,1,1,315,1210,895
13422,1,1,18,1272,1254
13423,1,1,508,1886,1378
13424,0,0,7,0,-7
13425,1,1,211,1598,1387
13426,0,0,79,0,-79
13427,1,1,688,4654,3966
13428,1,0,42,0,-42
13429,0,0,82,0,-82
13430,0,0,41,0,-41
13431,1,1,1203,1542,339
13432,1,0,7,0,-7
13433,1,0,58,0,-58
13434,0,0,25,0,-25
13435,1,0,6,0,-6
13436,0,0,11,0,-11
13437,1,0,5,0,-5
13438,1,0,8,0,-8
13439,0,0,86,0,-86
13440,1,0,20,0,-20
13441,1,1,858,1500,642
13442,0,0,8,0,-8
13443,1,1,354,1215,861
13444,1,0,6,0,-6
13445,1,1,340,1764,1424
13446,1,1,1261,1220,-41
13447,1,0,71,0,-71
13448,0,0,138,0,-138
13449,1,1,67,1589,1522
13450,0,0,44,0,-44
13451,1,1,396,1227,831
13452,0,0,10,0,-10
13453,1,0,24,0,-24
13454,1,1,514,1454,940
13455,1,1,308,2267,1959
13456,0,0,11,0,-11
13457,0,0,15,0,-15
13458,0,0,61,0,-61
13459,0,0,12,0,-12
13460,0,0,18,0,-18
13461,1,1,641,1472,831
13462,1,1,320,1309,989
13463,1,1,371,1727,1356
13464,0,0,24,0,-24
13465,1,0,53,0,-53
13466,1,1,367,1676,1309
13467,1,0,126,0,-126
13468,0,0,57,0,-57
13469,1,1,38,2239,2201
13470,1,1,119,1703,1584
13471,0,0,63,0,-63
13472,0,0,94,0,-94
13473,1,0,35,0,-35
13474,1,0,67,0,-67
13475,1,1,1142,1272,130
13476,0,0,73,0,-73
13477,0,0,87,0,-87
13478,1,0,17,0,-17
13479,0,0,99,0,-99
13480,1,0,33,0,-33
13481,1,0,13,0,-13
13482,1,0,34,0,-34
13483,0,0,14,0,-14
13484,1,0,32,0,-32
13485,0,0,5,0,-5
13486,1,0,15,0,-15
13487,0,0,115,0,-115
13488,1,0,234,0,-234
13489,1,0,236,0,-236
13490,1,1,157,1788,1631
13491,1,1,566,1216,650
13492,1,1,2158,1314,-844
13493,0,0,35,0,-35
13494,0,0,8,0,-8
13495,0,0,1,0,-1
13496,1,1,218,1763,1545
13497,1,0,90,0,-90
13498,0,0,24,0,-24
13499,0,0,25,0,-25
13500,1,1,232,1557,1325
13501,1,1,72,1290,1218
13502,0,0,40,0,-40
13503,0,0,45,0,-45
13504,0,0,3,0,-3
13505,0,0,10,0,-10
13506,1,0,102,0,-102
13507,1,0,66,0,-66
13508,1,1,540,1934,1394
13509,0,0,62,0,-62
13510,1,1,216,1920,1704
13511,0,0,4,0,-4
13512,1,0,15,0,-15
13513,1,1,334,1551,1217
13514,1,0,3,0,-3
13515,1,0,51,0,-51
13516,1,0,3,0,-3
13517,0,0,9,0,-9
13518,1,0,75,0,-75
13519,0,0,32,0,-32
13520,1,1,92,1221,1129
13521,0,0,77,0,-77
13522,0,0,5,0,-5
13523,1,0,61,0,-61
13524,1,1,873,1875,1002
13525,1,1,145,1301,1156
13526,0,0,171,0,-171
13527,1,1,1037,2016,979
13528,0,0,2,0,-2
13529,1,0,50,0,-50
13530,1,0,18,0,-18
13531,1,0,48,0,-48
13532,1,0,47,0,-47
13533,1,1,265,1658,1393
13534,0,0,231,0,-231
13535,0,0,29,0,-29
13536,1,1,406,1201,795
13537,1,0,94,0,-94
13538,1,0,21,0,-21
13539,1,1,387,1490,1103
13540,1,1,120,1238,1118
13541,1,1,1431,1531,100
13542,1,0,94,0,-94
13543,1,0,2,0,-2
13544,0,0,1,0,-1
13545,1,0,121,0,-121
13546,1,1,1089,1417,328
13547,1,1,37,1381,1344
13548,1,1,961,1296,335
13549,0,0,11,0,-11
13550,1,1,428,1250,822
13551,1,1,94,1400,1306
13552,1,1,288,1235,947
13553,0,0,79,0,-79
13554,1,0,33,0,-33
13555,1,1,608,1453,845
13556,1,1,94,1326,1232
13557,1,0,20,0,-20
13558,1,0,40,0,-40
13559,1,0,0,0,0
13560,1,1,352,3183,2831
13561,0,0,7,0,-7
13562,1,1,305,1201,896
13563,0,0,28,0,-28
13564,0,0,89,0,-89
13565,0,0,51,0,-51
13566,0,0,21,0,-21
13567,1,0,3,0,-3
13568,1,1,439,1278,839
13569,1,1,48,1414,1366
13570,0,0,65,0,-65
13571,0,0,52,0,-52
13572,1,0,370,0,-370
13573,1,1,70,2125,2055
13574,1,0,77,0,-77
13575,1,1,808,1268,460
13576,1,0,38,0,-38
13577,1,1,52,1854,1802
13578,0,0,43,0,-43
13579,1,0,11,0,-11
13580,0,0,132,0,-132
13581,0,0,23,0,-23
13582,1,0,28,0,-28
13583,1,1,192,1269,1077
13584,0,0,1,0,-1
13585,1,0,49,0,-49
13586,0,0,4,0,-4
13587,1,1,120,1264,1144
13588,0,0,102,0,-102
13589,1,0,23,0,-23
13590,1,1,174,1627,1453
13591,0,0,118,0,-118
13592,1,0,7,0,-7
13593,1,1,145,1305,1160
13594,0,0,291,0,-291
13595,1,0,28,0,-28
13596,0,0,24,0,-24
13597,1,1,215,1231,1016
13598,0,0,26,0,-26
13599,0,0,237,0,-237
13600,1,0,27,0,-27
13601,0,0,45,0,-45
13602,0,0,75,0,-75
13603,0,0,429,0,-429
13604,1,1,365,1351,986
13605,0,0,38,0,-38
13606,1,0,4,0,-4
13607,1,0,133,0,-133
13608,0,0,55,0,-55
13609,1,0,95,0,-95
13610,1,1,354,1604,1250
13611,1,0,5,0,-5
13612,1,0,61,0,-61
13613,1,0,40,0,-40
13614,0,0,8,0,-8
13615,0,0,43,0,-43
13616,1,1,990,1491,501
13617,1,1,893,2459,1566
13618,1,1,292,1213,921
13619,1,1,543,1587,1044
13620,1,1,712,1299,587
13621,1,1,582,1320,738
13622,1,0,46,0,-46
13623,1,1,558,1416,858
13624,1,0,55,0,-55
13625,1,1,165,1370,1205
13626,1,0,212,0,-212
13627,0,0,77,0,-77
13628,1,1,187,1308,1121
13629,1,0,71,0,-71
13630,1,0,36,0,-36
13631,1,0,12,0,-12
13632,0,0,10,0,-10
13633,0,0,71,0,-71
13634,1,1,1305,1698,393
13635,1,1,404,1709,1305
13636,1,1,434,1463,1029
13637,1,0,208,0,-208
13638,1,1,1103,3168,2065
13639,0,0,33,0,-33
13640,0,0,32,0,-32
13641,0,0,69,0,-69
13642,1,0,10,0,-10
13643,0,0,49,0,-49
13644,1,1,305,1358,1053
13645,1,0,12,0,-12
13646,1,1,452,1201,749
13647,1,0,75,0,-75
13648,0,0,37,0,-37
13649,1,1,750,1620,870
13650,1,0,103,0,-103
13651,1,0,19,0,-19
13652,0,0,6,0,-6
13653,0,0,15,0,-15
13654,0,0,24,0,-24
13655,0,0,46,0,-46
13656,0,0,117,0,-117
13657,1,1,122,1224,1102
13658,0,0,52,0,-52
13659,1,0,108,0,-108
13660,1,0,16,0,-16
13661,0,0,87,0,-87
13662,1,1,222,1201,979
13663,1,0,19,0,-19
13664,1,1,940,1378,438
13665,1,0,37,0,-37
13666,1,0,7,0,-7
13667,1,0,48,0,-48
13668,1,0,43,0,-43
13669,1,1,195,2120,1925
13670,1,1,185,1306,1121
13671,1,1,724,1386,662
13672,1,0,62,0,-62
13673,1,0,125,0,-125
13674,1,0,39,0,-39
13675,1,0,50,0,-50
13676,1,0,33,0,-33
13677,1,0,15,0,-15
13678,1,0,76,0,-76
13679,0,0,91,0,-91
13680,0,0,37,0,-37
13681,0,0,8,0,-8
13682,0,0,53,0,-53
13683,0,0,27,0,-27
13684,0,0,113,0,-113
13685,1,0,64,0,-64
13686,1,0,17,0,-17
13687,1,1,551,2030,1479
13688,1,0,40,0,-40
13689,1,1,365,1475,1110
13690,1,1,1287,1261,-26
13691,0,0,149,0,-149
13692,1,1,145,1256,1111
13693,0,0,22,0,-22
13694,1,0,0,0,0
13695,1,0,17,0,-17
13696,1,1,604,1473,869
13697,1,1,94,2666,2572
13698,0,0,6,0,-6
13699,1,0,17,0,-17
13700,1,1,288,7095,6807
13701,1,0,13,0,-13
13702,0,0,130,0,-130
13703,1,1,237,1296,1059
13704,0,0,70,0,-70
13705,1,1,241,3098,2857
13706,0,0,32,0,-32
13707,0,0,21,0,-21
13708,1,0,69,0,-69
13709,0,0,125,0,-125
13710,1,1,173,1251,1078
13711,0,0,1,0,-1
13712,1,0,35,0,-35
13713,0,0,16,0,-16
13714,1,1,1284,1498,214
13715,0,0,1,0,-1
13716,0,0,130,0,-130
13717,1,0,20,0,-20
13718,0,0,40,0,-40
13719,0,0,66,0,-66
13720,1,1,1466,1451,-15
13721,1,0,80,0,-80
13722,0,0,19,0,-19
13723,1,0,45,0,-45
13724,1,0,43,0,-43
13725,1,0,53,0,-53
13726,1,0,128,0,-128
13727,1,1,281,1890,1609
13728,0,0,2,0,-2
13729,0,0,46,0,-46
13730,1,1,39,1255,1216
13731,1,1,253,1610,1357
13732,0,0,43,0,-43
13733,0,0,26,0,-26
13734,1,1,125,1829,1704
13735,1,0,81,0,-81
13736,1,0,69,0,-69
13737,1,1,1737,1782,45
13738,0,0,2,0,-2
13739,1,0,28,0,-28
13740,1,1,46,1236,1190
13741,1,1,211,1328,1117
13742,1,1,60,1219,1159
13743,1,0,15,0,-15
13744,0,0,28,0,-28
13745,1,0,65,0,-65
13746,0,0,7,0,-7
13747,1,1,509,1224,715
13748,0,0,30,0,-30
13749,1,0,29,0,-29
13750,0,0,227,0,-227
13751,0,0,4,0,-4
13752,1,1,476,1396,920
13753,1,1,477,2777,2300
13754,1,1,501,2328,1827
13755,1,1,296,1494,1198
13756,1,0,113,0,-113
13757,0,0,13,0,-13
13758,1,1,179,1676,1497
13759,0,0,117,0,-117
13760,1,0,32,0,-32
13761,1,0,3,0,-3
13762,0,0,7,0,-7
13763,1,0,4,0,-4
13764,1,0,97,0,-97
13765,1,1,554,1237,683
13766,1,0,39,0,-39
13767,0,0,23,0,-23
13768,1,1,475,1499,1024
13769,1,1,1262,1249,-13
13770,1,1,144,1251,1107
13771,1,1,238,2021,1783
13772,1,1,592,1538,946
13773,1,0,158,0,-158
13774,1,1,791,1282,491
13775,0,0,66,0,-66
13776,1,1,331,1388,1057
13777,1,0,11,0,-11
13778,0,0,8,0,-8
13779,0,0,16,0,-16
13780,1,1,219,1936,1717
13781,1,0,10,0,-10
13782,1,0,1,0,-1
13783,1,0,78,0,-78
13784,0,0,51,0,-51
13785,0,0,24,0,-24
13786,0,0,30,0,-30
13787,1,0,69,0,-69
13788,1,0,205,0,-205
13789,0,0,186,0,-186
13790,1,0,235,0,-235
13791,1,0,4,0,-4
13792,0,0,0,0,0
13793,1,0,15,0,-15
13794,1,0,14,0,-14
13795,1,1,1141,1423,282
13796,0,0,18,0,-18
13797,1,1,453,1255,802
13798,0,0,81,0,-81
13799,1,1,99,1387,1288
13800,1,0,9,0,-9
13801,1,1,46,1467,1421
13802,1,1,149,1209,1060
13803,1,1,280,1419,1139
13804,1,0,54,0,-54
13805,0,0,23,0,-23
13806,0,0,14,0,-14
13807,0,0,57,0,-57
13808,0,0,37,0,-37
13809,0,0,100,0,-100
13810,1,0,8,0,-8
13811,1,1,439,1404,965
13812,1,0,72,0,-72
13813,0,0,18,0,-18
13814,1,0,3,0,-3
13815,1,1,587,1371,784
13816,0,0,50,0,-50
13817,1,0,27,0,-27
13818,0,0,32,0,-32
13819,1,0,3,0,-3
13820,1,0,34,0,-34
13821,0,0,34,0,-34
13822,0,0,74,0,-74
13823,0,0,50,0,-50
13824,1,0,76,0,-76
13825,1,1,35,2063,2028
13826,0,0,143,0,-143
13827,0,0,8,0,-8
13828,0,0,18,0,-18
13829,0,0,1,0,-1
13830,0,0,24,0,-24
13831,1,1,576,1580,1004
13832,1,1,95,1274,1179
13833,1,0,9,0,-9
13834,1,0,45,0,-45
13835,1,1,1282,2000,718
13836,1,0,52,0,-52
13837,0,0,22,0,-22
13838,1,0,91,0,-91
13839,1,0,16,0,-16
13840,1,0,63,0,-63
13841,0,0,85,0,-85
13842,1,1,242,1662,1420
13843,1,0,44,0,-44
13844,0,0,50,0,-50
13845,0,0,5,0,-5
13846,1,1,623,1637,1014
13847,0,0,19,0,-19
13848,0,0,19,0,-19
13849,0,0,63,0,-63
13850,1,1,69,2137,2068
13851,0,0,16,0,-16
13852,1,1,122,1437,1315
13853,0,0,22,0,-22
13854,0,0,30,0,-30
13855,1,1,337,1535,1198
13856,1,0,47,0,-47
13857,1,1,349,2296,1947
13858,1,0,114,0,-114
13859,0,0,28,0,-28
13860,1,0,53,0,-53
13861,0,0,157,0,-157
13862,1,0,27,0,-27
13863,0,0,165,0,-165
13864,1,1,920,1965,1045
13865,1,0,32,0,-32
13866,1,1,499,1322,823
13867,1,1,395,2098,1703
13868,1,1,615,1366,751
13869,1,0,145,0,-145
13870,1,1,1126,2376,1250
13871,1,0,25,0,-25
13872,0,0,66,0,-66
13873,0,0,38,0,-38
13874,1,1,187,1353,1166
13875,0,0,6,0,-6
13876,0,0,35,0,-35
13877,1,1,61,1515,1454
13878,0,0,9,0,-9
13879,0,0,5,0,-5
13880,0,0,61,0,-61
13881,1,1,121,1226,1105
13882,1,1,369,1209,840
13883,0,0,155,0,-155
13884,1,0,15,0,-15
13885,0,0,89,0,-89
13886,1,1,854,1916,1062
13887,1,1,542,1361,819
13888,0,0,104,0,-104
13889,1,1,457,2278,1821
13890,1,1,1079,1736,657
13891,1,1,896,1477,581
13892,1,1,95,1323,1228
13893,0,0,57,0,-57
13894,1,0,104,0,-104
13895,0,0,101,0,-101
13896,0,0,84,0,-84
13897,1,1,856,1237,381
13898,0,0,75,0,-75
13899,1,0,121,0,-121
13900,1,1,968,1410,442
13901,0,0,24,0,-24
13902,1,1,365,1447,1082
13903,0,0,134,0,-134
13904,0,0,9,0,-9
13905,0,0,46,0,-46
13906,1,0,23,0,-23
13907,0,0,38,0,-38
13908,0,0,84,0,-84
13909,0,0,36,0,-36
13910,0,0,21,0,-21
13911,0,0,79,0,-79
13912,1,0,51,0,-51
13913,1,0,163,0,-163
13914,1,1,544,1241,697
13915,1,1,317,1479,1162
13916,0,0,27,0,-27
13917,0,0,166,0,-166
13918,1,1,1199,1325,126
13919,1,0,113,0,-113
13920,1,0,7,0,-7
13921,1,0,7,0,-7
13922,1,0,12,0,-12
13923,1,0,95,0,-95
13924,0,0,3,0,-3
13925,1,1,43,1507,1464
13926,1,0,69,0,-69
13927,1,0,10,0,-10
13928,0,0,152,0,-152
13929,0,0,62,0,-62
13930,1,1,841,1316,475
13931,0,0,4,0,-4
13932,0,0,58,0,-58
13933,0,0,8,0,-8
13934,1,0,20,0,-20
13935,0,0,21,0,-21
13936,1,0,65,0,-65
13937,1,1,497,1239,742
13938,1,0,12,0,-12
13939,0,0,49,0,-49
13940,0,0,44,0,-44
13941,0,0,19,0,-19
13942,0,0,8,0,-8
13943,0,0,20,0,-20
13944,1,0,59,0,-59
13945,1,0,34,0,-34
13946,1,1,189,1786,1597
13947,1,1,1241,1303,62
13948,1,1,175,1597,1422
13949,0,0,12,0,-12
13950,0,0,83,0,-83
13951,0,0,28,0,-28
13952,1,0,28,0,-28
13953,1,0,21,0,-21
13954,0,0,11,0,-11
13955,0,0,65,0,-65
13956,1,1,613,1343,730
13957,1,0,70,0,-70
13958,1,0,12,0,-12
13959,1,0,147,0,-147
13960,0,0,101,0,-101
13961,1,0,50,0,-50
13962,1,1,393,3849,3456
13963,1,0,24,0,-24
13964,1,0,107,0,-107
13965,1,0,3,0,-3
13966,1,1,289,1266,977
13967,1,0,27,0,-27
13968,1,0,2,0,-2
13969,0,0,7,0,-7
13970,1,1,203,1291,1088
13971,1,0,54,0,-54
13972,0,0,87,0,-87
13973,1,1,1061,2506,1445
13974,0,0,23,0,-23
13975,1,1,416,1264,848
13976,0,0,42,0,-42
13977,0,0,86,0,-86
13978,0,0,31,0,-31
13979,0,0,14,0,-14
13980,0,0,149,0,-149
13981,1,1,346,1416,1070
13982,0,0,203,0,-203
13983,1,0,24,0,-24
13984,1,1,708,1483,775
13985,0,0,70,0,-70
13986,1,1,283,1379,1096
13987,0,0,2,0,-2
13988,1,1,815,1300,485
13989,0,0,55,0,-55
13990,0,0,103,0,-103
13991,0,0,46,0,-46
13992,0,0,27,0,-27
13993,0,0,32,0,-32
13994,0,0,43,0,-43
13995,1,1,539,1657,1118
13996,1,0,43,0,-43
13997,0,0,32,0,-32
13998,0,0,35,0,-35
13999,0,0,26,0,-26
14000,1,1,1731,1433,-298
14001,0,0,56,0,-56
14002,1,0,0,0,0
14003,0,0,50,0,-50
14004,0,0,35,0,-35
14005,1,0,15,0,-15
14006,1,1,149,1217,1068
14007,0,0,58,0,-58
14008,1,1,221,1282,1061
14009,0,0,7,0,-7
14010,0,0,15,0,-15
14011,1,1,557,1936,1379
14012,1,0,50,0,-50
14013,0,0,1,0,-1
14014,1,0,69,0,-69
14015,0,0,67,0,-67
14016,0,0,96,0,-96
14017,1,1,755,1430,675
14018,1,0,17,0,-17
14019,1,1,201,1796,1595
14020,0,0,174,0,-174
14021,1,1,93,1477,1384
14022,0,0,173,0,-173
14023,0,0,16,0,-16
14024,1,0,85,0,-85
14025,1,0,33,0,-33
14026,1,1,1147,1359,212
14027,1,0,75,0,-75
14028,0,0,90,0,-90
14029,1,0,16,0,-16
14030,0,0,4,0,-4
14031,1,1,59,2034,1975
14032,1,0,48,0,-48
14033,1,1,2277,1539,-738
14034,0,0,27,0,-27
14035,0,0,7,0,-7
14036,1,1,434,1232,798
14037,1,1,758,1831,1073
14038,0,0,5,0,-5
14039,1,1,994,1216,222
14040,1,1,806,1314,508
14041,0,0,31,0,-31
14042,1,0,38,0,-38
14043,0,0,9,0,-9
14044,1,1,396,1280,884
14045,1,0,17,0,-17
14046,0,0,93,0,-93
14047,1,1,71,1460,1389
14048,0,0,56,0,-56
14049,1,0,15,0,-15
14050,1,0,25,0,-25
14051,1,1,37,1623,1586
14052,0,0,1,0,-1
14053,0,0,47,0,-47
14054,1,0,86,0,-86
14055,0,0,72,0,-72
14056,1,0,27,0,-27
14057,1,0,87,0,-87
14058,0,0,147,0,-147
14059,0,0,172,0,-172
14060,1,1,700,1777,1077
14061,0,0,65,0,-65
14062,1,1,1957,1368,-589
14063,1,0,184,0,-184
14064,1,0,39,0,-39
14065,0,0,103,0,-103
14066,1,1,1138,1361,223
14067,1,1,656,2309,1653
14068,0,0,3,0,-3
14069,1,0,10,0,-10
14070,1,1,279,2471,2192
14071,1,0,79,0,-79
14072,1,0,26,0,-26
14073,0,0,18,0,-18
14074,1,1,627,1303,676
14075,1,1,253,1328,1075
14076,0,0,9,0,-9
14077,1,0,22,0,-22
14078,0,0,14,0,-14
14079,0,0,18,0,-18
14080,1,1,628,2347,1719
14081,0,0,22,0,-22
14082,1,1,666,1561,895
14083,0,0,48,0,-48
14084,0,0,2,0,-2
14085,1,1,171,1487,1316
14086,1,0,13,0,-13
14087,0,0,108,0,-108
14088,1,0,14,0,-14
14089,1,0,1,0,-1
14090,1,0,21,0,-21
14091,1,1,1457,1216,-241
14092,1,0,58,0,-58
14093,0,0,34,0,-34
14094,1,1,46,2998,2952
14095,0,0,62,0,-62
14096,0,0,43,0,-43
14097,1,0,9,0,-9
14098,1,0,147,0,-147
14099,1,1,339,1458,1119
14100,0,0,59,0,-59
14101,1,1,755,1237,482
14102,0,0,56,0,-56
14103,0,0,4,0,-4
14104,1,1,363,1489,1126
14105,1,0,34,0,-34
14106,1,1,783,1256,473
14107,1,1,228,1409,1181
14108,1,1,274,1347,1073
14109,0,0,96,0,-96
14110,1,1,234,1303,1069
14111,0,0,51,0,-51
14112,0,0,51,0,-51
14113,1,0,15,0,-15
14114,0,0,107,0,-107
14115,1,1,273,1474,1201
14116,1,0,26,0,-26
14117,1,1,1004,2307,1303
14118,0,0,47,0,-47
14119,1,1,136,1360,1224
14120,1,1,29,1443,1414
14121,0,0,2,0,-2
14122,1,1,41,3558,3517
14123,0,0,27,0,-27
14124,1,1,1372,1205,-167
14125,1,1,1168,1570,402
14126,1,0,12,0,-12
14127,0,0,75,0,-75
14128,0,0,34,0,-34
14129,1,1,901,2068,1167
14130,0,0,1,0,-1
14131,0,0,39,0,-39
14132,1,1,281,1418,1137
14133,1,1,284,2633,2349
14134,0,0,11,0,-11
14135,1,0,110,0,-110
14136,1,0,95,0,-95
14137,1,0,11,0,-11
14138,1,0,58,0,-58
14139,1,1,283,2845,2562
14140,1,1,1348,1684,336
14141,0,0,65,0,-65
14142,1,1,596,1822,1226
14143,0,0,26,0,-26
14144,1,1,294,1906,1612
14145,1,0,35,0,-35
14146,0,0,25,0,-25
14147,0,0,46,0,-46
14148,1,0,32,0,-32
14149,1,0,26,0,-26
14150,0,0,3,0,-3
14151,1,0,85,0,-85
14152,1,1,721,1920,1199
14153,1,0,45,0,-45
14154,1,1,21,1325,1304
14155,1,1,334,1359,1025
14156,0,0,23,0,-23
14157,0,0,105,0,-105
14158,0,0,212,0,-212
14159,1,0,9,0,-9
14160,1,0,77,0,-77
14161,0,0,26,0,-26
14162,0,0,181,0,-181
14163,0,0,102,0,-102
14164,1,0,10,0,-10
14165,0,0,10,0,-10
14166,1,0,4,0,-4
14167,0,0,90,0,-90
14168,1,1,542,1228,686
14169,1,0,18,0,-18
14170,1,0,25,0,-25
14171,1,1,59,1222,1163
14172,0,0,80,0,-80
14173,0,0,7,0,-7
14174,1,0,34,0,-34
14175,0,0,0,0,0
14176,1,0,30,0,-30
14177,1,0,8,0,-8
14178,0,0,50,0,-50
14179,1,0,143,0,-143
14180,1,0,6,0,-6
14181,0,0,0,0,0
14182,1,0,128,0,-128
14183,1,0,32,0,-32
14184,1,1,343,1294,951
14185,1,0,11,0,-11
14186,1,0,56,0,-56
14187,1,1,353,1987,1634
14188,0,0,36,0,-36
14189,1,0,44,0,-44
14190,1,0,11,0,-11
14191,1,1,465,1242,777
14192,1,1,526,1370,844
14193,0,0,55,0,-55
14194,0,0,195,0,-195
14195,0,0,17,0,-17
14196,0,0,55,0,-55
14197,1,1,160,1212,1052
14198,1,0,47,0,-47
14199,1,1,530,1765,1235
14200,1,0,48,0,-48
14201,0,0,161,0,-161
14202,1,1,407,1239,832
14203,1,0,39,0,-39
14204,0,0,109,0,-109
14205,1,0,17,0,-17
14206,1,0,41,0,-41
14207,0,0,33,0,-33
14208,1,1,226,2018,1792
14209,1,0,54,0,-54
14210,1,0,133,0,-133
14211,1,0,0,0,0
14212,1,1,689,1728,1039
14213,1,1,258,1310,1052
14214,0,0,6,0,-6
14215,1,0,8,0,-8
14216,1,1,199,1214,1015
14217,1,1,994,1248,254
14218,1,0,41,0,-41
14219,0,0,28,0,-28
14220,1,1,100,1811,1711
14221,1,1,468,1736,1268
14222,0,0,34,0,-34
14223,0,0,2,0,-2
14224,1,0,108,0,-108
14225,1,0,16,0,-16
14226,1,1,341,1304,963
14227,0,0,30,0,-30
14228,1,0,8,0,-8
14229,1,1,388,2386,1998
14230,1,0,67,0,-67
14231,1,0,72,0,-72
14232,1,1,738,1455,717
14233,1,1,899,1334,435
14234,1,0,39,0,-39
14235,1,1,211,1536,1325
14236,0,0,0,0,0
14237,1,1,171,1446,1275
14238,1,1,670,1540,870
14239,1,1,25,1452,1427
14240,1,0,50,0,-50
14241,1,0,88,0,-88
14242,1,1,93,1546,1453
14243,0,0,98,0,-98
14244,1,1,375,1273,898
14245,1,1,1464,1367,-97
14246,1,0,2,0,-2
14247,1,0,24,0,-24
14248,1,0,82,0,-82
14249,1,1,948,1306,358
14250,1,0,37,0,-37
14251,1,0,24,0,-24
14252,1,0,63,0,-63
14253,1,0,27,0,-27
14254,0,0,25,0,-25
14255,0,0,33,0,-33
14256,1,0,9,0,-9
14257,1,0,178,0,-178
14258,1,1,170,1390,1220
14259,0,0,21,0,-21
14260,0,0,54,0,-54
14261,0,0,14,0,-14
14262,1,0,46,0,-46
14263,0,0,105,0,-105
14264,0,0,11,0,-11
14265,0,0,11,0,-11
14266,0,0,30,0,-30
14267,0,0,9,0,-9
14268,1,0,5,0,-5
14269,1,0,86,0,-86
14270,1,1,579,1365,786
14271,0,0,53,0,-53
14272,0,0,32,0,-32
14273,1,1,1169,1850,681
14274,1,0,80,0,-80
14275,0,0,65,0,-65
14276,0,0,54,0,-54
14277,1,0,132,0,-132
14278,0,0,129,0,-129
14279,1,0,5,0,-5
14280,0,0,82,0,-82
14281,1,1,120,1291,1171
14282,0,0,54,0,-54
14283,0,0,49,0,-49
14284,1,1,270,5617,5347
14285,0,0,31,0,-31
14286,0,0,128,0,-128
14287,1,0,90,0,-90
14288,1,1,355,1604,1249
14289,1,1,322,1836,1514
14290,0,0,132,0,-132
14291,1,0,10,0,-10
14292,1,1,147,1284,1137
14293,1,1,853,1636,783
14294,1,0,25,0,-25
14295,1,1,230,3768,3538
14296,1,0,58,0,-58
14297,1,0,27,0,-27
14298,0,0,14,0,-14
14299,0,0,20,0,-20
14300,1,0,85,0,-85
14301,1,1,88,1409,1321
14302,0,0,68,0,-68
14303,0,0,73,0,-73
14304,0,0,13,0,-13
14305,0,0,171,0,-171
14306,0,0,9,0,-9
14307,1,1,612,1479,867
14308,1,0,9,0,-9
14309,0,0,27,0,-27
14310,0,0,13,0,-13
14311,0,0,49,0,-49
14312,1,1,337,1224,887
14313,1,0,6,0,-6
14314,1,0,29,0,-29
14315,1,0,71,0,-71
14316,1,0,6,0,-6
14317,1,1,360,1280,920
14318,0,0,50,0,-50
14319,0,0,24,0,-24
14320,1,1,405,1724,1319
14321,1,1,43,1838,1795
14322,1,0,37,0,-37
14323,1,1,336,1399,1063
14324,1,1,395,1337,942
14325,1,1,122,1280,1158
14326,0,0,22,0,-22
14327,1,0,92,0,-92
14328,1,0,23,0,-23
14329,0,0,35,0,-35
14330,1,0,13,0,-13
14331,0,0,33,0,-33
14332,0,0,131,0,-131
14333,1,0,11,0,-11
14334,1,0,44,0,-44
14335,0,0,355,0,-355
14336,1,1,425,1720,1295
14337,1,0,77,0,-77
14338,1,1,410,1518,1108
14339,1,0,6,0,-6
14340,0,0,27,0,-27
14341,1,0,3,0,-3
14342,0,0,1,0,-1
14343,0,0,0,0,0
14344,1,0,94,0,-94
14345,0,0,7,0,-7
14346,1,1,125,1224,1099
14347,0,0,1,0,-1
14348,1,0,14,0,-14
14349,0,0,26,0,-26
14350,1,1,1028,1292,264
14351,0,0,27,0,-27
14352,1,1,191,1340,1149
14353,1,1,237,1204,967
14354,1,1,404,1594,1190
14355,0,0,11,0,-11
14356,1,0,49,0,-49
14357,1,1,433,1388,955
14358,1,0,23,0,-23
14359,0,0,186,0,-186
14360,1,1,857,1294,437
14361,1,1,467,1404,937
14362,1,1,235,2861,2626
14363,1,1,553,1746,1193
14364,1,1,768,1336,568
14365,1,0,57,0,-57
14366,1,0,173,0,-173
14367,1,1,201,1201,1000
14368,0,0,31,0,-31
14369,1,1,536,1202,666
14370,1,0,48,0,-48
14371,0,0,10,0,-10
14372,1,0,11,0,-11
14373,1,1,310,1295,985
14374,1,1,462,1494,1032
14375,1,0,50,0,-50
14376,0,0,14,0,-14
14377,0,0,79,0,-79
14378,1,1,520,1637,1117
14379,0,0,120,0,-120
14380,0,0,31,0,-31
14381,0,0,41,0,-41
14382,1,1,625,1415,790
14383,1,0,19,0,-19
14384,1,1,2362,1256,-1106
14385,1,0,3,0,-3
14386,0,0,23,0,-23
14387,1,0,16,0,-16
14388,1,0,53,0,-53
14389,1,1,96,2712,2616
14390,1,0,60,0,-60
14391,1,0,19,0,-19
14392,1,0,69,0,-69
14393,1,0,1,0,-1
14394,1,1,505,1817,1312
14395,1,0,19,0,-19
14396,0,0,109,0,-109
14397,1,1,168,1554,1386
14398,1,1,1152,1569,417
14399,1,1,1087,1563,476
14400,1,1,479,1220,741
14401,1,1,409,1302,893
14402,1,0,62,0,-62
14403,0,0,21,0,-21
14404,1,0,16,0,-16
14405,1,1,50,1427,1377
14406,0,0,36,0,-36
14407,0,0,12,0,-12
14408,1,0,195,0,-195
14409,0,0,22,0,-22
14410,0,0,106,0,-106
14411,0,0,51,0,-51
14412,1,1,417,1335,918
14413,1,0,43,0,-43
14414,1,0,91,0,-91
14415,1,1,277,1806,1529
14416,0,0,20,0,-20
14417,0,0,1,0,-1
14418,0,0,97,0,-97
14419,0,0,40,0,-40
14420,1,0,220,0,-220
14421,0,0,157,0,-157
14422,1,0,13,0,-13
14423,1,0,120,0,-120
14424,1,0,107,0,-107
14425,1,0,110,0,-110
14426,0,0,39,0,-39
14427,0,0,130,0,-130
14428,0,0,65,0,-65
14429,1,0,9,0,-9
14430,1,1,302,1317,1015
14431,0,0,41,0,-41
14432,0,0,45,0,-45
14433,0,0,34,0,-34
14434,1,0,129,0,-129
14435,1,0,48,0,-48
14436,1,0,8,0,-8
14437,0,0,10,0,-10
14438,0,0,63,0,-63
14439,1,1,359,1238,879
14440,1,0,25,0,-25
14441,0,0,45,0,-45
14442,0,0,2,0,-2
14443,1,0,21,0,-21
14444,0,0,39,0,-39
14445,1,1,579,1365,786
14446,1,0,115,0,-115
14447,0,0,126,0,-126
14448,0,0,9,0,-9
14449,1,1,226,1426,1200
14450,1,0,372,0,-372
14451,0,0,73,0,-73
14452,1,1,1561,2419,858
14453,0,0,104,0,-104
14454,1,1,1648,1620,-28
14455,1,1,351,1473,1122
14456,1,1,478,1474,996
14457,1,0,3,0,-3
14458,1,1,893,1521,628
14459,1,1,537,1231,694
14460,1,0,73,0,-73
14461,1,1,743,1411,668
14462,1,1,429,1470,1041
14463,1,1,1919,1642,-277
14464,1,1,694,1228,534
14465,0,0,3,0,-3
14466,0,0,156,0,-156
14467,0,0,20,0,-20
14468,0,0,29,0,-29
14469,1,1,608,1363,755
14470,0,0,21,0,-21
14471,1,1,382,2269,1887
14472,0,0,58,0,-58
14473,0,0,136,0,-136
14474,0,0,49,0,-49
14475,0,0,245,0,-245
14476,1,1,312,1258,946
14477,0,0,28,0,-28
14478,1,1,99,1426,1327
14479,1,0,65,0,-65
14480,1,0,73,0,-73
14481,0,0,9,0,-9
14482,0,0,48,0,-48
14483,1,0,22,0,-22
14484,0,0,17,0,-17
14485,0,0,40,0,-40
14486,1,1,98,1625,1527
14487,1,1,1342,1441,99
14488,0,0,93,0,-93
14489,0,0,1,0,-1
14490,1,1,219,1307,1088
14491,0,0,13,0,-13
14492,1,0,17,0,-17
14493,0,0,11,0,-11
14494,1,1,872,1778,906
14495,1,1,677,1314,637
14496,0,0,104,0,-104
14497,0,0,65,0,-65
14498,1,1,930,1810,880
14499,1,0,3,0,-3
14500,0,0,14,0,-14
14501,1,0,8,0,-8
14502,1,1,121,2908,2787
14503,1,0,18,0,-18
14504,0,0,39,0,-39
14505,1,1,197,2419,2222
14506,1,0,6,0,-6
14507,1,0,57,0,-57
14508,1,0,15,0,-15
14509,0,0,97,0,-97
14510,0,0,17,0,-17
14511,1,0,13,0,-13
14512,0,0,24,0,-24
14513,1,1,644,1260,616
14514,0,0,6,0,-6
14515,1,0,34,0,-34
14516,1,0,52,0,-52
14517,1,1,169,2421,2252
14518,1,1,1554,1241,-313
14519,0,0,22,0,-22
14520,1,0,53,0,-53
14521,1,1,258,1539,1281
14522,0,0,41,0,-41
14523,1,1,469,1241,772
14524,1,1,1518,2074,556
14525,1,0,11,0,-11
14526,1,1,852,1336,484
14527,0,0,107,0,-107
14528,0,0,114,0,-114
14529,1,1,90,1512,1422
14530,1,0,6,0,-6
14531,0,0,53,0,-53
14532,1,1,84,1330,1246
14533,0,0,42,0,-42
14534,1,1,576,1211,635
14535,1,1,175,1259,1084
14536,1,1,239,1277,1038
14537,0,0,2,0,-2
14538,0,0,123,0,-123
14539,0,0,57,0,-57
14540,0,0,39,0,-39
14541,0,0,99,0,-99
14542,1,0,13,0,-13
14543,1,1,327,1267,940
14544,1,1,1031,1736,705
14545,0,0,11,0,-11
14546,0,0,39,0,-39
14547,1,0,16,0,-16
14548,0,0,70,0,-70
14549,0,0,24,0,-24
14550,0,0,46,0,-46
14551,1,1,844,1272,428
14552,1,1,100,1217,1117
14553,1,0,2,0,-2
14554,0,0,98,0,-98
14555,1,1,488,1888,1400
14556,0,0,91,0,-91
14557,1,1,522,2257,1735
14558,0,0,12,0,-12
14559,1,1,506,1556,1050
14560,1,0,15,0,-15
14561,0,0,171,0,-171
14562,0,0,80,0,-80
14563,1,0,2,0,-2
14564,1,0,25,0,-25
14565,1,1,140,1276,1136
14566,0,0,2,0,-2
14567,1,0,92,0,-92
14568,1,0,121,0,-121
14569,1,0,18,0,-18
14570,0,0,5,0,-5
14571,1,0,40,0,-40
14572,1,0,129,0,-129
14573,1,1,773,1540,767
14574,1,1,1005,1667,662
14575,1,0,47,0,-47
14576,1,0,18,0,-18
14577,0,0,18,0,-18
14578,0,0,74,0,-74
14579,1,1,953,2046,1093
14580,0,0,6,0,-6
14581,0,0,62,0,-62
14582,0,0,10,0,-10
14583,0,0,9,0,-9
14584,1,1,499,1548,1049
14585,1,0,61,0,-61
14586,0,0,5,0,-5
14587,0,0,44,0,-44
14588,0,0,28,0,-28
14589,1,1,170,1641,1471
14590,1,1,899,2679,1780
14591,1,0,23,0,-23
14592,1,1,360,1719,1359
14593,1,1,404,1285,881
14594,1,1,205,1222,1017
14595,1,0,57,0,-57
14596,1,0,1,0,-1
14597,1,1,172,2519,2347
14598,1,0,0,0,0
14599,1,1,175,1245,1070
14600,0,0,12,0,-12
14601,1,1,374,3377,3003
14602,1,1,340,2306,1966
14603,1,1,178,1957,1779
14604,1,1,1445,1784,339
14605,1,1,1654,1426,-228
14606,0,0,10,0,-10
14607,0,0,16,0,-16
14608,1,0,11,0,-11
14609,1,0,253,0,-253
14610,0,0,3,0,-3
14611,1,1,1343,1454,111
14612,0,0,81,0,-81
14613,1,0,103,0,-103
14614,0,0,71,0,-71
14615,1,0,9,0,-9
14616,0,0,49,0,-49
14617,1,1,91,1227,1136
14618,1,1,721,1343,622
14619,1,1,532,1567,1035
14620,1,1,253,1674,1421
14621,1,0,17,0,-17
14622,1,1,555,2048,1493
14623,1,1,328,1365,1037
14624,1,0,67,0,-67
14625,1,0,42,0,-42
14626,1,1,287,1214,927
14627,1,0,7,0,-7
14628,1,1,244,1242,998
14629,0,0,124,0,-124
14630,1,1,503,1252,749
14631,0,0,49,0,-49
14632,0,0,37,0,-37
14633,1,0,15,0,-15
14634,1,0,171,0,-171
14635,1,0,83,0,-83
14636,1,0,179,0,-179
14637,0,0,30,0,-30
14638,1,1,58,1618,1560
14639,0,0,4,0,-4
14640,0,0,52,0,-52
14641,0,0,5,0,-5
14642,1,1,72,1383,1311
14643,0,0,92,0,-92
14644,1,1,312,1380,1068
14645,0,0,50,0,-50
14646,0,0,81,0,-81
14647,0,0,17,0,-17
14648,0,0,34,0,-34
14649,0,0,30,0,-30
14650,1,1,213,1484,1271
14651,1,1,1339,1625,286
14652,0,0,15,0,-15
14653,1,0,47,0,-47
14654,1,0,0,0,0
14655,1,0,29,0,-29
14656,0,0,86,0,-86
14657,1,1,267,1207,940
14658,0,0,26,0,-26
14659,0,0,78,0,-78
14660,0,0,10,0,-10
14661,1,0,31,0,-31
14662,0,0,61,0,-61
14663,0,0,50,0,-50
14664,0,0,131,0,-131
14665,0,0,40,0,-40
14666,1,0,82,0,-82
14667,1,1,506,1475,969
14668,1,1,190,1360,1170
14669,1,1,60,1737,1677
14670,1,1,244,1214,970
14671,1,0,18,0,-18
14672,1,0,16,0,-16
14673,1,0,18,0,-18
14674,1,0,32,0,-32
14675,1,1,87,1432,1345
14676,1,0,12,0,-12
14677,0,0,48,0,-48
14678,0,0,107,0,-107
14679,1,0,5,0,-5
14680,0,0,92,0,-92
14681,0,0,32,0,-32
14682,1,1,725,1491,766
14683,1,0,3,0,-3
14684,0,0,60,0,-60
14685,1,0,126,0,-126
14686,0,0,42,0,-42
14687,0,0,3,0,-3
14688,1,0,20,0,-20
14689,1,0,3,0,-3
14690,0,0,39,0,-39
14691,1,0,31,0,-31
14692,0,0,53,0,-53
14693,1,0,14,0,-14
14694,0,0,123,0,-123
14695,1,1,401,1207,806
14696,0,0,66,0,-66
14697,0,0,20,0,-20
14698,1,0,79,0,-79
14699,1,0,45,0,-45
14700,1,0,15,0,-15
14701,0,0,8,0,-8
14702,0,0,0,0,0
14703,1,0,114,0,-114
14704,1,1,425,1767,1342
14705,1,0,10,0,-10
14706,1,1,1150,2799,1649
14707,1,0,30,0,-30
14708,0,0,13,0,-13
14709,1,1,670,2188,1518
14710,0,0,86,0,-86
14711,0,0,85,0,-85
14712,1,1,166,1363,1197
14713,0,0,19,0,-19
14714,1,0,26,0,-26
14715,1,0,193,0,-193
14716,1,1,1774,1214,-560
14717,0,0,19,0,-19
14718,0,0,83,0,-83
14719,1,1,119,1836,1717
14720,0,0,18,0,-18
14721,1,0,35,0,-35
14722,1,0,28,0,-28
14723,0,0,48,0,-48
14724,1,1,105,1357,1252
14725,0,0,26,0,-26
14726,0,0,89,0,-89
14727,1,0,0,0,0
14728,1,1,892,1869,977
14729,0,0,11,0,-11
14730,0,0,31,0,-31
14731,0,0,80,0,-80
14732,1,0,41,0,-41
14733,1,0,65,0,-65
14734,1,0,107,0,-107
14735,1,1,336,1237,901
14736,1,1,863,3573,2710
14737,1,1,573,1236,663
14738,1,1,146,1410,1264
14739,0,0,33,0,-33
14740,1,1,319,1522,1203
14741,1,1,390,1446,1056
14742,0,0,112,0,-112
14743,0,0,42,0,-42
14744,1,0,63,0,-63
14745,1,1,1048,1338,290
14746,1,0,168,0,-168
14747,1,1,190,1740,1550
14748,1,0,7,0,-7
14749,1,1,696,1477,781
14750,1,0,147,0,-147
14751,1,0,49,0,-49
14752,1,1,1434,2102,668
14753,1,1,99,1430,1331
14754,0,0,11,0,-11
14755,0,0,77,0,-77
14756,1,0,86,0,-86
14757,1,0,9,0,-9
14758,1,1,454,1299,845
14759,1,1,1356,1209,-147
14760,0,0,21,0,-21
14761,1,1,244,1512,1268
14762,0,0,0,0,0
14763,1,1,702,1525,823
14764,1,0,22,0,-22
14765,1,1,183,1472,1289
14766,1,1,1865,1278,-587
14767,0,0,12,0,-12
14768,1,1,1660,1301,-359
14769,0,0,17,0,-17
14770,1,1,365,1287,922
14771,0,0,18,0,-18
14772,0,0,3,0,-3
14773,1,1,92,1373,1281
14774,1,1,424,3534,3110
14775,0,0,55,0,-55
14776,1,1,324,1894,1570
14777,0,0,10,0,-10
14778,1,0,12,0,-12
14779,0,0,49,0,-49
14780,1,1,598,1616,1018
14781,0,0,19,0,-19
14782,1,1,263,1625,1362
14783,1,1,977,1323,346
14784,1,0,84,0,-84
14785,1,1,460,1305,845
14786,0,0,38,0,-38
14787,1,1,273,2234,1961
14788,0,0,22,0,-22
14789,1,1,1102,1568,466
14790,0,0,91,0,-91
14791,1,0,37,0,-37
14792,1,0,6,0,-6
14793,0,0,16,0,-16
14794,0,0,7,0,-7
14795,0,0,33,0,-33
14796,1,0,16,0,-16
14797,0,0,112,0,-112
14798,0,0,18,0,-18
14799,1,0,101,0,-101
14800,1,0,15,0,-15
14801,0,0,37,0,-37
14802,1,1,454,1383,929
14803,0,0,37,0,-37
14804,1,1,511,1301,790
14805,1,0,9,0,-9
14806,0,0,16,0,-16
14807,1,1,1011,1226,215
14808,1,1,1891,1392,-499
14809,1,1,799,1224,425
14810,0,0,19,0,-19
14811,0,0,7,0,-7
14812,1,0,11,0,-11
14813,0,0,9,0,-9
14814,1,0,16,0,-16
14815,0,0,19,0,-19
14816,0,0,113,0,-113
14817,0,0,40,0,-40
14818,1,0,12,0,-12
14819,0,0,16,0,-16
14820,0,0,13,0,-13
14821,0,0,21,0,-21
14822,0,0,19,0,-19
14823,1,0,25,0,-25
14824,1,0,66,0,-66
14825,1,0,164,0,-164
14826,0,0,4,0,-4
14827,0,0,180,0,-180
14828,1,1,982,1484,502
14829,1,0,10,0,-10
14830,0,0,108,0,-108
14831,0,0,22,0,-22
14832,1,0,49,0,-49
14833,1,0,6,0,-6
14834,1,0,13,0,-13
14835,1,1,950,1300,350
14836,1,1,553,2830,2277
14837,0,0,31,0,-31
14838,1,1,952,1286,334
14839,1,1,118,1399,1281
14840,0,0,14,0,-14
14841,1,1,971,1391,420
14842,0,0,5,0,-5
14843,0,0,69,0,-69
14844,1,1,68,1327,1259
14845,1,1,161,1264,1103
14846,0,0,10,0,-10
14847,0,0,70,0,-70
14848,1,0,54,0,-54
14849,0,0,66,0,-66
14850,1,1,302,1423,1121
14851,1,1,664,1428,764
14852,1,1,259,1323,1064
14853,1,0,7,0,-7
14854,1,0,35,0,-35
14855,1,1,805,1247,442
14856,0,0,164,0,-164
14857,1,1,483,2670,2187
14858,1,0,34,0,-34
14859,1,0,8,0,-8
14860,1,1,95,1844,1749
14861,1,0,1,0,-1
14862,1,0,58,0,-58
14863,0,0,45,0,-45
14864,1,0,68,0,-68
14865,1,1,298,1343,1045
14866,1,1,111,1232,1121
14867,1,1,235,1323,1088
14868,1,1,643,1223,580
14869,1,1,284,1392,1108
14870,1,1,368,1432,1064
14871,1,0,30,0,-30
14872,1,1,1085,2947,1862
14873,1,1,195,3642,3447
14874,0,0,12,0,-12
14875,1,1,612,2906,2294
14876,1,1,636,1545,909
14877,0,0,76,0,-76
14878,1,0,112,0,-112
14879,0,0,38,0,-38
14880,1,0,2,0,-2
14881,0,0,13,0,-13
14882,0,0,66,0,-66
14883,1,1,79,2052,1973
14884,1,0,78,0,-78
14885,1,0,113,0,-113
14886,1,1,383,1269,886
14887,0,0,57,0,-57
14888,0,0,63,0,-63
14889,1,0,122,0,-122
14890,1,0,14,0,-14
14891,1,1,1696,2276,580
14892,1,1,534,1595,1061
14893,0,0,0,0,0
14894,1,1,165,1259,1094
14895,1,0,92,0,-92
14896,1,0,47,0,-47
14897,0,0,56,0,-56
14898,1,0,104,0,-104
14899,0,0,14,0,-14
14900,1,1,410,1418,1008
14901,1,1,613,2005,1392
14902,1,0,24,0,-24
14903,1,1,460,5402,4942
14904,1,0,21,0,-21
14905,1,1,574,1495,921
14906,0,0,49,0,-49
14907,1,0,153,0,-153
14908,0,0,62,0,-62
14909,1,1,1138,1215,77
14910,1,0,24,0,-24
14911,0,0,20,0,-20
14912,0,0,101,0,-101
14913,0,0,43,0,-43
14914,1,0,49,0,-49
14915,0,0,72,0,-72
14916,1,1,167,1235,1068
14917,1,1,647,1298,651
14918,0,0,4,0,-4
14919,1,0,29,0,-29
14920,1,0,83,0,-83
14921,0,0,42,0,-42
14922,1,1,216,1451,1235
14923,0,0,31,0,-31
14924,0,0,12,0,-12
14925,0,0,47,0,-47
14926,0,0,18,0,-18
14927,1,1,640,1254,614
14928,1,0,43,0,-43
14929,0,0,58,0,-58
14930,0,0,54,0,-54
14931,0,0,51,0,-51
14932,0,0,58,0,-58
14933,1,1,473,1211,738
14934,1,0,28,0,-28
14935,0,0,269,0,-269
14936,1,1,157,1268,1111
14937,1,0,32,0,-32
14938,0,0,226,0,-226
14939,0,0,3,0,-3
14940,1,0,11,0,-11
14941,1,0,24,0,-24
14942,1,0,115,0,-115
14943,0,0,65,0,-65
14944,1,1,395,1329,934
14945,0,0,8,0,-8
14946,1,0,27,0,-27
14947,0,0,121,0,-121
14948,1,0,51,0,-51
14949,0,0,28,0,-28
14950,0,0,166,0,-166
14951,1,0,44,0,-44
14952,1,1,1017,1297,280
14953,1,0,3,0,-3
14954,0,0,78,0,-78
14955,0,0,42,0,-42
14956,0,0,9,0,-9
14957,0,0,39,0,-39
14958,1,0,69,0,-69
14959,0,0,3,0,-3
14960,1,0,35,0,-35
14961,0,0,39,0,-39
14962,1,0,7,0,-7
14963,1,0,22,0,-22
14964,1,0,21,0,-21
14965,0,0,47,0,-47
14966,1,0,30,0,-30
14967,0,0,0,0,0
14968,1,1,154,1369,1215
14969,1,0,55,0,-55
14970,1,1,892,1509,617
14971,1,0,11,0,-11
14972,0,0,104,0,-104
14973,0,0,112,0,-112
14974,0,0,22,0,-22
14975,0,0,140,0,-140
14976,1,0,51,0,-51
14977,0,0,31,0,-31
14978,0,0,22,0,-22
14979,1,1,145,2383,2238
14980,0,0,54,0,-54
14981,1,0,1,0,-1
14982,1,1,613,1326,713
14983,0,0,74,0,-74
14984,0,0,8,0,-8
14985,0,0,8,0,-8
14986,1,1,437,1387,950
14987,0,0,98,0,-98
14988,1,1,388,1308,920
14989,1,0,74,0,-74
14990,1,1,529,1470,941
14991,1,1,523,1624,1101
14992,1,0,24,0,-24
14993,1,1,732,1627,895
14994,1,1,468,1228,760
14995,0,0,1,0,-1
14996,0,0,14,0,-14
14997,0,0,40,0,-40
14998,1,1,115,1383,1268
14999,1,0,64,0,-64
15000,1,0,12,0,-12
15001,0,0,136,0,-136
15002,0,0,112,0,-112
15003,1,0,3,0,-3
15004,1,1,40,2258,2218
15005,1,0,31,0,-31
15006,1,1,284,1317,1033
15007,1,1,675,1223,548
15008,0,0,78,0,-78
15009,1,1,430,1331,901
15010,1,0,51,0,-51
15011,1,0,199,0,-199
15012,1,0,24,0,-24
15013,0,0,16,0,-16
15014,0,0,33,0,-33
15015,1,0,32,0,-32
15016,1,1,252,1285,1033
15017,0,0,18,0,-18
15018,0,0,75,0,-75
15019,1,1,204,1404,1200
15020,1,0,25,0,-25
15021,1,0,6,0,-6
15022,0,0,4,0,-4
15023,1,0,118,0,-118
15024,0,0,59,0,-59
15025,0,0,12,0,-12
15026,0,0,71,0,-71
15027,1,0,8,0,-8
15028,1,1,1599,2193,594
15029,1,0,33,0,-33
15030,0,0,2,0,-2
15031,1,0,31,0,-31
15032,1,0,41,0,-41
15033,1,1,827,1362,535
15034,1,0,30,0,-30
15035,0,0,5,0,-5
15036,0,0,57,0,-57
15037,1,0,38,0,-38
15038,1,1,618,1505,887
15039,0,0,24,0,-24
15040,0,0,30,0,-30
15041,1,1,75,2092,2017
15042,1,0,133,0,-133
15043,0,0,21,0,-21
15044,1,0,29,0,-29
15045,0,0,4,0,-4
15046,1,0,100,0,-100
15047,0,0,3,0,-3
15048,1,0,1,0,-1
15049,1,1,131,1298,1167
15050,1,1,740,1713,973
15051,1,1,532,1365,833
15052,0,0,49,0,-49
15053,1,0,48,0,-48
15054,0,0,0,0,0
15055,0,0,32,0,-32
15056,0,0,82,0,-82
15057,0,0,19,0,-19
15058,0,0,11,0,-11
15059,0,0,0,0,0
15060,1,0,90,0,-90
15061,0,0,23,0,-23
15062,1,1,91,1635,1544
15063,0,0,54,0,-54
15064,0,0,9,0,-9
15065,0,0,100,0,-100
15066,0,0,106,0,-106
15067,0,0,100,0,-100
15068,1,0,53,0,-53
15069,0,0,36,0,-36
15070,1,1,174,1550,1376
15071,1,0,6,0,-6
15072,0,0,8,0,-8
15073,1,1,209,1497,1288
15074,1,0,58,0,-58
15075,0,0,70,0,-70
15076,1,1,307,1268,961
15077,1,0,32,0,-32
15078,1,1,193,1401,1208
15079,0,0,81,0,-81
15080,1,0,26,0,-26
15081,1,1,830,1709,879
15082,1,1,219,1374,1155
15083,1,0,28,0,-28
15084,0,0,92,0,-92
15085,0,0,12,0,-12
15086,0,0,53,0,-53
15087,1,1,98,1392,1294
15088,0,0,133,0,-133
15089,1,1,307,1371,1064
15090,1,0,53,0,-53
15091,1,1,401,1390,989
15092,1,1,766,1325,559
15093,1,0,188,0,-188
15094,1,1,1449,3473,2024
15095,1,0,51,0,-51
15096,1,1,602,1417,815
15097,1,0,25,0,-25
15098,1,0,61,0,-61
15099,0,0,58,0,-58
15100,0,0,139,0,-139
15101,1,1,824,2134,1310
15102,0,0,115,0,-115
15103,1,1,299,1262,963
15104,1,1,283,1537,1254
15105,1,0,8,0,-8
15106,0,0,29,0,-29
15107,1,0,21,0,-21
15108,1,1,1123,3114,1991
15109,0,0,10,0,-10
15110,0,0,68,0,-68
15111,1,0,145,0,-145
15112,0,0,65,0,-65
15113,1,1,774,1332,558
15114,1,1,201,1477,1276
15115,0,0,40,0,-40
15116,1,1,266,1548,1282
15117,1,1,222,1627,1405
15118,0,0,9,0,-9
15119,1,0,126,0,-126
15120,1,1,572,1612,1040
15121,0,0,1,0,-1
15122,1,1,830,1659,829
15123,1,1,317,1543,1226
15124,1,1,94,1464,1370
15125,0,0,0,0,0
15126,1,1,1494,1281,-213
15127,1,1,307,1770,1463
15128,1,0,108,0,-108
15129,0,0,37,0,-37
15130,0,0,16,0,-16
15131,1,1,732,1222,490
15132,1,1,1182,1379,197
15133,0,0,6,0,-6
15134,1,1,324,1986,1662
15135,1,0,16,0,-16
15136,1,0,9,0,-9
15137,1,0,18,0,-18
15138,0,0,50,0,-50
15139,0,0,91,0,-91
15140,1,1,115,2044,1929
15141,0,0,46,0,-46
15142,0,0,88,0,-88
15143,1,0,33,0,-33
15144,1,1,499,1520,1021
15145,0,0,60,0,-60
15146,1,0,35,0,-35
15147,0,0,35,0,-35
15148,1,0,166,0,-166
15149,0,0,12,0,-12
15150,1,1,220,1742,1522
15151,1,1,161,1296,1135
15152,0,0,22,0,-22
15153,0,0,0,0,0
15154,1,1,813,1573,760
15155,1,1,529,1243,714
15156,0,0,30,0,-30
15157,1,0,46,0,-46
15158,0,0,150,0,-150
15159,1,1,96,1361,1265
15160,0,0,31,0,-31
15161,0,0,94,0,-94
15162,1,1,794,1454,660
15163,0,0,55,0,-55
15164,0,0,37,0,-37
15165,1,1,600,1776,1176
15166,0,0,98,0,-98
15167,1,1,353,1639,1286
15168,1,1,363,1401,1038
15169,1,1,1086,1230,144
15170,1,0,94,0,-94
15171,1,1,1342,1270,-72
15172,1,1,130,1298,1168
15173,0,0,10,0,-10
15174,0,0,55,0,-55
15175,1,0,35,0,-35
15176,0,0,11,0,-11
15177,1,1,19,1450,1431
15178,0,0,45,0,-45
15179,0,0,144,0,-144
15180,1,0,22,0,-22
15181,1,0,40,0,-40
15182,1,0,69,0,-69
15183,1,0,19,0,-19
15184,0,0,51,0,-51
15185,1,1,970,1438,468
15186,1,1,465,1526,1061
15187,0,0,2,0,-2
15188,1,0,22,0,-22
15189,1,0,58,0,-58
15190,0,0,75,0,-75
15191,1,0,4,0,-4
15192,0,0,8,0,-8
15193,1,1,294,1224,930
15194,1,0,6,0,-6
15195,1,1,203,1322,1119
15196,0,0,18,0,-18
15197,1,0,102,0,-102
15198,1,0,0,0,0
15199,1,1,738,1278,540
15200,0,0,23,0,-23
15201,1,1,576,1275,699
15202,0,0,37,0,-37
15203,1,0,37,0,-37
15204,1,1,646,3103,2457
15205,0,0,74,0,-74
15206,0,0,33,0,-33
15207,0,0,65,0,-65
15208,1,1,52,1388,1336
15209,1,0,23,0,-23
15210,1,1,152,1294,1142
15211,0,0,149,0,-149
15212,0,0,69,0,-69
15213,1,0,89,0,-89
15214,1,1,1313,1255,-58
15215,1,1,338,1669,1331
15216,0,0,31,0,-31
15217,0,0,48,0,-48
15218,1,1,173,1231,1058
15219,0,0,89,0,-89
15220,0,0,7,0,-7
15221,0,0,17,0,-17
15222,0,0,63,0,-63
15223,0,0,37,0,-37
15224,1,1,99,3095,2996
15225,0,0,39,0,-39
15226,0,0,44,0,-44
15227,1,0,47,0,-47
15228,1,1,940,1560,620
15229,0,0,14,0,-14
15230,0,0,37,0,-37
15231,1,1,80,1200,1120
15232,0,0,27,0,-27
15233,0,0,9,0,-9
15234,1,1,371,1579,1208
15235,0,0,49,0,-49
15236,1,0,2,0,-2
15237,1,1,317,1264,947
15238,1,1,380,1896,1516
15239,0,0,9,0,-9
15240,0,0,138,0,-138
15241,1,1,738,1626,888
15242,1,1,75,1393,1318
15243,1,0,77,0,-77
15244,0,0,80,0,-80
15245,0,0,251,0,-251
15246,1,0,79,0,-79
15247,1,0,45,0,-45
15248,1,0,24,0,-24
15249,1,1,1008,1853,845
15250,1,1,1865,1360,-505
15251,0,0,68,0,-68
15252,1,0,108,0,-108
15253,0,0,59,0,-59
15254,1,0,26,0,-26
15255,1,1,342,2056,1714
15256,0,0,21,0,-21
15257,1,1,1523,2511,988
15258,0,0,23,0,-23
15259,1,1,1150,1596,446
15260,1,1,683,2449,1766
15261,0,0,54,0,-54
15262,0,0,44,0,-44
15263,0,0,42,0,-42
15264,0,0,22,0,-22
15265,0,0,40,0,-40
15266,0,0,16,0,-16
15267,1,1,233,1506,1273
15268,1,0,10,0,-10
15269,1,0,24,0,-24
15270,0,0,97,0,-97
15271,1,0,3,0,-3
15272,1,1,59,2028,1969
15273,1,0,9,0,-9
15274,0,0,134,0,-134
15275,1,0,76,0,-76
15276,1,1,156,1767,1611
15277,0,0,14,0,-14
15278,0,0,171,0,-171
15279,0,0,61,0,-61
15280,1,0,28,0,-28
15281,0,0,16,0,-16
15282,0,0,12,0,-12
15283,1,1,165,1798,1633
15284,1,1,491,1528,1037
15285,1,0,77,0,-77
15286,1,1,168,1545,1377
15287,1,0,10,0,-10
15288,1,0,31,0,-31
15289,1,0,91,0,-91
15290,0,0,13,0,-13
15291,1,1,82,1312,1230
15292,1,0,97,0,-97
15293,1,1,92,1240,1148
15294,0,0,15,0,-15
15295,0,0,276,0,-276
15296,0,0,42,0,-42
15297,1,0,9,0,-9
15298,1,1,130,1683,1553
15299,1,0,86,0,-86
15300,1,0,1,0,-1
15301,0,0,93,0,-93
15302,0,0,82,0,-82
15303,0,0,109,0,-109
15304,0,0,16,0,-16
15305,1,1,224,1207,983
15306,0,0,43,0,-43
15307,0,0,37,0,-37
15308,0,0,0,0,0
15309,1,0,25,0,-25
15310,0,0,44,0,-44
15311,0,0,14,0,-14
15312,1,1,164,1924,1760
15313,0,0,18,0,-18
15314,0,0,16,0,-16
15315,0,0,7,0,-7
15316,0,0,10,0,-10
15317,1,0,57,0,-57
15318,0,0,112,0,-112
15319,1,0,34,0,-34
15320,1,1,431,1394,963
15321,0,0,65,0,-65
15322,1,0,11,0,-11
15323,1,1,407,1469,1062
15324,0,0,32,0,-32
15325,1,1,378,1280,902
15326,1,1,753,1344,591
15327,1,0,213,0,-213
15328,0,0,38,0,-38
15329,1,1,67,1255,1188
15330,1,1,133,1338,1205
15331,0,0,159,0,-159
15332,0,0,17,0,-17
15333,0,0,4,0,-4
15334,1,1,261,1216,955
15335,0,0,34,0,-34
15336,1,0,6,0,-6
15337,0,0,108,0,-108
15338,1,0,59,0,-59
15339,0,0,12,0,-12
15340,0,0,20,0,-20
15341,1,0,9,0,-9
15342,0,0,19,0,-19
15343,1,1,218,1213,995
15344,0,0,62,0,-62
15345,1,1,116,1364,1248
15346,1,1,491,1560,1069
15347,1,0,72,0,-72
15348,0,0,95,0,-95
15349,0,0,44,0,-44
15350,1,0,71,0,-71
15351,0,0,15,0,-15
15352,1,1,195,1496,1301
15353,1,1,387,2123,1736
15354,1,0,23,0,-23
15355,0,0,7,0,-7
15356,1,0,2,0,-2
15357,1,1,141,1361,1220
15358,1,0,93,0,-93
15359,1,0,30,0,-30
15360,1,0,14,0,-14
15361,0,0,13,0,-13
15362,0,0,20,0,-20
15363,1,1,774,2223,1449
15364,0,0,18,0,-18
15365,0,0,120,0,-120
15366,0,0,15,0,-15
15367,0,0,36,0,-36
15368,1,0,2,0,-2
15369,1,0,24,0,-24
15370,0,0,67,0,-67
15371,1,0,10,0,-10
15372,1,0,23,0,-23
15373,0,0,0,0,0
15374,0,0,28,0,-28
15375,1,1,914,1515,601
15376,0,0,62,0,-62
15377,1,1,619,1651,1032
15378,1,1,192,1787,1595
15379,1,1,195,1410,1215
15380,0,0,48,0,-48
15381,0,0,63,0,-63
15382,1,0,12,0,-12
15383,0,0,179,0,-179
15384,1,1,1114,1451,337
15385,0,0,25,0,-25
15386,1,0,4,0,-4
15387,0,0,66,0,-66
15388,1,0,6,0,-6
15389,0,0,3,0,-3
15390,1,1,194,1761,1567
15391,0,0,60,0,-60
15392,1,0,27,0,-27
15393,0,0,61,0,-61
15394,0,0,21,0,-21
15395,0,0,25,0,-25
15396,0,0,54,0,-54
15397,0,0,69,0,-69
15398,1,0,21,0,-21
15399,1,1,1511,1211,-300
15400,1,0,45,0,-45
15401,0,0,4,0,-4
15402,0,0,31,0,-31
15403,0,0,65,0,-65
15404,0,0,74,0,-74
15405,0,0,7,0,-7
15406,1,1,522,1379,857
15407,0,0,48,0,-48
15408,0,0,13,0,-13
15409,1,0,52,0,-52
15410,0,0,2,0,-2
15411,1,0,49,0,-49
15412,1,0,28,0,-28
15413,0,0,56,0,-56
15414,1,1,130,1324,1194
15415,0,0,14,0,-14
15416,0,0,141,0,-141
15417,1,1,317,1911,1594
15418,1,0,38,0,-38
15419,0,0,124,0,-124
15420,1,1,96,1731,1635
15421,1,1,615,1250,635
15422,0,0,16,0,-16
15423,1,1,584,1282,698
15424,0,0,75,0,-75
15425,0,0,52,0,-52
15426,0,0,64,0,-64
15427,1,0,157,0,-157
15428,1,1,77,1247,1170
15429,1,1,348,3036,2688
15430,1,0,68,0,-68
15431,0,0,17,0,-17
15432,1,1,691,1213,522
15433,0,0,55,0,-55
15434,0,0,20,0,-20
15435,1,0,183,0,-183
15436,1,1,238,1808,1570
15437,0,0,198,0,-198
15438,1,0,16,0,-16
15439,0,0,45,0,-45
15440,1,0,14,0,-14
15441,0,0,34,0,-34
15442,0,0,62,0,-62
15443,1,0,32,0,-32
15444,1,1,90,1731,1641
15445,0,0,33,0,-33
15446,1,1,20,1470,1450
15447,0,0,0,0,0
15448,0,0,82,0,-82
15449,1,0,157,0,-157
15450,1,0,24,0,-24
15451,0,0,115,0,-115
15452,1,0,5,0,-5
15453,1,1,155,1401,1246
15454,1,1,938,1343,405
15455,1,1,495,1279,784
15456,0,0,42,0,-42
15457,1,0,75,0,-75
15458,1,0,4,0,-4
15459,1,1,697,1222,525
15460,1,0,42,0,-42
15461,0,0,6,0,-6
15462,1,1,2773,1304,-1469
15463,1,1,42,1818,1776
15464,1,1,118,1466,1348
15465,1,1,462,2469,2007
15466,1,1,293,2176,1883
15467,1,1,72,1463,1391
15468,1,0,194,0,-194
15469,1,1,633,1245,612
15470,1,1,76,1308,1232
15471,1,1,1257,1409,152
15472,0,0,225,0,-225
15473,0,0,237,0,-237
15474,0,0,7,0,-7
15475,1,1,338,1498,1160
15476,1,0,44,0,-44
15477,0,0,3,0,-3
15478,1,1,913,1252,339
15479,1,0,93,0,-93
15480,1,1,457,1344,887
15481,1,0,15,0,-15
15482,0,0,197,0,-197
15483,1,1,515,1480,965
15484,1,1,70,1267,1197
15485,1,1,91,1508,1417
15486,1,1,450,1533,1083
15487,1,0,24,0,-24
15488,0,0,161,0,-161
15489,0,0,29,0,-29
15490,1,1,488,1495,1007
15491,0,0,32,0,-32
15492,0,0,2,0,-2
15493,1,0,10,0,-10
15494,0,0,41,0,-41
15495,1,1,266,1344,1078
15496,0,0,25,0,-25
15497,0,0,49,0,-49
15498,0,0,79,0,-79
15499,0,0,83,0,-83
15500,0,0,62,0,-62
15501,0,0,11,0,-11
15502,1,0,13,0,-13
15503,1,0,87,0,-87
15504,0,0,58,0,-58
15505,1,1,784,1253,469
15506,1,0,110,0,-110
15507,1,1,220,1278,1058
15508,0,0,22,0,-22
15509,1,0,39,0,-39
15510,1,0,113,0,-113
15511,0,0,104,0,-104
15512,1,1,78,1243,1165
15513,1,1,44,1215,1171
15514,0,0,14,0,-14
15515,1,0,124,0,-124
15516,0,0,5,0,-5
15517,0,0,12,0,-12
15518,1,0,30,0,-30
15519,1,1,158,1310,1152
15520,1,0,73,0,-73
15521,0,0,6,0,-6
15522,1,1,213,1448,1235
15523,1,0,70,0,-70
15524,1,1,442,1219,777
15525,0,0,92,0,-92
15526,1,0,101,0,-101
15527,0,0,14,0,-14
15528,1,1,63,1452,1389
15529,1,0,37,0,-37
15530,0,0,50,0,-50
15531,1,1,264,1218,954
15532,1,0,274,0,-274
15533,0,0,78,0,-78
15534,0,0,25,0,-25
15535,1,0,19,0,-19
15536,1,1,92,1935,1843
15537,0,0,3,0,-3
15538,1,0,28,0,-28
15539,0,0,19,0,-19
15540,1,1,184,1254,1070
15541,1,1,777,1297,520
15542,0,0,32,0,-32
15543,1,1,37,1569,1532
15544,0,0,3,0,-3
15545,0,0,56,0,-56
15546,1,1,319,2231,1912
15547,1,0,45,0,-45
15548,1,1,685,1268,583
15549,0,0,110,0,-110
15550,0,0,118,0,-118
15551,0,0,18,0,-18
15552,0,0,19,0,-19
15553,0,0,60,0,-60
15554,1,0,145,0,-145
15555,1,1,620,1622,1002
15556,1,1,100,1259,1159
15557,1,1,434,1252,818
15558,1,1,667,1374,707
15559,1,0,2,0,-2
15560,1,0,317,0,-317
15561,0,0,37,0,-37
15562,0,0,5,0,-5
15563,0,0,43,0,-43
15564,0,0,50,0,-50
15565,0,0,109,0,-109
15566,1,0,21,0,-21
15567,1,1,394,1410,1016
15568,0,0,128,0,-128
15569,1,0,8,0,-8
15570,0,0,13,0,-13
15571,0,0,85,0,-85
15572,1,0,43,0,-43
15573,1,0,13,0,-13
15574,1,0,106,0,-106
15575,0,0,51,0,-51
15576,1,1,198,1272,1074
15577,1,0,31,0,-31
15578,0,0,44,0,-44
15579,1,1,462,1940,1478
15580,1,1,198,1524,1326
15581,1,1,542,1349,807
15582,1,1,327,1360,1033
15583,0,0,6,0,-6
15584,1,1,251,1657,1406
15585,1,1,115,2289,2174
15586,0,0,28,0,-28
15587,0,0,21,0,-21
15588,0,0,21,0,-21
15589,1,0,24,0,-24
15590,1,1,146,1311,1165
15591,1,1,178,1314,1136
15592,1,0,7,0,-7
15593,0,0,18,0,-18
15594,1,0,105,0,-105
15595,0,0,51,0,-51
15596,1,1,502,1406,904
15597,0,0,189,0,-189
15598,0,0,18,0,-18
15599,1,1,166,1571,1405
15600,1,1,120,1538,1418
15601,0,0,89,0,-89
15602,1,0,87,0,-87
15603,0,0,8,0,-8
15604,0,0,48,0,-48
15605,1,0,53,0,-53
15606,0,0,64,0,-64
15607,0,0,28,0,-28
15608,0,0,40,0,-40
15609,1,1,262,1802,1540
15610,0,0,13,0,-13
15611,1,0,27,0,-27
15612,1,0,63,0,-63
15613,1,1,66,1722,1656
15614,0,0,44,0,-44
15615,0,0,58,0,-58
15616,0,0,100,0,-100
15617,1,1,306,1338,1032
15618,1,0,25,0,-25
15619,0,0,4,0,-4
15620,1,0,4,0,-4
15621,0,0,12,0,-12
15622,0,0,1,0,-1
15623,1,0,23,0,-23
15624,0,0,59,0,-59
15625,1,1,367,1917,1550
15626,1,1,134,1717,1583
15627,1,0,37,0,-37
15628,0,0,72,0,-72
15629,1,1,1387,1974,587
15630,0,0,13,0,-13
15631,1,0,3,0,-3
15632,1,1,91,1683,1592
15633,0,0,29,0,-29
15634,1,0,67,0,-67
15635,1,0,22,0,-22
15636,0,0,8,0,-8
15637,1,1,139,2359,2220
15638,1,0,23,0,-23
15639,1,1,230,1272,1042
15640,0,0,7,0,-7
15641,1,1,1220,1550,330
15642,1,0,167,0,-167
15643,1,0,92,0,-92
15644,1,1,593,2055,1462
15645,0,0,18,0,-18
15646,1,1,1467,2662,1195
15647,0,0,33,0,-33
15648,0,0,77,0,-77
15649,0,0,28,0,-28
15650,0,0,58,0,-58
15651,0,0,6,0,-6
15652,0,0,27,0,-27
15653,0,0,13,0,-13
15654,1,0,2,0,-2
15655,0,0,29,0,-29
15656,0,0,24,0,-24
15657,1,1,491,1432,941
15658,0,0,0,0,0
15659,1,1,440,2240,1800
15660,0,0,72,0,-72
15661,1,0,101,0,-101
15662,1,1,117,2189,2072
15663,0,0,20,0,-20
15664,0,0,60,0,-60
15665,1,1,740,1401,661
15666,1,0,29,0,-29
15667,1,1,637,1304,667
15668,1,1,654,1358,704
15669,1,0,30,0,-30
15670,0,0,30,0,-30
15671,0,0,90,0,-90
15672,1,1,352,1653,1301
15673,0,0,23,0,-23
15674,0,0,4,0,-4
15675,1,0,33,0,-33
15676,0,0,103,0,-103
15677,1,1,389,1310,921
15678,1,0,10,0,-10
15679,0,0,30,0,-30
15680,1,1,248,1223,975
15681,1,1,642,1344,702
15682,0,0,86,0,-86
15683,0,0,7,0,-7
15684,1,0,31,0,-31
15685,1,1,290,5042,4752
15686,0,0,5,0,-5
15687,0,0,1,0,-1
15688,1,0,105,0,-105
15689,0,0,55,0,-55
15690,0,0,50,0,-50
15691,1,0,2,0,-2
15692,1,1,466,2531,2065
15693,0,0,66,0,-66
15694,0,0,24,0,-24
15695,0,0,118,0,-118
15696,1,1,90,1235,1145
15697,0,0,65,0,-65
15698,0,0,22,0,-22
15699,1,0,16,0,-16
15700,0,0,28,0,-28
15701,1,1,140,1452,1312
15702,1,1,318,1397,1079
15703,0,0,85,0,-85
15704,1,0,116,0,-116
15705,1,0,101,0,-101
15706,1,1,236,1203,967
15707,0,0,10,0,-10
15708,1,0,36,0,-36
15709,1,0,34,0,-34
15710,1,1,241,1550,1309
15711,0,0,27,0,-27
15712,1,1,1790,2240,450
15713,1,0,2,0,-2
15714,1,0,35,0,-35
15715,1,1,499,1210,711
15716,1,1,249,1741,1492
15717,0,0,54,0,-54
15718,1,0,15,0,-15
15719,1,1,1109,2574,1465
15720,1,0,60,0,-60
15721,0,0,18,0,-18
15722,0,0,23,0,-23
15723,0,0,50,0,-50
15724,0,0,25,0,-25
15725,0,0,28,0,-28
15726,0,0,30,0,-30
15727,1,0,16,0,-16
15728,1,1,326,1476,1150
15729,1,0,56,0,-56
15730,1,0,28,0,-28
15731,0,0,47,0,-47
15732,0,0,28,0,-28
15733,0,0,15,0,-15
15734,1,0,51,0,-51
15735,0,0,26,0,-26
15736,1,0,40,0,-40
15737,1,0,72,0,-72
15738,1,0,84,0,-84
15739,0,0,93,0,-93
15740,0,0,81,0,-81
15741,1,0,3,0,-3
15742,1,1,291,1247,956
15743,0,0,127,0,-127
15744,1,0,166,0,-166
15745,1,0,234,0,-234
15746,1,0,8,0,-8
15747,0,0,41,0,-41
15748,0,0,2,0,-2
15749,1,1,300,1800,1500
15750,1,1,721,1405,684
15751,1,0,39,0,-39
15752,0,0,4,0,-4
15753,1,1,401,1327,926
15754,0,0,3,0,-3
15755,1,1,68,3153,3085
15756,1,0,105,0,-105
15757,0,0,91,0,-91
15758,1,1,1027,1945,918
15759,1,1,433,1277,844
15760,0,0,230,0,-230
15761,1,1,196,1229,1033
15762,1,1,1285,1894,609
15763,1,1,361,1407,1046
15764,0,0,0,0,0
15765,0,0,9,0,-9
15766,1,0,45,0,-45
15767,1,0,12,0,-12
15768,0,0,66,0,-66
15769,1,0,3,0,-3
15770,0,0,34,0,-34
15771,1,0,6,0,-6
15772,1,0,66,0,-66
15773,1,0,144,0,-144
15774,1,0,0,0,0
15775,1,0,79,0,-79
15776,0,0,26,0,-26
15777,0,0,19,0,-19
15778,1,0,48,0,-48
15779,1,0,9,0,-9
15780,0,0,82,0,-82
15781,0,0,25,0,-25
15782,1,0,6,0,-6
15783,1,1,229,1651,1422
15784,1,1,880,1216,336
15785,1,0,4,0,-4
15786,1,1,50,3074,3024
15787,0,0,42,0,-42
15788,1,0,66,0,-66
15789,1,1,111,1496,1385
15790,1,0,67,0,-67
15791,0,0,74,0,-74
15792,1,0,15,0,-15
15793,1,1,32,1306,1274
15794,0,0,6,0,-6
15795,0,0,105,0,-105
15796,1,1,241,1313,1072
15797,1,1,373,1230,857
15798,0,0,33,0,-33
15799,0,0,42,0,-42
15800,1,0,31,0,-31
15801,1,0,13,0,-13
15802,1,0,45,0,-45
15803,1,0,52,0,-52
15804,1,0,64,0,-64
15805,0,0,31,0,-31
15806,1,0,26,0,-26
15807,1,0,108,0,-108
15808,1,1,1638,1773,135
15809,1,0,5,0,-5
15810,0,0,56,0,-56
15811,1,0,22,0,-22
15812,0,0,60,0,-60
15813,0,0,26,0,-26
15814,1,0,63,0,-63
15815,1,0,122,0,-122
15816,0,0,66,0,-66
15817,0,0,90,0,-90
15818,0,0,71,0,-71
15819,0,0,17,0,-17
15820,1,0,36,0,-36
15821,1,0,9,0,-9
15822,0,0,28,0,-28
15823,0,0,92,0,-92
15824,1,0,149,0,-149
15825,1,0,7,0,-7
15826,1,1,215,1233,1018
15827,1,0,11,0,-11
15828,1,1,629,1279,650
15829,1,1,581,1326,745
15830,0,0,28,0,-28
15831,0,0,14,0,-14
15832,0,0,53,0,-53
15833,1,1,743,3296,2553
15834,1,0,38,0,-38
15835,1,1,385,1542,1157
15836,1,1,857,1373,516
15837,0,0,28,0,-28
15838,1,0,34,0,-34
15839,1,0,89,0,-89
15840,1,1,311,1200,889
15841,1,0,34,0,-34
15842,1,1,45,1231,1186
15843,0,0,20,0,-20
15844,0,0,75,0,-75
15845,1,0,16,0,-16
15846,1,0,40,0,-40
15847,1,0,8,0,-8
15848,0,0,10,0,-10
15849,1,1,95,1212,1117
15850,0,0,103,0,-103
15851,0,0,50,0,-50
15852,1,0,43,0,-43
15853,1,0,23,0,-23
15854,1,0,133,0,-133
15855,0,0,50,0,-50
15856,1,1,94,1236,1142
15857,1,0,26,0,-26
15858,1,0,45,0,-45
15859,1,0,120,0,-120
15860,0,0,24,0,-24
15861,1,0,15,0,-15
15862,0,0,48,0,-48
15863,1,0,66,0,-66
15864,1,0,5,0,-5
15865,1,1,2165,4071,1906
15866,1,1,572,1503,931
15867,1,0,55,0,-55
15868,1,1,738,1733,995
15869,1,1,555,1794,1239
15870,0,0,7,0,-7
15871,1,1,441,1332,891
15872,1,0,48,0,-48
15873,0,0,101,0,-101
15874,1,0,49,0,-49
15875,0,0,12,0,-12
15876,1,0,74,0,-74
15877,1,0,135,0,-135
15878,1,0,64,0,-64
15879,1,0,33,0,-33
15880,1,1,86,1228,1142
15881,1,1,941,1330,389
15882,1,0,67,0,-67
15883,0,0,8,0,-8
15884,1,0,76,0,-76
15885,0,0,24,0,-24
15886,1,0,5,0,-5
15887,1,0,63,0,-63
15888,1,1,1589,1441,-148
15889,0,0,26,0,-26
15890,0,0,11,0,-11
15891,1,1,396,1437,1041
15892,0,0,128,0,-128
15893,1,1,92,2414,2322
15894,1,0,24,0,-24
15895,0,0,26,0,-26
15896,1,0,116,0,-116
15897,1,0,23,0,-23
15898,0,0,58,0,-58
15899,1,0,15,0,-15
15900,1,1,144,1354,1210
15901,1,0,32,0,-32
15902,1,0,36,0,-36
15903,0,0,9,0,-9
15904,1,1,605,1454,849
15905,0,0,92,0,-92
15906,1,0,66,0,-66
15907,0,0,104,0,-104
15908,0,0,87,0,-87
15909,1,0,201,0,-201
15910,0,0,16,0,-16
15911,0,0,68,0,-68
15912,0,0,39,0,-39
15913,1,0,30,0,-30
15914,0,0,205,0,-205
15915,0,0,98,0,-98
15916,0,0,27,0,-27
15917,0,0,75,0,-75
15918,0,0,28,0,-28
15919,0,0,28,0,-28
15920,0,0,67,0,-67
15921,1,1,761,1338,577
15922,1,1,602,2475,1873
15923,0,0,13,0,-13
15924,1,0,90,0,-90
15925,1,0,28,0,-28
15926,1,1,499,1335,836
15927,0,0,32,0,-32
15928,1,0,97,0,-97
15929,0,0,22,0,-22
15930,0,0,39,0,-39
15931,1,0,3,0,-3
15932,0,0,290,0,-290
15933,1,0,68,0,-68
15934,0,0,198,0,-198
15935,1,1,351,2217,1866
15936,1,0,3,0,-3
15937,1,0,71,0,-71
15938,0,0,100,0,-100
15939,1,0,30,0,-30
15940,1,0,49,0,-49
15941,1,1,889,1308,419
15942,1,1,303,1357,1054
15943,1,1,1020,1202,182
15944,0,0,48,0,-48
15945,1,0,22,0,-22
15946,1,1,332,1239,907
15947,1,1,187,1293,1106
15948,0,0,77,0,-77
15949,1,0,30,0,-30
15950,1,1,561,1767,1206
15951,0,0,11,0,-11
15952,1,0,28,0,-28
15953,0,0,3,0,-3
15954,0,0,12,0,-12
15955,0,0,27,0,-27
15956,1,1,798,1444,646
15957,1,1,28,1616,1588
15958,0,0,39,0,-39
15959,1,0,70,0,-70
15960,0,0,123,0,-123
15961,1,1,203,1626,1423
15962,1,1,620,1220,600
15963,0,0,1,0,-1
15964,1,1,601,1359,758
15965,0,0,8,0,-8
15966,0,0,73,0,-73
15967,1,1,341,1350,1009
15968,0,0,16,0,-16
15969,1,0,48,0,-48
15970,1,1,1928,1606,-322
15971,0,0,86,0,-86
15972,1,1,393,1352,959
15973,1,0,53,0,-53
15974,1,0,48,0,-48
15975,1,0,20,0,-20
15976,0,0,192,0,-192
15977,1,0,41,0,-41
15978,0,0,62,0,-62
15979,0,0,10,0,-10
15980,0,0,38,0,-38
15981,1,1,96,1391,1295
15982,0,0,17,0,-17
15983,0,0,44,0,-44
15984,1,0,9,0,-9
15985,1,1,427,1585,1158
15986,0,0,11,0,-11
15987,0,0,53,0,-53
15988,1,0,59,0,-59
15989,1,0,48,0,-48
15990,1,0,63,0,-63
15991,0,0,104,0,-104
15992,1,1,149,1238,1089
15993,1,1,225,1206,981
15994,1,1,166,1478,1312
15995,1,0,9,0,-9
15996,0,0,3,0,-3
15997,1,0,1,0,-1
15998,1,0,12,0,-12
15999,1,1,170,1448,1278
16000,0,0,99,0,-99
16001,1,0,3,0,-3
16002,1,1,335,1351,1016
16003,1,1,165,1338,1173
16004,1,1,272,1233,961
16005,1,1,657,1224,567
16006,1,1,912,1665,753
16007,1,1,741,2907,2166
16008,0,0,114,0,-114
16009,0,0,20,0,-20
16010,0,0,81,0,-81
16011,1,0,2,0,-2
16012,1,1,724,1301,577
16013,1,0,138,0,-138
16014,0,0,1,0,-1
16015,1,0,46,0,-46
16016,1,1,1085,1407,322
16017,1,1,8,1711,1703
16018,1,0,4,0,-4
16019,1,0,24,0,-24
16020,1,0,89,0,-89
16021,0,0,33,0,-33
16022,1,0,47,0,-47
16023,0,0,24,0,-24
16024,0,0,17,0,-17
16025,1,1,220,1324,1104
16026,1,1,489,1209,720
16027,0,0,53,0,-53
16028,1,1,285,1202,917
16029,1,1,790,1694,904
16030,0,0,3,0,-3
16031,1,0,5,0,-5
16032,0,0,8,0,-8
16033,0,0,5,0,-5
16034,1,0,28,0,-28
16035,1,0,46,0,-46
16036,1,0,14,0,-14
16037,1,0,46,0,-46
16038,1,1,2457,1606,-851
16039,1,1,886,1207,321
16040,1,0,16,0,-16
16041,1,0,5,0,-5
16042,1,0,18,0,-18
16043,1,1,417,1346,929
16044,1,1,1318,1617,299
16045,1,1,458,1254,796
16046,1,1,181,1400,1219
16047,0,0,24,0,-24
16048,0,0,8,0,-8
16049,0,0,119,0,-119
16050,1,0,27,0,-27
16051,1,1,1307,1647,340
16052,1,1,870,1458,588
16053,1,1,195,1457,1262
16054,1,0,4,0,-4
16055,1,0,29,0,-29
16056,0,0,34,0,-34
16057,0,0,4,0,-4
16058,1,1,64,1640,1576
16059,1,0,24,0,-24
16060,1,0,141,0,-141
16061,1,0,16,0,-16
16062,1,0,112,0,-112
16063,1,0,123,0,-123
16064,1,0,35,0,-35
16065,1,0,31,0,-31
16066,0,0,8,0,-8
16067,1,0,84,0,-84
16068,0,0,23,0,-23
16069,1,0,157,0,-157
16070,0,0,24,0,-24
16071,1,1,374,1679,1305
16072,1,0,5,0,-5
16073,1,1,172,2750,2578
16074,1,1,347,1817,1470
16075,1,1,394,3290,2896
16076,1,0,44,0,-44
16077,0,0,38,0,-38
16078,0,0,53,0,-53
16079,1,1,1319,1622,303
16080,0,0,52,0,-52
16081,1,1,269,1383,1114
16082,1,0,66,0,-66
16083,0,0,115,0,-115
16084,1,1,354,1893,1539
16085,0,0,13,0,-13
16086,1,0,0,0,0
16087,1,1,438,2683,2245
16088,1,0,2,0,-2
16089,1,0,98,0,-98
16090,1,1,199,2157,1958
16091,1,0,12,0,-12
16092,0,0,74,0,-74
16093,1,1,1266,1686,420
16094,0,0,26,0,-26
16095,1,0,131,0,-131
16096,0,0,114,0,-114
16097,0,0,26,0,-26
16098,0,0,50,0,-50
16099,1,0,24,0,-24
16100,0,0,9,0,-9
16101,0,0,48,0,-48
16102,0,0,48,0,-48
16103,0,0,0,0,0
16104,0,0,25,0,-25
16105,1,0,12,0,-12
16106,0,0,3,0,-3
16107,1,1,565,1331,766
16108,1,1,645,1808,1163
16109,1,0,68,0,-68
16110,1,0,1,0,-1
16111,1,0,33,0,-33
16112,0,0,19,0,-19
16113,1,0,103,0,-103
16114,1,0,34,0,-34
16115,0,0,38,0,-38
16116,1,0,1,0,-1
16117,1,1,899,1592,693
16118,1,0,28,0,-28
16119,1,0,23,0,-23
16120,1,0,38,0,-38
16121,1,0,5,0,-5
16122,1,0,17,0,-17
16123,1,0,1,0,-1
16124,1,0,2,0,-2
16125,1,1,1023,1694,671
16126,1,1,831,1289,458
16127,1,1,71,2434,2363
16128,0,0,58,0,-58
16129,1,1,468,1662,1194
16130,1,0,9,0,-9
16131,1,1,412,1219,807
16132,1,1,73,1604,1531
16133,1,1,92,1570,1478
16134,0,0,75,0,-75
16135,1,0,29,0,-29
16136,1,1,1045,1267,222
16137,0,0,74,0,-74
16138,1,0,91,0,-91
16139,0,0,23,0,-23
16140,0,0,54,0,-54
16141,0,0,5,0,-5
16142,0,0,28,0,-28
16143,1,0,54,0,-54
16144,0,0,17,0,-17
16145,0,0,13,0,-13
16146,0,0,38,0,-38
16147,1,1,322,1543,1221
16148,0,0,27,0,-27
16149,1,0,1,0,-1
16150,1,1,335,1411,1076
16151,1,0,5,0,-5
16152,1,1,510,1224,714
16153,0,0,38,0,-38
16154,1,1,331,1716,1385
16155,0,0,29,0,-29
16156,1,1,105,1214,1109
16157,0,0,26,0,-26
16158,1,0,75,0,-75
16159,1,0,60,0,-60
16160,1,0,106,0,-106
16161,1,0,77,0,-77
16162,1,0,63,0,-63
16163,1,0,15,0,-15
16164,0,0,116,0,-116
16165,0,0,11,0,-11
16166,0,0,4,0,-4
16167,0,0,134,0,-134
16168,1,1,993,1786,793
16169,1,0,56,0,-56
16170,0,0,223,0,-223
16171,1,0,28,0,-28
16172,1,1,439,1465,1026
16173,0,0,70,0,-70
16174,0,0,108,0,-108
16175,0,0,38,0,-38
16176,0,0,30,0,-30
16177,1,1,2043,2355,312
16178,1,0,7,0,-7
16179,1,0,17,0,-17
16180,0,0,18,0,-18
16181,1,1,214,1310,1096
16182,0,0,3,0,-3
16183,1,1,1705,1365,-340
16184,0,0,188,0,-188
16185,1,0,101,0,-101
16186,1,0,246,0,-246
16187,0,0,37,0,-37
16188,1,0,54,0,-54
16189,1,0,61,0,-61
16190,0,0,17,0,-17
16191,1,0,35,0,-35
16192,1,1,230,1441,1211
16193,0,0,14,0,-14
16194,1,1,143,1425,1282
16195,1,0,59,0,-59
16196,0,0,36,0,-36
16197,0,0,17,0,-17
16198,0,0,33,0,-33
16199,0,0,10,0,-10
16200,1,1,225,1903,1678
16201,0,0,99,0,-99
16202,1,1,1067,1246,179
16203,0,0,36,0,-36
16204,1,0,22,0,-22
16205,1,0,30,0,-30
16206,1,0,40,0,-40
16207,1,1,640,1550,910
16208,0,0,111,0,-111
16209,1,0,91,0,-91
16210,1,0,102,0,-102
16211,0,0,9,0,-9
16212,1,1,577,1468,891
16213,0,0,41,0,-41
16214,0,0,30,0,-30
16215,0,0,140,0,-140
16216,0,0,6,0,-6
16217,0,0,30,0,-30
16218,0,0,10,0,-10
16219,1,1,585,1235,650
16220,1,1,825,2258,1433
16221,1,1,1319,1354,35
16222,0,0,14,0,-14
16223,1,1,882,2176,1294
16224,1,1,434,1419,985
16225,0,0,15,0,-15
16226,1,0,48,0,-48
16227,0,0,71,0,-71
16228,0,0,6,0,-6
16229,1,0,40,0,-40
16230,1,1,125,1289,1164
16231,1,1,130,1279,1149
16232,0,0,34,0,-34
16233,1,1,572,1249,677
16234,0,0,73,0,-73
16235,1,1,259,1318,1059
16236,0,0,8,0,-8
16237,1,1,709,1243,534
16238,0,0,38,0,-38
16239,1,1,670,2503,1833
16240,0,0,69,0,-69
16241,1,1,699,1670,971
16242,0,0,42,0,-42
16243,0,0,9,0,-9
16244,0,0,107,0,-107
16245,0,0,60,0,-60
16246,1,1,192,5881,5689
16247,0,0,56,0,-56
16248,1,0,18,0,-18
16249,0,0,9,0,-9
16250,0,0,58,0,-58
16251,1,0,11,0,-11
16252,1,0,6,0,-6
16253,0,0,1,0,-1
16254,1,1,616,2571,1955
16255,1,0,28,0,-28
16256,1,0,12,0,-12
16257,1,0,41,0,-41
16258,1,0,69,0,-69
16259,1,0,87,0,-87
16260,0,0,21,0,-21
16261,0,0,54,0,-54
16262,0,0,5,0,-5
16263,1,1,78,1236,1158
16264,0,0,4,0,-4
16265,1,1,1223,2866,1643
16266,1,1,349,2351,2002
16267,1,0,41,0,-41
16268,0,0,34,0,-34
16269,1,1,178,2139,1961
16270,0,0,73,0,-73
16271,0,0,89,0,-89
16272,0,0,16,0,-16
16273,1,1,81,1222,1141
16274,0,0,15,0,-15
16275,0,0,9,0,-9
16276,0,0,35,0,-35
16277,1,1,111,1788,1677
16278,1,0,34,0,-34
16279,1,0,32,0,-32
16280,1,1,566,1916,1350
16281,1,0,113,0,-113
16282,0,0,20,0,-20
16283,1,0,59,0,-59
16284,0,0,36,0,-36
16285,0,0,2,0,-2
16286,0,0,75,0,-75
16287,0,0,14,0,-14
16288,1,0,32,0,-32
16289,1,1,493,3137,2644
16290,1,0,152,0,-152
16291,0,0,22,0,-22
16292,0,0,60,0,-60
16293,1,0,73,0,-73
16294,0,0,31,0,-31
16295,0,0,61,0,-61
16296,1,1,780,2721,1941
16297,1,1,589,2324,1735
16298,1,1,942,1595,653
16299,1,1,260,1256,996
16300,0,0,27,0,-27
16301,1,0,4,0,-4
16302,1,1,815,1468,653
16303,1,0,12,0,-12
16304,0,0,126,0,-126
16305,1,0,2,0,-2
16306,0,0,23,0,-23
16307,1,0,9,0,-9
16308,1,1,553,1412,859
16309,1,1,181,1693,1512
16310,1,0,71,0,-71
16311,0,0,35,0,-35
16312,0,0,31,0,-31
16313,1,1,447,2262,1815
16314,1,0,18,0,-18
16315,0,0,26,0,-26
16316,0,0,39,0,-39
16317,1,0,8,0,-8
16318,1,1,715,1207,492
16319,1,1,410,1225,815
16320,1,0,55,0,-55
16321,1,0,19,0,-19
16322,1,1,358,3095,2737
16323,1,1,754,1449,695
16324,1,0,64,0,-64
16325,1,1,482,1465,983
16326,0,0,2,0,-2
16327,0,0,131,0,-131
16328,1,0,27,0,-27
16329,0,0,3,0,-3
16330,1,0,15,0,-15
16331,0,0,47,0,-47
16332,1,1,1628,2708,1080
16333,1,0,0,0,0
16334,1,1,257,1352,1095
16335,1,1,195,1226,1031
16336,1,1,18,1207,1189
16337,0,0,7,0,-7
16338,1,0,53,0,-53
16339,0,0,42,0,-42
16340,1,1,170,2728,2558
16341,1,0,35,0,-35
16342,1,1,166,1555,1389
16343,1,1,116,1293,1177
16344,1,0,30,0,-30
16345,0,0,1,0,-1
16346,0,0,21,0,-21
16347,0,0,5,0,-5
16348,1,1,204,1550,1346
16349,0,0,0,0,0
16350,0,0,0,0,0
16351,1,1,352,1629,1277
16352,1,1,111,1246,1135
16353,1,0,21,0,-21
16354,1,1,20,1218,1198
16355,1,0,26,0,-26
16356,0,0,27,0,-27
16357,0,0,15,0,-15
16358,0,0,18,0,-18
16359,0,0,26,0,-26
16360,1,1,956,1481,525
16361,1,1,328,1275,947
16362,0,0,10,0,-10
16363,0,0,3,0,-3
16364,1,0,28,0,-28
16365,1,0,42,0,-42
16366,1,1,315,1210,895
16367,1,1,97,1845,1748
16368,0,0,21,0,-21
16369,1,1,315,1210,895
16370,0,0,7,0,-7
16371,1,1,510,1230,720
16372,1,0,17,0,-17
16373,0,0,50,0,-50
16374,1,0,34,0,-34
16375,0,0,27,0,-27
16376,1,0,58,0,-58
16377,1,0,15,0,-15
16378,0,0,24,0,-24
16379,0,0,275,0,-275
16380,1,0,70,0,-70
16381,0,0,94,0,-94
16382,0,0,56,0,-56
16383,1,1,690,1287,597
16384,0,0,43,0,-43
16385,1,1,220,1238,1018
16386,0,0,19,0,-19
16387,1,1,1203,1768,565
16388,1,0,70,0,-70
16389,1,1,675,1640,965
16390,1,1,716,1292,576
16391,1,1,751,1481,730
16392,1,0,50,0,-50
16393,0,0,51,0,-51
16394,1,0,30,0,-30
16395,1,1,121,2098,1977
16396,0,0,124,0,-124
16397,1,0,21,0,-21
16398,1,1,208,1263,1055
16399,1,1,427,1282,855
16400,1,1,127,1499,1372
16401,1,0,50,0,-50
16402,0,0,127,0,-127
16403,1,0,110,0,-110
16404,1,1,696,1268,572
16405,1,0,39,0,-39
16406,1,0,18,0,-18
16407,0,0,40,0,-40
16408,0,0,41,0,-41
16409,0,0,39,0,-39
16410,0,0,13,0,-13
16411,1,0,88,0,-88
16412,1,1,39,2544,2505
16413,1,1,552,2119,1567
16414,1,0,15,0,-15
16415,1,0,8,0,-8
16416,0,0,26,0,-26
16417,1,1,462,1293,831
16418,1,0,42,0,-42
16419,1,1,127,1377,1250
16420,1,1,327,1376,1049
16421,1,1,866,2213,1347
16422,1,1,299,2246,1947
16423,0,0,7,0,-7
16424,1,1,204,1585,1381
16425,1,1,339,1230,891
16426,1,0,13,0,-13
16427,1,0,211,0,-211
16428,0,0,85,0,-85
16429,0,0,13,0,-13
16430,0,0,18,0,-18
16431,0,0,196,0,-196
16432,1,1,407,1415,1008
16433,0,0,14,0,-14
16434,1,0,24,0,-24
16435,1,0,13,0,-13
16436,0,0,72,0,-72
16437,0,0,73,0,-73
16438,0,0,10,0,-10
16439,0,0,4,0,-4
16440,0,0,39,0,-39
16441,0,0,113,0,-113
16442,0,0,5,0,-5
16443,0,0,34,0,-34
16444,1,0,38,0,-38
16445,1,0,10,0,-10
16446,1,1,52,1493,1441
16447,0,0,30,0,-30
16448,0,0,112,0,-112
16449,0,0,24,0,-24
16450,1,0,17,0,-17
16451,1,0,11,0,-11
16452,0,0,4,0,-4
16453,1,0,48,0,-48
16454,0,0,39,0,-39
16455,1,0,20,0,-20
16456,0,0,247,0,-247
16457,1,1,301,2135,1834
16458,0,0,71,0,-71
16459,1,1,282,1248,966
16460,1,0,120,0,-120
16461,1,1,207,1270,1063
16462,1,0,69,0,-69
16463,1,1,94,1607,1513
16464,0,0,46,0,-46
16465,1,1,118,1536,1418
16466,0,0,34,0,-34
16467,0,0,3,0,-3
16468,0,0,243,0,-243
16469,0,0,49,0,-49
16470,1,1,228,1257,1029
16471,0,0,77,0,-77
16472,1,1,1154,1487,333
16473,1,1,244,1250,1006
16474,1,0,33,0,-33
16475,0,0,3,0,-3
16476,1,0,30,0,-30
16477,1,0,4,0,-4
16478,0,0,74,0,-74
16479,1,1,682,1529,847
16480,1,1,491,1238,747
16481,0,0,7,0,-7
16482,1,1,136,1331,1195
16483,1,1,591,2409,1818
16484,0,0,64,0,-64
16485,1,0,16,0,-16
16486,1,0,214,0,-214
16487,1,0,33,0,-33
16488,0,0,75,0,-75
16489,1,1,758,1748,990
16490,1,1,1052,1458,406
16491,1,1,454,1219,765
16492,1,1,239,1593,1354
16493,0,0,15,0,-15
16494,1,1,690,1200,510
16495,0,0,17,0,-17
16496,1,0,42,0,-42
16497,1,0,103,0,-103
16498,1,1,182,1322,1140
16499,1,1,224,1353,1129
16500,1,1,122,1208,1086
16501,1,0,147,0,-147
16502,1,0,46,0,-46
16503,1,0,30,0,-30
16504,1,1,1076,2025,949
16505,1,1,821,2077,1256
16506,1,0,19,0,-19
16507,1,0,12,0,-12
16508,1,1,715,1988,1273
16509,1,0,18,0,-18
16510,1,0,91,0,-91
16511,0,0,9,0,-9
16512,1,0,24,0,-24
16513,0,0,73,0,-73
16514,1,1,954,1241,287
16515,1,0,53,0,-53
16516,0,0,58,0,-58
16517,1,1,101,1202,1101
16518,1,1,162,1228,1066
16519,1,1,207,1566,1359
16520,0,0,15,0,-15
16521,0,0,128,0,-128
16522,0,0,21,0,-21
16523,1,1,880,1736,856
16524,1,1,191,1286,1095
16525,1,0,41,0,-41
16526,1,0,45,0,-45
16527,0,0,31,0,-31
16528,1,1,133,1370,1237
16529,0,0,58,0,-58
16530,0,0,35,0,-35
16531,1,1,321,1805,1484
16532,0,0,18,0,-18
16533,0,0,31,0,-31
16534,1,1,397,2300,1903
16535,1,0,8,0,-8
16536,1,1,948,2181,1233
16537,0,0,26,0,-26
16538,0,0,41,0,-41
16539,1,0,80,0,-80
16540,0,0,33,0,-33
16541,0,0,77,0,-77
16542,0,0,15,0,-15
16543,1,0,33,0,-33
16544,1,0,26,0,-26
16545,1,0,28,0,-28
16546,1,0,5,0,-5
16547,1,1,501,2343,1842
16548,1,0,1,0,-1
16549,0,0,22,0,-22
16550,0,0,33,0,-33
16551,0,0,11,0,-11
16552,0,0,4,0,-4
16553,0,0,8,0,-8
16554,1,0,29,0,-29
16555,1,1,686,1486,800
16556,1,1,306,1437,1131
16557,0,0,22,0,-22
16558,1,1,720,1326,606
16559,0,0,134,0,-134
16560,0,0,9,0,-9
16561,0,0,42,0,-42
16562,1,1,353,2704,2351
16563,0,0,129,0,-129
16564,1,0,17,0,-17
16565,1,0,112,0,-112
16566,1,0,45,0,-45
16567,0,0,90,0,-90
16568,0,0,124,0,-124
16569,1,1,352,1462,1110
16570,1,1,26,1293,1267
16571,1,1,224,1307,1083
16572,1,0,8,0,-8
16573,1,1,1287,1450,163
16574,1,1,980,1313,333
16575,1,1,290,1234,944
16576,0,0,48,0,-48
16577,0,0,142,0,-142
16578,1,1,189,1781,1592
16579,1,0,43,0,-43
16580,0,0,18,0,-18
16581,1,1,263,2036,1773
16582,1,1,98,1234,1136
16583,1,1,623,1233,610
16584,0,0,39,0,-39
16585,1,0,11,0,-11
16586,1,1,144,1222,1078
16587,1,0,49,0,-49
16588,1,0,47,0,-47
16589,1,1,616,1805,1189
16590,1,0,25,0,-25
16591,0,0,51,0,-51
16592,1,1,773,1233,460
16593,1,1,359,1604,1245
16594,0,0,3,0,-3
16595,1,0,2,0,-2
16596,1,0,108,0,-108
16597,0,0,20,0,-20
16598,1,1,107,1477,1370
16599,1,1,316,1215,899
16600,1,1,1352,1305,-47
16601,1,0,11,0,-11
16602,1,0,13,0,-13
16603,0,0,85,0,-85
16604,0,0,34,0,-34
16605,1,1,764,1312,548
16606,0,0,107,0,-107
16607,1,1,468,1849,1381
16608,0,0,62,0,-62
16609,0,0,19,0,-19
16610,1,0,92,0,-92
16611,1,0,35,0,-35
16612,0,0,17,0,-17
16613,0,0,22,0,-22
16614,1,0,1,0,-1
16615,0,0,142,0,-142
16616,1,1,557,1218,661
16617,0,0,6,0,-6
16618,1,0,27,0,-27
16619,1,0,26,0,-26
16620,0,0,48,0,-48
16621,0,0,17,0,-17
16622,0,0,57,0,-57
16623,1,1,817,1719,902
16624,1,1,137,4795,4658
16625,0,0,39,0,-39
16626,0,0,35,0,-35
16627,0,0,162,0,-162
16628,1,1,98,1444,1346
16629,0,0,20,0,-20
16630,1,0,8,0,-8
16631,0,0,75,0,-75
16632,1,0,74,0,-74
16633,1,0,43,0,-43
16634,1,0,17,0,-17
16635,0,0,44,0,-44
16636,1,1,103,1276,1173
16637,1,1,194,1594,1400
16638,0,0,21,0,-21
16639,0,0,69,0,-69
16640,1,0,15,0,-15
16641,0,0,20,0,-20
16642,1,0,206,0,-206
16643,0,0,31,0,-31
16644,0,0,28,0,-28
16645,0,0,8,0,-8
16646,1,1,415,1304,889
16647,0,0,49,0,-49
16648,0,0,45,0,-45
16649,1,1,304,1304,1000
16650,0,0,78,0,-78
16651,1,0,51,0,-51
16652,1,1,311,1233,922
16653,1,1,1046,1222,176
16654,1,1,527,1216,689
16655,1,1,826,1229,403
16656,1,1,1185,1634,449
16657,1,1,545,1380,835
16658,1,1,91,1275,1184
16659,0,0,26,0,-26
16660,1,0,68,0,-68
16661,1,1,39,1216,1177
16662,1,1,529,1895,1366
16663,1,0,94,0,-94
16664,0,0,43,0,-43
16665,0,0,1,0,-1
16666,1,1,161,1344,1183
16667,1,1,1902,1283,-619
16668,0,0,23,0,-23
16669,1,1,527,2208,1681
16670,1,1,321,1259,938
16671,1,0,8,0,-8
16672,0,0,148,0,-148
16673,0,0,6,0,-6
16674,1,1,48,1580,1532
16675,1,1,933,1724,791
16676,1,0,8,0,-8
16677,1,0,46,0,-46
16678,0,0,28,0,-28
16679,1,1,119,1447,1328
16680,0,0,36,0,-36
16681,1,0,43,0,-43
16682,0,0,0,0,0
16683,1,0,25,0,-25
16684,1,0,10,0,-10
16685,1,1,33,1828,1795
16686,0,0,6,0,-6
16687,0,0,2,0,-2
16688,0,0,27,0,-27
16689,1,0,25,0,-25
16690,1,1,421,1280,859
16691,1,1,262,1312,1050
16692,0,0,37,0,-37
16693,1,1,535,1980,1445
16694,0,0,58,0,-58
16695,1,1,151,1525,1374
16696,1,1,473,1414,941
16697,1,0,83,0,-83
16698,1,1,191,1496,1305
16699,1,1,20,3157,3137
16700,1,1,330,2354,2024
16701,1,0,39,0,-39
16702,0,0,53,0,-53
16703,0,0,23,0,-23
16704,1,1,435,1216,781
16705,0,0,65,0,-65
16706,1,0,41,0,-41
16707,0,0,31,0,-31
16708,1,1,585,1238,653
16709,0,0,57,0,-57
16710,0,0,25,0,-25
16711,1,1,1311,1534,223
16712,0,0,61,0,-61
16713,1,0,40,0,-40
16714,1,0,62,0,-62
16715,1,0,79,0,-79
16716,1,0,84,0,-84
16717,0,0,25,0,-25
16718,1,1,378,1708,1330
16719,1,1,372,1334,962
16720,1,1,519,1507,988
16721,1,1,1756,1522,-234
16722,1,1,144,1230,1086
16723,0,0,76,0,-76
16724,0,0,7,0,-7
16725,1,0,164,0,-164
16726,1,1,244,1227,983
16727,1,0,27,0,-27
16728,1,0,104,0,-104
16729,1,0,52,0,-52
16730,1,1,312,1371,1059
16731,0,0,6,0,-6
16732,0,0,17,0,-17
16733,1,0,75,0,-75
16734,1,1,273,1275,1002
16735,0,0,37,0,-37
16736,1,1,739,1581,842
16737,1,1,219,1257,1038
16738,1,0,0,0,0
16739,0,0,111,0,-111
16740,1,0,57,0,-57
16741,1,1,670,1369,699
16742,0,0,29,0,-29
16743,1,0,24,0,-24
16744,1,0,44,0,-44
16745,0,0,66,0,-66
16746,1,0,106,0,-106
16747,0,0,1,0,-1
16748,0,0,9,0,-9
16749,0,0,8,0,-8
16750,0,0,0,0,0
16751,1,0,42,0,-42
16752,1,0,8,0,-8
16753,1,1,240,1816,1576
16754,0,0,6,0,-6
16755,1,1,908,1358,450
16756,1,1,836,1557,721
16757,1,0,33,0,-33
16758,1,1,541,1738,1197
16759,0,0,16,0,-16
16760,1,1,101,1205,1104
16761,0,0,30,0,-30
16762,1,1,94,1846,1752
16763,1,0,51,0,-51
16764,0,0,15,0,-15
16765,0,0,35,0,-35
16766,1,1,1086,1717,631
16767,0,0,75,0,-75
16768,0,0,48,0,-48
16769,1,1,326,3209,2883
16770,1,0,49,0,-49
16771,0,0,39,0,-39
16772,1,0,20,0,-20
16773,1,1,1217,1590,373
16774,1,0,41,0,-41
16775,0,0,21,0,-21
16776,0,0,30,0,-30
16777,1,1,742,1216,474
16778,0,0,106,0,-106
16779,0,0,4,0,-4
16780,0,0,75,0,-75
16781,1,0,41,0,-41
16782,0,0,5,0,-5
16783,1,1,901,1843,942
16784,0,0,19,0,-19
16785,1,1,288,1417,1129
16786,1,1,217,2952,2735
16787,1,1,1101,1385,284
16788,0,0,15,0,-15
16789,1,1,234,1395,1161
16790,1,0,105,0,-105
16791,1,0,26,0,-26
16792,0,0,201,0,-201
16793,1,0,100,0,-100
16794,1,1,512,1243,731
16795,1,0,47,0,-47
16796,0,0,51,0,-51
16797,0,0,41,0,-41
16798,0,0,58,0,-58
16799,0,0,98,0,-98
16800,0,0,10,0,-10
16801,1,1,656,1842,1186
16802,0,0,175,0,-175
16803,1,1,309,1475,1166
16804,1,0,29,0,-29
16805,1,1,489,4108,3619
16806,0,0,68,0,-68
16807,0,0,11,0,-11
16808,0,0,28,0,-28
16809,1,0,37,0,-37
16810,0,0,16,0,-16
16811,0,0,1,0,-1
16812,0,0,71,0,-71
16813,0,0,62,0,-62
16814,1,0,0,0,0
16815,0,0,0,0,0
16816,1,1,917,2296,1379
16817,0,0,98,0,-98
16818,1,1,213,1303,1090
16819,1,0,100,0,-100
16820,1,0,3,0,-3
16821,1,1,185,1309,1124
16822,1,0,58,0,-58
16823,0,0,9,0,-9
16824,1,1,161,1511,1350
16825,1,0,80,0,-80
16826,1,1,498,1520,1022
16827,1,1,1204,1424,220
16828,1,1,692,1287,595
16829,1,0,4,0,-4
16830,1,0,14,0,-14
16831,0,0,32,0,-32
16832,0,0,19,0,-19
16833,1,1,388,2359,1971
16834,1,0,73,0,-73
16835,1,1,519,1595,1076
16836,1,0,61,0,-61
16837,0,0,26,0,-26
16838,0,0,17,0,-17
16839,1,1,493,1450,957
16840,1,0,39,0,-39
16841,0,0,11,0,-11
16842,1,1,1828,1240,-588
16843,0,0,38,0,-38
16844,1,1,36,1468,1432
16845,0,0,20,0,-20
16846,1,0,9,0,-9
16847,1,1,81,1204,1123
16848,1,1,141,1588,1447
16849,1,1,317,1317,1000
16850,1,1,383,1499,1116
16851,0,0,132,0,-132
16852,1,0,39,0,-39
16853,1,0,16,0,-16
16854,1,1,976,1295,319
16855,0,0,87,0,-87
16856,1,0,36,0,-36
16857,1,1,843,1251,408
16858,1,1,212,1708,1496
16859,1,0,33,0,-33
16860,1,1,848,2088,1240
16861,1,1,226,1494,1268
16862,1,0,2,0,-2
16863,0,0,44,0,-44
16864,1,1,419,1545,1126
16865,1,1,158,1223,1065
16866,1,0,35,0,-35
16867,1,1,28,2462,2434
16868,0,0,3,0,-3
16869,0,0,9,0,-9
16870,0,0,78,0,-78
16871,1,0,29,0,-29
16872,0,0,19,0,-19
16873,0,0,2,0,-2
16874,0,0,29,0,-29
16875,1,1,206,1287,1081
16876,0,0,102,0,-102
16877,1,0,8,0,-8
16878,0,0,125,0,-125
16879,1,1,205,1574,1369
16880,0,0,14,0,-14
16881,1,0,26,0,-26
16882,1,0,15,0,-15
16883,0,0,19,0,-19
16884,1,0,0,0,0
16885,1,1,368,1251,883
16886,1,1,61,1365,1304
16887,1,1,283,1244,961
16888,1,1,1367,2064,697
16889,1,0,17,0,-17
16890,0,0,107,0,-107
16891,1,1,136,1352,1216
16892,0,0,27,0,-27
16893,1,0,139,0,-139
16894,0,0,9,0,-9
16895,1,1,714,1302,588
16896,0,0,3,0,-3
16897,0,0,198,0,-198
16898,1,1,1152,1903,751
16899,0,0,158,0,-158
16900,1,1,376,1269,893
16901,1,1,55,1430,1375
16902,1,0,98,0,-98
16903,1,1,158,2486,2328
16904,1,1,678,1297,619
16905,0,0,20,0,-20
16906,1,1,552,1262,710
16907,1,1,422,1370,948
16908,0,0,27,0,-27
16909,0,0,18,0,-18
16910,0,0,7,0,-7
16911,0,0,64,0,-64
16912,0,0,22,0,-22
16913,0,0,15,0,-15
16914,0,0,89,0,-89
16915,1,1,154,1288,1134
16916,1,1,543,1488,945
16917,1,1,1194,1346,152
16918,1,0,87,0,-87
16919,1,0,12,0,-12
16920,0,0,19,0,-19
16921,0,0,49,0,-49
16922,0,0,104,0,-104
16923,0,0,17,0,-17
16924,1,0,21,0,-21
16925,1,1,1644,2004,360
16926,0,0,115,0,-115
16927,1,0,79,0,-79
16928,1,0,38,0,-38
16929,1,0,43,0,-43
16930,1,0,114,0,-114
16931,1,0,10,0,-10
16932,1,1,475,1209,734
16933,1,1,415,2607,2192
16934,1,0,22,0,-22
16935,1,1,437,1276,839
16936,1,0,67,0,-67
16937,1,1,81,2110,2029
16938,0,0,61,0,-61
16939,1,0,35,0,-35
16940,0,0,129,0,-129
16941,0,0,0,0,0
16942,0,0,142,0,-142
16943,0,0,92,0,-92
16944,1,1,169,1296,1127
16945,1,1,308,1348,1040
16946,0,0,80,0,-80
16947,1,1,813,1273,460
16948,1,0,9,0,-9
16949,0,0,24,0,-24
16950,1,0,53,0,-53
16951,0,0,74,0,-74
16952,1,1,107,1954,1847
16953,1,0,12,0,-12
16954,1,1,857,2269,1412
16955,0,0,23,0,-23
16956,0,0,29,0,-29
16957,1,1,119,1321,1202
16958,0,0,6,0,-6
16959,0,0,54,0,-54
16960,1,0,47,0,-47
16961,1,1,1718,1241,-477
16962,1,1,156,1215,1059
16963,1,0,33,0,-33
16964,0,0,9,0,-9
16965,1,1,700,1583,883
16966,1,1,306,1258,952
16967,0,0,107,0,-107
16968,0,0,53,0,-53
16969,0,0,35,0,-35
16970,1,1,478,2160,1682
16971,1,0,13,0,-13
16972,0,0,2,0,-2
16973,1,0,3,0,-3
16974,0,0,18,0,-18
16975,0,0,44,0,-44
16976,1,0,88,0,-88
16977,1,0,26,0,-26
16978,1,1,334,1518,1184
16979,0,0,43,0,-43
16980,0,0,11,0,-11
16981,1,1,863,1208,345
16982,1,1,187,1686,1499
16983,1,0,14,0,-14
16984,0,0,50,0,-50
16985,0,0,45,0,-45
16986,0,0,37,0,-37
16987,1,1,97,1252,1155
16988,1,0,101,0,-101
16989,0,0,21,0,-21
16990,1,0,80,0,-80
16991,1,1,20,1247,1227
16992,0,0,2,0,-2
16993,0,0,6,0,-6
16994,1,1,1227,2099,872
16995,0,0,75,0,-75
16996,1,0,163,0,-163
16997,1,1,2024,1337,-687
16998,1,0,29,0,-29
16999,0,0,14,0,-14
17000,1,0,19,0,-19
17001,0,0,84,0,-84
17002,0,0,27,0,-27
17003,0,0,16,0,-16
17004,0,0,82,0,-82
17005,1,1,190,1239,1049
17006,1,1,1892,1210,-682
17007,0,0,50,0,-50
17008,1,0,3,0,-3
17009,1,0,117,0,-117
17010,1,0,39,0,-39
17011,1,1,885,1217,332
17012,1,1,869,1715,846
17013,1,0,2,0,-2
17014,0,0,45,0,-45
17015,1,1,303,2134,1831
17016,1,0,30,0,-30
17017,1,1,1690,1410,-280
17018,0,0,1,0,-1
17019,1,0,20,0,-20
17020,1,1,266,2234,1968
17021,1,1,26,1284,1258
17022,1,1,109,1550,1441
17023,1,0,40,0,-40
17024,0,0,32,0,-32
17025,0,0,200,0,-200
17026,1,1,1419,1314,-105
17027,0,0,8,0,-8
17028,1,1,444,1785,1341
17029,1,0,18,0,-18
17030,0,0,92,0,-92
17031,1,1,327,1292,965
17032,0,0,184,0,-184
17033,0,0,81,0,-81
17034,0,0,43,0,-43
17035,1,1,508,1203,695
17036,0,0,4,0,-4
17037,0,0,27,0,-27
17038,1,0,40,0,-40
17039,0,0,55,0,-55
17040,0,0,23,0,-23
17041,1,1,1684,1627,-57
17042,1,1,2163,1509,-654
17043,0,0,60,0,-60
17044,0,0,83,0,-83
17045,0,0,111,0,-111
17046,1,1,438,1389,951
17047,0,0,69,0,-69
17048,1,0,25,0,-25
17049,1,1,890,1505,615
17050,1,0,137,0,-137
17051,0,0,12,0,-12
17052,0,0,26,0,-26
17053,1,1,375,1307,932
17054,1,1,348,1436,1088
17055,0,0,6,0,-6
17056,1,0,30,0,-30
17057,0,0,35,0,-35
17058,1,1,79,1580,1501
17059,0,0,114,0,-114
17060,1,0,3,0,-3
17061,1,0,111,0,-111
17062,1,0,77,0,-77
17063,0,0,66,0,-66
17064,1,1,1457,1498,41
17065,1,0,2,0,-2
17066,0,0,35,0,-35
17067,0,0,3,0,-3
17068,1,0,5,0,-5
17069,0,0,61,0,-61
17070,0,0,31,0,-31
17071,0,0,66,0,-66
17072,1,1,333,1423,1090
17073,0,0,37,0,-37
17074,1,0,16,0,-16
17075,0,0,6,0,-6
17076,0,0,42,0,-42
17077,0,0,12,0,-12
17078,1,0,24,0,-24
17079,1,0,79,0,-79
17080,1,1,546,1219,673
17081,0,0,55,0,-55
17082,0,0,91,0,-91
17083,1,1,401,1673,1272
17084,0,0,102,0,-102
17085,1,1,806,1416,610
17086,1,0,19,0,-19
17087,0,0,158,0,-158
17088,1,1,670,1333,663
17089,0,0,71,0,-71
17090,0,0,89,0,-89
17091,1,0,20,0,-20
17092,0,0,47,0,-47
17093,0,0,8,0,-8
17094,0,0,87,0,-87
17095,1,1,289,1336,1047
17096,1,1,137,1765,1628
17097,1,1,360,1334,974
17098,0,0,23,0,-23
17099,0,0,47,0,-47
17100,1,0,18,0,-18
17101,0,0,98,0,-98
17102,1,1,2848,1307,-1541
17103,0,0,86,0,-86
17104,0,0,106,0,-106
17105,0,0,235,0,-235
17106,0,0,140,0,-140
17107,1,0,6,0,-6
17108,0,0,203,0,-203
17109,1,1,909,1221,312
17110,0,0,6,0,-6
17111,0,0,272,0,-272
17112,1,0,20,0,-20
17113,0,0,4,0,-4
17114,0,0,101,0,-101
17115,0,0,46,0,-46
17116,1,0,86,0,-86
17117,1,1,434,2340,1906
17118,1,1,273,1342,1069
17119,0,0,20,0,-20
17120,1,0,58,0,-58
17121,0,0,8,0,-8
17122,1,1,313,1542,1229
17123,1,0,46,0,-46
17124,0,0,43,0,-43
17125,1,1,655,1206,551
17126,1,1,1596,1276,-320
17127,0,0,20,0,-20
17128,0,0,144,0,-144
17129,1,1,1309,1763,454
17130,1,1,192,1220,1028
17131,1,0,22,0,-22
17132,1,1,842,1699,857
17133,1,1,1010,1573,563
17134,1,0,61,0,-61
17135,0,0,189,0,-189
17136,1,0,14,0,-14
17137,1,1,910,1343,433
17138,1,0,2,0,-2
17139,1,1,303,1409,1106
17140,1,1,831,1536,705
17141,1,0,44,0,-44
17142,0,0,19,0,-19
17143,0,0,189,0,-189
17144,0,0,31,0,-31
17145,0,0,18,0,-18
17146,0,0,68,0,-68
17147,1,1,497,1496,999
17148,0,0,13,0,-13
17149,1,1,320,1567,1247
17150,1,0,17,0,-17
17151,1,0,36,0,-36
17152,0,0,53,0,-53
17153,1,0,28,0,-28
17154,1,1,216,1305,1089
17155,0,0,15,0,-15
17156,1,1,585,2253,1668
17157,0,0,62,0,-62
17158,0,0,58,0,-58
17159,1,0,14,0,-14
17160,1,0,13,0,-13
17161,1,1,246,1892,1646
17162,0,0,70,0,-70
17163,1,0,8,0,-8
17164,1,1,887,1811,924
17165,0,0,177,0,-177
17166,0,0,2,0,-2
17167,0,0,64,0,-64
17168,1,1,76,1302,1226
17169,1,1,223,1479,1256
17170,1,0,14,0,-14
17171,1,0,59,0,-59
17172,0,0,0,0,0
17173,0,0,44,0,-44
17174,0,0,28,0,-28
17175,0,0,34,0,-34
17176,1,1,369,1450,1081
17177,1,1,97,1661,1564
17178,1,0,35,0,-35
17179,1,1,110,1722,1612
17180,0,0,95,0,-95
17181,1,1,333,2238,1905
17182,0,0,47,0,-47
17183,1,0,32,0,-32
17184,1,1,131,1590,1459
17185,1,1,230,3486,3256
17186,1,0,76,0,-76
17187,1,1,763,1512,749
17188,0,0,17,0,-17
17189,1,0,7,0,-7
17190,1,1,161,1365,1204
17191,0,0,48,0,-48
17192,1,0,209,0,-209
17193,0,0,18,0,-18
17194,1,0,33,0,-33
17195,0,0,67,0,-67
17196,0,0,117,0,-117
17197,1,1,478,2145,1667
17198,0,0,96,0,-96
17199,0,0,24,0,-24
17200,1,0,38,0,-38
17201,0,0,124,0,-124
17202,1,0,20,0,-20
17203,1,0,32,0,-32
17204,0,0,135,0,-135
17205,0,0,0,0,0
17206,1,1,243,1951,1708
17207,1,1,524,1312,788
17208,1,1,878,1238,360
17209,0,0,93,0,-93
17210,1,0,72,0,-72
17211,1,0,32,0,-32
17212,0,0,59,0,-59
17213,0,0,192,0,-192
17214,0,0,3,0,-3
17215,1,1,598,1200,602
17216,1,1,455,1220,765
17217,1,0,24,0,-24
17218,0,0,16,0,-16
17219,1,0,16,0,-16
17220,0,0,7,0,-7
17221,1,0,82,0,-82
17222,1,1,47,1597,1550
17223,1,0,40,0,-40
17224,1,0,69,0,-69
17225,0,0,13,0,-13
17226,1,0,145,0,-145
17227,1,1,112,1607,1495
17228,1,1,209,1510,1301
17229,0,0,66,0,-66
17230,0,0,118,0,-118
17231,0,0,138,0,-138
17232,0,0,109,0,-109
17233,0,0,2,0,-2
17234,0,0,60,0,-60
17235,0,0,8,0,-8
17236,1,1,92,2290,2198
17237,1,1,229,1782,1553
17238,0,0,2,0,-2
17239,0,0,169,0,-169
17240,1,1,81,1203,1122
17241,0,0,193,0,-193
17242,1,1,525,1519,994
17243,1,0,9,0,-9
17244,0,0,27,0,-27
17245,0,0,9,0,-9
17246,1,1,152,2941,2789
17247,0,0,48,0,-48
17248,0,0,2,0,-2
17249,0,0,60,0,-60
17250,1,0,25,0,-25
17251,0,0,11,0,-11
17252,1,0,7,0,-7
17253,1,1,879,1436,557
17254,1,1,508,1614,1106
17255,0,0,10,0,-10
17256,0,0,37,0,-37
17257,1,0,22,0,-22
17258,1,1,278,1706,1428
17259,1,0,24,0,-24
17260,1,0,11,0,-11
17261,0,0,70,0,-70
17262,1,0,30,0,-30
17263,0,0,11,0,-11
17264,1,0,17,0,-17
17265,1,0,10,0,-10
17266,1,1,898,1302,404
17267,1,1,581,1608,1027
17268,1,0,120,0,-120
17269,1,1,937,1323,386
17270,1,0,163,0,-163
17271,0,0,0,0,0
17272,0,0,91,0,-91
17273,0,0,54,0,-54
17274,1,0,27,0,-27
17275,1,0,30,0,-30
17276,1,0,13,0,-13
17277,0,0,24,0,-24
17278,1,0,75,0,-75
17279,1,0,65,0,-65
17280,0,0,194,0,-194
17281,0,0,76,0,-76
17282,1,1,769,2967,2198
17283,1,0,24,0,-24
17284,0,0,49,0,-49
17285,1,1,350,1892,1542
17286,1,1,332,1254,922
17287,1,1,282,1254,972
17288,1,0,105,0,-105
17289,1,1,1637,1308,-329
17290,0,0,1,0,-1
17291,1,0,37,0,-37
17292,0,0,37,0,-37
17293,0,0,14,0,-14
17294,1,1,346,1258,912
17295,1,1,409,1296,887
17296,1,0,15,0,-15
17297,1,0,26,0,-26
17298,1,1,51,2106,2055
17299,0,0,51,0,-51
17300,0,0,97,0,-97
17301,1,1,116,1346,1230
17302,1,1,677,1401,724
17303,1,0,81,0,-81
17304,0,0,48,0,-48
17305,1,1,76,1209,1133
17306,1,0,44,0,-44
17307,1,1,348,1895,1547
17308,1,0,24,0,-24
17309,0,0,53,0,-53
17310,0,0,18,0,-18
17311,1,1,336,1832,1496
17312,1,0,61,0,-61
17313,1,0,31,0,-31
17314,1,1,100,1223,1123
17315,1,0,49,0,-49
17316,1,1,928,1467,539
17317,1,1,1176,1369,193
17318,1,0,133,0,-133
17319,1,0,46,0,-46
17320,0,0,108,0,-108
17321,1,1,535,1488,953
17322,0,0,21,0,-21
17323,0,0,34,0,-34
17324,0,0,30,0,-30
17325,0,0,17,0,-17
17326,1,0,20,0,-20
17327,1,1,391,1479,1088
17328,1,0,10,0,-10
17329,1,0,45,0,-45
17330,1,0,2,0,-2
17331,1,1,386,1652,1266
17332,1,1,277,1372,1095
17333,0,0,164,0,-164
17334,1,0,119,0,-119
17335,1,0,45,0,-45
17336,1,0,8,0,-8
17337,1,0,0,0,0
17338,1,0,57,0,-57
17339,0,0,20,0,-20
17340,1,1,1919,1449,-470
17341,1,1,413,1964,1551
17342,1,0,33,0,-33
17343,0,0,1,0,-1
17344,0,0,47,0,-47
17345,1,1,324,1398,1074
17346,0,0,53,0,-53
17347,0,0,10,0,-10
17348,0,0,117,0,-117
17349,1,0,13,0,-13
17350,1,0,13,0,-13
17351,1,1,1419,1653,234
17352,1,1,151,1537,1386
17353,1,0,104,0,-104
17354,1,1,81,1620,1539
17355,1,0,38,0,-38
17356,1,0,43,0,-43
17357,0,0,29,0,-29
17358,1,1,102,1235,1133
17359,0,0,66,0,-66
17360,1,0,34,0,-34
17361,1,1,221,1496,1275
17362,1,1,519,1779,1260
17363,0,0,15,0,-15
17364,1,1,203,1323,1120
17365,1,1,306,1255,949
17366,1,0,1,0,-1
17367,1,1,976,1818,842
17368,1,0,42,0,-42
17369,1,0,34,0,-34
17370,0,0,14,0,-14
17371,0,0,66,0,-66
17372,1,0,95,0,-95
17373,1,1,466,3254,2788
17374,1,1,390,1239,849
17375,0,0,5,0,-5
17376,0,0,33,0,-33
17377,1,1,122,1255,1133
17378,1,1,348,1377,1029
17379,1,1,695,1279,584
17380,1,0,44,0,-44
17381,0,0,29,0,-29
17382,1,1,845,1219,374
17383,0,0,123,0,-123
17384,0,0,24,0,-24
17385,1,0,43,0,-43
17386,0,0,82,0,-82
17387,1,1,49,1328,1279
17388,1,1,722,1377,655
17389,1,1,1025,1288,263
17390,1,1,865,1203,338
17391,1,1,146,1238,1092
17392,1,0,12,0,-12
17393,1,0,53,0,-53
17394,1,0,4,0,-4
17395,1,0,18,0,-18
17396,0,0,81,0,-81
17397,1,0,44,0,-44
17398,0,0,1,0,-1
17399,0,0,88,0,-88
17400,1,1,863,1424,561
17401,0,0,45,0,-45
17402,1,1,711,1228,517
17403,1,0,8,0,-8
17404,1,0,4,0,-4
17405,1,1,427,1671,1244
17406,1,1,83,2526,2443
17407,0,0,53,0,-53
17408,1,0,6,0,-6
17409,1,0,35,0,-35
17410,0,0,17,0,-17
17411,1,1,1066,1447,381
17412,1,1,251,2128,1877
17413,1,1,446,1481,1035
17414,0,0,38,0,-38
17415,1,1,255,2479,2224
17416,1,1,669,2858,2189
17417,1,0,16,0,-16
17418,1,0,94,0,-94
17419,1,0,28,0,-28
17420,1,1,835,1280,445
17421,0,0,3,0,-3
17422,1,1,499,1280,781
17423,0,0,41,0,-41
17424,0,0,132,0,-132
17425,1,1,1235,1487,252
17426,1,0,97,0,-97
17427,0,0,113,0,-113
17428,1,1,290,1256,966
17429,1,0,56,0,-56
17430,1,1,129,1209,1080
17431,1,1,403,1263,860
17432,0,0,66,0,-66
17433,1,1,302,1496,1194
17434,1,0,1,0,-1
17435,1,0,33,0,-33
17436,1,1,423,2237,1814
17437,1,1,2058,1428,-630
17438,1,0,52,0,-52
17439,1,0,7,0,-7
17440,0,0,5,0,-5
17441,0,0,50,0,-50
17442,1,0,18,0,-18
17443,0,0,5,0,-5
17444,0,0,9,0,-9
17445,0,0,15,0,-15
17446,1,1,488,1296,808
17447,1,1,1229,1597,368
17448,0,0,53,0,-53
17449,1,0,22,0,-22
17450,1,0,17,0,-17
17451,1,0,84,0,-84
17452,1,1,545,1276,731
17453,0,0,42,0,-42
17454,0,0,47,0,-47
17455,1,0,27,0,-27
17456,0,0,28,0,-28
17457,1,0,223,0,-223
17458,0,0,21,0,-21
17459,1,1,152,3365,3213
17460,0,0,61,0,-61
17461,1,1,995,1469,474
17462,0,0,15,0,-15
17463,0,0,5,0,-5
17464,1,1,1847,1505,-342
17465,0,0,90,0,-90
17466,0,0,14,0,-14
17467,0,0,19,0,-19
17468,1,0,71,0,-71
17469,1,0,155,0,-155
17470,0,0,145,0,-145
17471,1,1,760,1485,725
17472,1,0,4,0,-4
17473,0,0,8,0,-8
17474,0,0,15,0,-15
17475,1,1,1151,1371,220
17476,1,0,20,0,-20
17477,0,0,112,0,-112
17478,0,0,244,0,-244
17479,0,0,22,0,-22
17480,1,1,250,1605,1355
17481,1,1,1091,1204,113
17482,0,0,6,0,-6
17483,1,0,55,0,-55
17484,1,1,1270,1571,301
17485,0,0,6,0,-6
17486,1,0,80,0,-80
17487,0,0,98,0,-98
17488,1,0,16,0,-16
17489,0,0,17,0,-17
17490,1,0,82,0,-82
17491,1,0,110,0,-110
17492,0,0,41,0,-41
17493,1,0,59,0,-59
17494,1,1,983,1968,985
17495,0,0,20,0,-20
17496,1,0,169,0,-169
17497,0,0,15,0,-15
17498,1,1,963,1699,736
17499,1,0,3,0,-3
17500,1,1,194,1200,1006
17501,0,0,11,0,-11
17502,0,0,64,0,-64
17503,1,0,26,0,-26
17504,1,1,485,1410,925
17505,0,0,205,0,-205
17506,1,0,17,0,-17
17507,1,1,129,2065,1936
17508,0,0,11,0,-11
17509,0,0,40,0,-40
17510,1,0,29,0,-29
17511,1,1,1018,2718,1700
17512,1,1,521,1488,967
17513,1,1,399,2052,1653
17514,0,0,79,0,-79
17515,0,0,8,0,-8
17516,1,0,39,0,-39
17517,0,0,57,0,-57
17518,0,0,69,0,-69
17519,1,1,52,2013,1961
17520,1,1,62,2283,2221
17521,0,0,23,0,-23
17522,1,0,70,0,-70
17523,1,0,161,0,-161
17524,0,0,101,0,-101
17525,1,0,18,0,-18
17526,1,0,1,0,-1
17527,0,0,57,0,-57
17528,1,0,31,0,-31
17529,1,1,320,1524,1204
17530,1,0,20,0,-20
17531,1,1,638,1208,570
17532,1,1,273,1533,1260
17533,0,0,40,0,-40
17534,0,0,10,0,-10
17535,0,0,107,0,-107
17536,1,1,654,3465,2811
17537,1,1,331,1220,889
17538,1,0,18,0,-18
17539,0,0,13,0,-13
17540,0,0,122,0,-122
17541,1,0,10,0,-10
17542,1,1,96,1204,1108
17543,1,1,605,1254,649
17544,1,0,18,0,-18
17545,0,0,3,0,-3
17546,1,0,40,0,-40
17547,1,0,11,0,-11
17548,1,0,19,0,-19
17549,1,0,5,0,-5
17550,0,0,63,0,-63
17551,1,0,38,0,-38
17552,0,0,48,0,-48
17553,1,1,154,1335,1181
17554,1,1,288,1449,1161
17555,1,1,157,1289,1132
17556,1,1,847,1236,389
17557,1,1,278,1323,1045
17558,1,0,112,0,-112
17559,0,0,30,0,-30
17560,1,0,47,0,-47
17561,0,0,43,0,-43
17562,1,0,12,0,-12
17563,1,1,102,1328,1226
17564,0,0,30,0,-30
17565,1,1,72,1281,1209
17566,1,0,10,0,-10
17567,0,0,120,0,-120
17568,1,0,5,0,-5
17569,1,0,107,0,-107
17570,1,0,4,0,-4
17571,1,0,66,0,-66
17572,0,0,68,0,-68
17573,1,1,1010,1810,800
17574,0,0,1,0,-1
17575,1,0,49,0,-49
17576,1,0,6,0,-6
17577,1,1,986,1239,253
17578,1,1,350,1200,850
17579,1,0,0,0,0
17580,1,0,50,0,-50
17581,1,0,23,0,-23
17582,1,1,876,1279,403
17583,0,0,7,0,-7
17584,0,0,25,0,-25
17585,0,0,78,0,-78
17586,1,0,23,0,-23
17587,1,1,467,1668,1201
17588,0,0,27,0,-27
17589,1,1,711,1553,842
17590,1,1,324,1610,1286
17591,1,0,13,0,-13
17592,0,0,69,0,-69
17593,1,0,77,0,-77
17594,0,0,56,0,-56
17595,0,0,120,0,-120
17596,1,0,103,0,-103
17597,0,0,112,0,-112
17598,1,0,83,0,-83
17599,1,0,17,0,-17
17600,1,1,1542,1486,-56
17601,0,0,20,0,-20
17602,1,0,81,0,-81
17603,1,1,294,7045,6751
17604,0,0,111,0,-111
17605,0,0,19,0,-19
17606,1,1,59,1336,1277
17607,1,0,18,0,-18
17608,1,1,675,1409,734
17609,1,1,279,1427,1148
17610,1,1,319,1676,1357
17611,1,0,47,0,-47
17612,1,1,909,2198,1289
17613,0,0,80,0,-80
17614,0,0,44,0,-44
17615,0,0,23,0,-23
17616,0,0,52,0,-52
17617,0,0,64,0,-64
17618,1,0,44,0,-44
17619,1,1,10,1202,1192
17620,0,0,55,0,-55
17621,1,0,35,0,-35
17622,0,0,66,0,-66
17623,1,1,161,1449,1288
17624,0,0,70,0,-70
17625,1,0,12,0,-12
17626,1,0,167,0,-167
17627,1,1,788,1228,440
17628,1,0,15,0,-15
17629,0,0,26,0,-26
17630,0,0,130,0,-130
17631,1,1,532,1204,672
17632,1,0,101,0,-101
17633,0,0,43,0,-43
17634,0,0,29,0,-29
17635,1,0,54,0,-54
17636,1,1,519,1576,1057
17637,1,1,2210,1603,-607
17638,1,1,144,1326,1182
17639,0,0,73,0,-73
17640,0,0,18,0,-18
17641,1,1,459,1373,914
17642,1,1,499,1643,1144
17643,0,0,34,0,-34
17644,0,0,9,0,-9
17645,1,1,402,1316,914
17646,0,0,15,0,-15
17647,0,0,152,0,-152
17648,1,1,120,1386,1266
17649,0,0,21,0,-21
17650,1,0,48,0,-48
17651,0,0,35,0,-35
17652,1,0,29,0,-29
17653,1,1,296,1372,1076
17654,0,0,71,0,-71
17655,0,0,4,0,-4
17656,0,0,9,0,-9
17657,1,0,48,0,-48
17658,1,1,1100,1775,675
17659,1,1,288,2041,1753
17660,1,0,61,0,-61
17661,1,1,83,1791,1708
17662,1,1,287,1890,1603
17663,1,0,135,0,-135
17664,1,1,524,1647,1123
17665,1,0,43,0,-43
17666,0,0,192,0,-192
17667,1,1,492,1227,735
17668,0,0,164,0,-164
17669,1,0,20,0,-20
17670,1,1,538,1319,781
17671,1,1,103,1345,1242
17672,0,0,10,0,-10
17673,1,0,52,0,-52
17674,1,0,23,0,-23
17675,1,1,972,1913,941
17676,0,0,50,0,-50
17677,1,0,2,0,-2
17678,1,1,151,1302,1151
17679,0,0,12,0,-12
17680,0,0,26,0,-26
17681,1,1,248,1793,1545
17682,0,0,49,0,-49
17683,0,0,35,0,-35
17684,1,0,18,0,-18
17685,1,1,78,1432,1354
17686,0,0,8,0,-8
17687,1,0,18,0,-18
17688,0,0,1,0,-1
17689,0,0,43,0,-43
17690,0,0,54,0,-54
17691,0,0,38,0,-38
17692,1,1,324,2401,2077
17693,1,0,37,0,-37
17694,1,0,121,0,-121
17695,1,1,607,2866,2259
17696,1,1,955,2298,1343
17697,1,1,1062,1409,347
17698,0,0,32,0,-32
17699,1,1,792,1278,486
17700,1,0,39,0,-39
17701,1,1,525,1378,853
17702,1,0,66,0,-66
17703,1,1,794,2414,1620
17704,1,1,348,1423,1075
17705,0,0,71,0,-71
17706,1,0,91,0,-91
17707,1,1,376,1596,1220
17708,0,0,52,0,-52
17709,0,0,74,0,-74
17710,1,1,299,1676,1377
17711,1,1,1176,2027,851
17712,1,1,1020,2261,1241
17713,0,0,100,0,-100
17714,1,0,143,0,-143
17715,1,0,12,0,-12
17716,0,0,56,0,-56
17717,1,1,64,1295,1231
17718,1,0,111,0,-111
17719,1,1,202,1759,1557
17720,0,0,6,0,-6
17721,1,0,15,0,-15
17722,1,0,45,0,-45
17723,1,1,538,2355,1817
17724,1,0,10,0,-10
17725,0,0,58,0,-58
17726,0,0,27,0,-27
17727,1,1,156,2002,1846
17728,1,0,183,0,-183
17729,1,1,474,1417,943
17730,0,0,23,0,-23
17731,1,0,21,0,-21
17732,1,0,9,0,-9
17733,1,0,72,0,-72
17734,1,1,45,1227,1182
17735,1,1,81,1205,1124
17736,1,0,67,0,-67
17737,0,0,4,0,-4
17738,1,1,247,1542,1295
17739,1,0,58,0,-58
17740,0,0,60,0,-60
17741,1,1,608,1293,685
17742,0,0,31,0,-31
17743,1,1,861,1413,552
17744,1,1,708,1242,534
17745,1,0,52,0,-52
17746,1,0,37,0,-37
17747,0,0,18,0,-18
17748,0,0,18,0,-18
17749,1,1,213,1233,1020
17750,1,1,1725,1344,-381
17751,0,0,39,0,-39
17752,0,0,72,0,-72
17753,1,0,92,0,-92
17754,0,0,5,0,-5
17755,1,1,964,1512,548
17756,1,0,59,0,-59
17757,0,0,38,0,-38
17758,1,1,283,1698,1415
17759,1,1,559,2897,2338
17760,1,0,13,0,-13
17761,1,0,11,0,-11
17762,1,0,25,0,-25
17763,0,0,62,0,-62
17764,1,0,90,0,-90
17765,0,0,33,0,-33
17766,0,0,9,0,-9
17767,0,0,41,0,-41
17768,1,0,28,0,-28
17769,1,1,259,1459,1200
17770,1,0,4,0,-4
17771,1,1,663,1326,663
17772,0,0,22,0,-22
17773,1,0,24,0,-24
17774,1,1,166,1433,1267
17775,1,0,55,0,-55
17776,1,0,0,0,0
17777,1,1,532,3522,2990
17778,1,1,94,1917,1823
17779,1,0,26,0,-26
17780,1,0,7,0,-7
17781,1,1,614,1403,789
17782,0,0,41,0,-41
17783,0,0,22,0,-22
17784,1,1,400,1382,982
17785,0,0,81,0,-81
17786,1,1,2658,1423,-1235
17787,1,1,54,1551,1497
17788,1,1,583,1266,683
17789,0,0,113,0,-113
17790,1,0,30,0,-30
17791,0,0,37,0,-37
17792,0,0,30,0,-30
17793,0,0,113,0,-113
17794,0,0,11,0,-11
17795,1,1,359,1354,995
17796,1,0,18,0,-18
17797,0,0,65,0,-65
17798,1,1,382,1699,1317
17799,1,0,66,0,-66
17800,1,1,244,1767,1523
17801,1,0,12,0,-12
17802,1,0,12,0,-12
17803,0,0,97,0,-97
17804,0,0,13,0,-13
17805,1,0,8,0,-8
17806,0,0,8,0,-8
17807,0,0,64,0,-64
17808,0,0,6,0,-6
17809,0,0,19,0,-19
17810,1,0,125,0,-125
17811,0,0,6,0,-6
17812,1,1,296,1684,1388
17813,1,0,188,0,-188
17814,1,1,377,1354,977
17815,1,1,1183,1800,617
17816,1,0,28,0,-28
17817,1,0,2,0,-2
17818,1,0,2,0,-2
17819,0,0,38,0,-38
17820,1,0,14,0,-14
17821,0,0,11,0,-11
17822,1,1,410,1262,852
17823,0,0,35,0,-35
17824,0,0,63,0,-63
17825,1,0,38,0,-38
17826,0,0,50,0,-50
17827,0,0,16,0,-16
17828,1,1,7,1207,1200
17829,0,0,185,0,-185
17830,1,1,118,2331,2213
17831,1,0,92,0,-92
17832,1,1,109,1662,1553
17833,1,0,8,0,-8
17834,1,0,140,0,-140
17835,1,0,45,0,-45
17836,1,0,31,0,-31
17837,0,0,64,0,-64
17838,1,0,21,0,-21
17839,0,0,29,0,-29
17840,1,0,50,0,-50
17841,0,0,1,0,-1
17842,1,1,2071,1918,-153
17843,1,1,1268,1205,-63
17844,0,0,114,0,-114
17845,0,0,31,0,-31
17846,1,0,9,0,-9
17847,0,0,19,0,-19
17848,0,0,31,0,-31
17849,1,1,373,2450,2077
17850,0,0,39,0,-39
17851,0,0,52,0,-52
17852,1,1,1315,1509,194
17853,0,0,73,0,-73
17854,1,1,106,1642,1536
17855,0,0,8,0,-8
17856,0,0,96,0,-96
17857,1,0,39,0,-39
17858,0,0,6,0,-6
17859,0,0,24,0,-24
17860,1,0,7,0,-7
17861,1,0,25,0,-25
17862,1,1,975,1339,364
17863,1,1,43,2043,2000
17864,0,0,73,0,-73
17865,1,0,113,0,-113
17866,0,0,134,0,-134
17867,0,0,85,0,-85
17868,0,0,29,0,-29
17869,1,0,19,0,-19
17870,1,0,21,0,-21
17871,0,0,92,0,-92
17872,1,1,111,1214,1103
17873,0,0,33,0,-33
17874,1,1,712,1475,763
17875,0,0,57,0,-57
17876,1,1,323,1930,1607
17877,1,0,2,0,-2
17878,1,0,111,0,-111
17879,0,0,11,0,-11
17880,1,1,228,1798,1570
17881,1,1,800,1338,538
17882,1,0,8,0,-8
17883,0,0,13,0,-13
17884,0,0,124,0,-124
17885,0,0,112,0,-112
17886,1,0,25,0,-25
17887,0,0,73,0,-73
17888,1,0,40,0,-40
17889,1,1,782,1271,489
17890,1,0,7,0,-7
17891,1,1,268,1452,1184
17892,1,0,26,0,-26
17893,1,1,758,1304,546
17894,1,0,39,0,-39
17895,1,0,14,0,-14
17896,0,0,22,0,-22
17897,0,0,62,0,-62
17898,1,0,39,0,-39
17899,1,0,0,0,0
17900,0,0,73,0,-73
17901,1,1,706,1852,1146
17902,1,0,157,0,-157
17903,1,1,457,1844,1387
17904,0,0,50,0,-50
17905,0,0,83,0,-83
17906,1,0,6,0,-6
17907,0,0,11,0,-11
17908,1,1,325,1400,1075
17909,0,0,47,0,-47
17910,0,0,26,0,-26
17911,1,0,22,0,-22
17912,0,0,70,0,-70
17913,1,0,17,0,-17
17914,1,1,47,1296,1249
17915,1,1,1223,1896,673
17916,1,0,40,0,-40
17917,1,0,3,0,-3
17918,0,0,82,0,-82
17919,1,0,58,0,-58
17920,0,0,80,0,-80
17921,0,0,50,0,-50
17922,0,0,28,0,-28
17923,0,0,50,0,-50
17924,1,1,220,1216,996
17925,0,0,5,0,-5
17926,1,1,1027,1311,284
17927,0,0,93,0,-93
17928,1,1,242,1812,1570
17929,1,1,197,1481,1284
17930,0,0,8,0,-8
17931,1,1,302,1347,1045
17932,1,0,5,0,-5
17933,0,0,56,0,-56
17934,1,0,73,0,-73
17935,1,1,320,1283,963
17936,1,1,329,1590,1261
17937,0,0,118,0,-118
17938,0,0,30,0,-30
17939,1,1,157,1652,1495
17940,1,1,1000,1507,507
17941,1,0,1,0,-1
17942,1,0,75,0,-75
17943,1,0,85,0,-85
17944,1,0,65,0,-65
17945,1,0,16,0,-16
17946,0,0,1,0,-1
17947,1,1,234,1324,1090
17948,1,0,62,0,-62
17949,0,0,13,0,-13
17950,0,0,6,0,-6
17951,1,0,213,0,-213
17952,0,0,10,0,-10
17953,1,1,798,1244,446
17954,1,0,25,0,-25
17955,1,1,79,5043,4964
17956,1,1,69,1306,1237
17957,1,0,52,0,-52
17958,0,0,81,0,-81
17959,0,0,41,0,-41
17960,0,0,38,0,-38
17961,1,1,576,1224,648
17962,1,0,26,0,-26
17963,0,0,6,0,-6
17964,0,0,16,0,-16
17965,0,0,71,0,-71
17966,0,0,4,0,-4
17967,0,0,26,0,-26
17968,1,0,42,0,-42
17969,1,0,24,0,-24
17970,1,1,57,1439,1382
17971,0,0,5,0,-5
17972,0,0,224,0,-224
17973,1,0,48,0,-48
17974,1,1,513,1734,1221
17975,1,1,335,1419,1084
17976,1,1,785,1931,1146
17977,1,1,308,1417,1109
17978,0,0,21,0,-21
17979,1,1,712,1286,574
17980,0,0,1,0,-1
17981,1,0,14,0,-14
17982,0,0,89,0,-89
17983,0,0,1,0,-1
17984,0,0,12,0,-12
17985,1,1,447,4719,4272
17986,0,0,61,0,-61
17987,1,1,616,2165,1549
17988,0,0,24,0,-24
17989,0,0,46,0,-46
17990,1,1,220,1249,1029
17991,0,0,63,0,-63
17992,0,0,22,0,-22
17993,1,1,153,1290,1137
17994,0,0,4,0,-4
17995,0,0,24,0,-24
17996,1,0,8,0,-8
17997,1,0,11,0,-11
17998,1,0,157,0,-157
17999,1,0,7,0,-7
18000,0,0,7,0,-7
18001,1,0,38,0,-38
18002,1,1,16,4767,4751
18003,1,1,354,1251,897
18004,1,1,281,1344,1063
18005,0,0,3,0,-3
18006,0,0,23,0,-23
18007,1,1,645,2271,1626
18008,1,1,1005,1652,647
18009,1,0,19,0,-19
18010,1,1,260,2463,2203
18011,1,0,114,0,-114
18012,1,1,210,1569,1359
18013,1,0,104,0,-104
18014,1,1,295,1289,994
18015,0,0,28,0,-28
18016,0,0,29,0,-29
18017,0,0,87,0,-87
18018,1,0,5,0,-5
18019,1,1,234,1330,1096
18020,0,0,4,0,-4
18021,0,0,53,0,-53
18022,0,0,45,0,-45
18023,1,0,13,0,-13
18024,0,0,2,0,-2
18025,0,0,54,0,-54
18026,1,0,0,0,0
18027,1,1,469,1482,1013
18028,1,0,65,0,-65
18029,0,0,83,0,-83
18030,0,0,51,0,-51
18031,0,0,64,0,-64
18032,0,0,83,0,-83
18033,1,1,512,1230,718
18034,0,0,87,0,-87
18035,1,1,536,1306,770
18036,1,0,92,0,-92
18037,1,1,567,1392,825
18038,0,0,44,0,-44
18039,0,0,95,0,-95
18040,1,1,15,1518,1503
18041,1,0,73,0,-73
18042,0,0,90,0,-90
18043,0,0,2,0,-2
18044,0,0,168,0,-168
18045,0,0,6,0,-6
18046,0,0,7,0,-7
18047,1,0,24,0,-24
18048,1,0,19,0,-19
18049,0,0,33,0,-33
18050,0,0,48,0,-48
18051,1,1,919,1359,440
18052,0,0,52,0,-52
18053,1,1,225,2284,2059
18054,1,0,7,0,-7
18055,0,0,93,0,-93
18056,1,0,97,0,-97
18057,1,0,21,0,-21
18058,1,0,18,0,-18
18059,0,0,62,0,-62
18060,1,1,1394,4661,3267
18061,1,1,609,1225,616
18062,1,0,20,0,-20
18063,1,1,876,1859,983
18064,1,1,32,1615,1583
18065,1,1,442,1449,1007
18066,1,1,145,1347,1202
18067,1,1,366,1518,1152
18068,0,0,33,0,-33
18069,1,0,14,0,-14
18070,1,0,41,0,-41
18071,1,1,781,1357,576
18072,1,1,719,1210,491
18073,0,0,3,0,-3
18074,1,1,24,2018,1994
18075,1,1,360,1289,929
18076,0,0,0,0,0
18077,1,0,85,0,-85
18078,0,0,42,0,-42
18079,1,0,124,0,-124
18080,0,0,11,0,-11
18081,0,0,238,0,-238
18082,1,1,275,1694,1419
18083,0,0,6,0,-6
18084,1,1,494,1492,998
18085,1,1,512,1210,698
18086,1,1,147,1486,1339
18087,0,0,79,0,-79
18088,1,0,27,0,-27
18089,1,0,118,0,-118
18090,0,0,193,0,-193
18091,1,0,39,0,-39
18092,0,0,18,0,-18
18093,1,0,67,0,-67
18094,1,0,109,0,-109
18095,0,0,317,0,-317
18096,1,1,321,1695,1374
18097,0,0,18,0,-18
18098,1,0,122,0,-122
18099,0,0,41,0,-41
18100,1,1,204,1623,1419
18101,1,0,36,0,-36
18102,1,0,10,0,-10
18103,1,1,97,1242,1145
18104,0,0,101,0,-101
18105,1,0,45,0,-45
18106,1,0,27,0,-27
18107,1,1,557,1857,1300
18108,0,0,59,0,-59
18109,1,0,44,0,-44
18110,1,0,122,0,-122
18111,1,1,386,2728,2342
18112,0,0,84,0,-84
18113,1,0,3,0,-3
18114,0,0,76,0,-76
18115,1,0,25,0,-25
18116,1,0,49,0,-49
18117,1,1,579,3326,2747
18118,1,1,1287,1523,236
18119,0,0,8,0,-8
18120,0,0,17,0,-17
18121,0,0,3,0,-3
18122,1,1,107,3224,3117
18123,0,0,11,0,-11
18124,0,0,17,0,-17
18125,1,1,667,2367,1700
18126,1,1,62,1212,1150
18127,0,0,35,0,-35
18128,1,1,999,1532,533
18129,1,0,4,0,-4
18130,0,0,75,0,-75
18131,1,0,39,0,-39
18132,0,0,10,0,-10
18133,1,1,325,3816,3491
18134,0,0,15,0,-15
18135,1,0,27,0,-27
18136,0,0,170,0,-170
18137,1,0,29,0,-29
18138,1,1,743,1710,967
18139,1,1,780,1267,487
18140,0,0,41,0,-41
18141,0,0,18,0,-18
18142,0,0,5,0,-5
18143,1,0,9,0,-9
18144,1,1,1779,4109,2330
18145,0,0,71,0,-71
18146,1,0,18,0,-18
18147,0,0,31,0,-31
18148,1,1,1198,1256,58
18149,1,1,640,1406,766
18150,0,0,0,0,0
18151,0,0,31,0,-31
18152,1,0,1,0,-1
18153,0,0,1,0,-1
18154,1,1,181,1592,1411
18155,1,1,268,1289,1021
18156,0,0,155,0,-155
18157,0,0,55,0,-55
18158,0,0,47,0,-47
18159,0,0,67,0,-67
18160,1,1,178,1639,1461
18161,1,0,18,0,-18
18162,1,0,20,0,-20
18163,0,0,37,0,-37
18164,1,0,14,0,-14
18165,1,1,87,1243,1156
18166,1,0,45,0,-45
18167,0,0,15,0,-15
18168,0,0,1,0,-1
18169,1,0,97,0,-97
18170,0,0,20,0,-20
18171,1,1,1829,1392,-437
18172,0,0,3,0,-3
18173,0,0,57,0,-57
18174,1,0,67,0,-67
18175,0,0,31,0,-31
18176,1,1,723,1551,828
18177,1,1,673,1200,527
18178,0,0,17,0,-17
18179,1,1,383,1867,1484
18180,1,0,20,0,-20
18181,0,0,21,0,-21
18182,1,0,12,0,-12
18183,1,1,278,1792,1514
18184,1,0,0,0,0
18185,1,1,1161,2350,1189
18186,1,0,7,0,-7
18187,0,0,61,0,-61
18188,0,0,26,0,-26
18189,1,0,67,0,-67
18190,1,1,253,1343,1090
18191,0,0,5,0,-5
18192,1,1,278,1229,951
18193,1,1,510,1328,818
18194,0,0,44,0,-44
18195,1,1,399,1477,1078
18196,0,0,20,0,-20
18197,1,1,374,1221,847
18198,1,0,43,0,-43
18199,1,0,10,0,-10
18200,1,1,704,1581,877
18201,1,1,200,1297,1097
18202,0,0,168,0,-168
18203,0,0,11,0,-11
18204,1,1,89,1295,1206
18205,1,1,263,1356,1093
18206,0,0,24,0,-24
18207,1,0,44,0,-44
18208,1,0,34,0,-34
18209,0,0,99,0,-99
18210,0,0,98,0,-98
18211,0,0,7,0,-7
18212,0,0,24,0,-24
18213,1,0,8,0,-8
18214,1,1,1399,1238,-161
18215,1,1,586,1335,749
18216,1,1,539,1775,1236
18217,1,1,1384,1383,-1
18218,1,0,87,0,-87
18219,1,0,38,0,-38
18220,0,0,22,0,-22
18221,0,0,18,0,-18
18222,1,0,69,0,-69
18223,1,0,151,0,-151
18224,0,0,52,0,-52
18225,0,0,4,0,-4
18226,1,0,48,0,-48
18227,0,0,18,0,-18
18228,1,1,460,1272,812
18229,0,0,116,0,-116
18230,1,1,72,1288,1216
18231,1,0,43,0,-43
18232,0,0,3,0,-3
18233,1,0,185,0,-185
18234,1,0,38,0,-38
18235,1,0,86,0,-86
18236,1,0,0,0,0
18237,1,0,39,0,-39
18238,1,0,114,0,-114
18239,0,0,0,0,0
18240,1,1,408,1457,1049
18241,1,0,111,0,-111
18242,1,0,60,0,-60
18243,1,0,10,0,-10
18244,1,1,2116,1649,-467
18245,0,0,22,0,-22
18246,1,1,94,2102,2008
18247,1,1,140,1249,1109
18248,1,0,43,0,-43
18249,1,1,189,1294,1105
18250,1,0,6,0,-6
18251,1,1,619,1647,1028
18252,1,1,998,1417,419
18253,0,0,25,0,-25
18254,1,1,457,1807,1350
18255,0,0,0,0,0
18256,1,1,311,1276,965
18257,1,0,15,0,-15
18258,0,0,19,0,-19
18259,1,1,286,1277,991
18260,1,1,1086,1401,315
18261,0,0,4,0,-4
18262,0,0,4,0,-4
18263,1,0,11,0,-11
18264,1,1,83,1545,1462
18265,0,0,2,0,-2
18266,1,0,61,0,-61
18267,1,1,859,1224,365
18268,1,1,307,2364,2057
18269,1,0,97,0,-97
18270,0,0,1,0,-1
18271,1,0,161,0,-161
18272,1,0,130,0,-130
18273,0,0,14,0,-14
18274,1,0,1,0,-1
18275,0,0,52,0,-52
18276,1,1,31,1530,1499
18277,1,0,48,0,-48
18278,0,0,92,0,-92
18279,0,0,109,0,-109
18280,0,0,6,0,-6
18281,0,0,12,0,-12
18282,0,0,29,0,-29
18283,0,0,18,0,-18
18284,1,1,100,1495,1395
18285,1,0,3,0,-3
18286,1,1,179,1423,1244
18287,0,0,14,0,-14
18288,1,1,375,1228,853
18289,1,1,260,1967,1707
18290,1,0,0,0,0
18291,1,0,5,0,-5
18292,1,1,125,1437,1312
18293,0,0,278,0,-278
18294,1,0,16,0,-16
18295,0,0,13,0,-13
18296,0,0,7,0,-7
18297,0,0,81,0,-81
18298,1,0,17,0,-17
18299,1,0,28,0,-28
18300,1,0,32,0,-32
18301,1,0,12,0,-12
18302,1,1,46,1735,1689
18303,1,0,37,0,-37
18304,0,0,54,0,-54
18305,0,0,36,0,-36
18306,1,0,16,0,-16
18307,0,0,46,0,-46
18308,1,0,104,0,-104
18309,1,0,79,0,-79
18310,0,0,124,0,-124
18311,0,0,13,0,-13
18312,0,0,58,0,-58
18313,0,0,103,0,-103
18314,0,0,43,0,-43
18315,0,0,4,0,-4
18316,0,0,4,0,-4
18317,0,0,37,0,-37
18318,1,0,77,0,-77
18319,0,0,7,0,-7
18320,0,0,6,0,-6
18321,0,0,38,0,-38
18322,0,0,15,0,-15
18323,1,1,154,1616,1462
18324,1,0,89,0,-89
18325,0,0,48,0,-48
18326,0,0,13,0,-13
18327,1,0,9,0,-9
18328,0,0,11,0,-11
18329,0,0,72,0,-72
18330,1,1,102,1336,1234
18331,0,0,108,0,-108
18332,1,1,590,1444,854
18333,1,1,704,1294,590
18334,1,0,5,0,-5
18335,1,0,45,0,-45
18336,1,1,42,1215,1173
18337,1,0,109,0,-109
18338,0,0,34,0,-34
18339,1,1,205,1664,1459
18340,0,0,96,0,-96
18341,0,0,62,0,-62
18342,1,1,448,1489,1041
18343,0,0,49,0,-49
18344,1,0,4,0,-4
18345,1,0,52,0,-52
18346,0,0,6,0,-6
18347,0,0,135,0,-135
18348,1,0,36,0,-36
18349,1,1,790,1511,721
18350,1,1,289,1512,1223
18351,1,0,109,0,-109
18352,1,0,31,0,-31
18353,1,0,142,0,-142
18354,0,0,3,0,-3
18355,0,0,121,0,-121
18356,1,0,87,0,-87
18357,1,0,22,0,-22
18358,0,0,94,0,-94
18359,0,0,82,0,-82
18360,1,1,694,1373,679
18361,1,0,6,0,-6
18362,0,0,8,0,-8
18363,1,1,1565,1569,4
18364,1,0,182,0,-182
18365,1,0,145,0,-145
18366,1,0,27,0,-27
18367,1,0,17,0,-17
18368,1,0,96,0,-96
18369,0,0,6,0,-6
18370,1,1,279,1404,1125
18371,0,0,59,0,-59
18372,0,0,0,0,0
18373,0,0,44,0,-44
18374,0,0,9,0,-9
18375,1,0,104,0,-104
18376,1,0,17,0,-17
18377,1,0,72,0,-72
18378,1,0,99,0,-99
18379,1,1,373,1299,926
18380,1,0,3,0,-3
18381,1,1,87,1326,1239
18382,1,1,1516,1507,-9
18383,1,0,2,0,-2
18384,0,0,91,0,-91
18385,1,0,48,0,-48
18386,1,1,365,1489,1124
18387,0,0,13,0,-13
18388,1,0,211,0,-211
18389,0,0,61,0,-61
18390,1,1,322,1512,1190
18391,0,0,7,0,-7
18392,0,0,99,0,-99
18393,1,0,8,0,-8
18394,0,0,20,0,-20
18395,1,0,96,0,-96
18396,0,0,128,0,-128
18397,1,1,359,1284,925
18398,1,0,41,0,-41
18399,1,1,84,3386,3302
18400,1,0,4,0,-4
18401,1,1,2677,1533,-1144
18402,1,0,31,0,-31
18403,1,1,75,1582,1507
18404,1,0,9,0,-9
18405,1,0,0,0,0
18406,0,0,132,0,-132
18407,0,0,44,0,-44
18408,1,0,27,0,-27
18409,1,0,136,0,-136
18410,0,0,40,0,-40
18411,1,0,8,0,-8
18412,0,0,80,0,-80
18413,1,1,2479,1201,-1278
18414,0,0,17,0,-17
18415,1,1,184,1556,1372
18416,1,1,176,1225,1049
18417,0,0,1,0,-1
18418,0,0,20,0,-20
18419,1,1,783,1636,853
18420,0,0,41,0,-41
18421,0,0,115,0,-115
18422,0,0,208,0,-208
18423,0,0,5,0,-5
18424,1,0,39,0,-39
18425,1,1,185,1316,1131
18426,1,1,774,1547,773
18427,0,0,93,0,-93
18428,1,1,53,2373,2320
18429,1,0,22,0,-22
18430,1,1,167,1221,1054
18431,0,0,75,0,-75
18432,1,1,357,1443,1086
18433,1,1,194,1423,1229
18434,1,0,30,0,-30
18435,0,0,44,0,-44
18436,1,1,399,1399,1000
18437,1,1,803,1236,433
18438,1,1,474,1508,1034
18439,0,0,23,0,-23
18440,1,0,49,0,-49
18441,1,1,979,1312,333
18442,1,1,1973,2190,217
18443,1,1,947,1576,629
18444,0,0,110,0,-110
18445,0,0,49,0,-49
18446,0,0,3,0,-3
18447,1,0,12,0,-12
18448,1,1,2356,4907,2551
18449,1,1,3907,1912,-1995
18450,1,0,41,0,-41
18451,1,1,2339,1240,-1099
18452,1,0,17,0,-17
18453,1,1,1673,1494,-179
18454,0,0,157,0,-157
18455,1,0,9,0,-9
18456,1,0,57,0,-57
18457,1,1,1181,1923,742
18458,1,1,494,1250,756
18459,1,0,53,0,-53
18460,1,1,279,1327,1048
18461,1,1,585,1332,747
18462,0,0,21,0,-21
18463,1,1,578,1393,815
18464,1,0,18,0,-18
18465,0,0,94,0,-94
18466,0,0,87,0,-87
18467,1,1,395,1445,1050
18468,0,0,72,0,-72
18469,1,1,639,1234,595
18470,1,0,17,0,-17
18471,0,0,4,0,-4
18472,1,0,6,0,-6
18473,0,0,109,0,-109
18474,0,0,43,0,-43
18475,0,0,24,0,-24
18476,0,0,77,0,-77
18477,1,0,5,0,-5
18478,0,0,113,0,-113
18479,0,0,169,0,-169
18480,0,0,46,0,-46
18481,1,0,15,0,-15
18482,1,1,1300,1345,45
18483,1,1,395,2487,2092
18484,0,0,41,0,-41
18485,1,0,1,0,-1
18486,0,0,64,0,-64
18487,1,1,455,1586,1131
18488,0,0,33,0,-33
18489,0,0,45,0,-45
18490,1,0,16,0,-16
18491,1,1,483,2465,1982
18492,1,1,261,1203,942
18493,1,1,410,1362,952
18494,1,1,149,1212,1063
18495,1,1,533,1359,826
18496,1,0,57,0,-57
18497,1,1,148,1242,1094
18498,1,0,74,0,-74
18499,0,0,61,0,-61
18500,1,1,549,2124,1575
18501,0,0,133,0,-133
18502,0,0,110,0,-110
18503,0,0,9,0,-9
18504,1,0,112,0,-112
18505,0,0,39,0,-39
18506,1,1,217,1381,1164
18507,1,1,255,1564,1309
18508,0,0,32,0,-32
18509,1,0,38,0,-38
18510,1,1,366,1255,889
18511,1,1,97,1360,1263
18512,0,0,26,0,-26
18513,1,0,189,0,-189
18514,1,1,156,1442,1286
18515,1,1,113,1415,1302
18516,0,0,65,0,-65
18517,1,1,865,1235,370
18518,0,0,0,0,0
18519,0,0,55,0,-55
18520,1,0,80,0,-80
18521,1,1,664,1509,845
18522,0,0,8,0,-8
18523,0,0,6,0,-6
18524,1,1,124,1636,1512
18525,1,1,52,1219,1167
18526,0,0,0,0,0
18527,0,0,20,0,-20
18528,1,1,76,1968,1892
18529,0,0,1,0,-1
18530,1,0,11,0,-11
18531,1,0,99,0,-99
18532,0,0,159,0,-159
18533,1,0,87,0,-87
18534,1,0,9,0,-9
18535,0,0,1,0,-1
18536,1,1,392,1531,1139
18537,0,0,14,0,-14
18538,0,0,7,0,-7
18539,1,1,406,1698,1292
18540,1,1,973,1683,710
18541,0,0,11,0,-11
18542,1,0,26,0,-26
18543,0,0,13,0,-13
18544,0,0,23,0,-23
18545,0,0,30,0,-30
18546,1,1,792,1366,574
18547,1,0,6,0,-6
18548,1,1,1933,1209,-724
18549,1,1,2321,1221,-1100
18550,1,0,46,0,-46
18551,1,1,862,1375,513
18552,0,0,97,0,-97
18553,1,1,1758,2723,965
18554,1,1,169,2490,2321
18555,1,0,84,0,-84
18556,1,1,97,1226,1129
18557,1,1,538,1338,800
18558,0,0,120,0,-120
18559,1,1,164,1611,1447
18560,1,1,122,1454,1332
18561,1,1,65,1207,1142
18562,1,0,3,0,-3
18563,0,0,9,0,-9
18564,0,0,104,0,-104
18565,0,0,43,0,-43
18566,0,0,78,0,-78
18567,1,1,496,1396,900
18568,0,0,14,0,-14
18569,1,1,359,1977,1618
18570,1,0,52,0,-52
18571,0,0,7,0,-7
18572,1,0,61,0,-61
18573,1,1,158,2339,2181
18574,0,0,8,0,-8
18575,1,1,454,1363,909
18576,1,1,274,1306,1032
18577,1,1,655,1205,550
18578,0,0,59,0,-59
18579,0,0,28,0,-28
18580,0,0,44,0,-44
18581,1,1,242,1271,1029
18582,1,0,9,0,-9
18583,0,0,25,0,-25
18584,1,0,13,0,-13
18585,0,0,17,0,-17
18586,1,0,33,0,-33
18587,1,1,394,1331,937
18588,1,1,210,1434,1224
18589,1,0,28,0,-28
18590,0,0,1,0,-1
18591,0,0,168,0,-168
18592,1,0,73,0,-73
18593,1,0,37,0,-37
18594,1,0,66,0,-66
18595,0,0,25,0,-25
18596,0,0,22,0,-22
18597,0,0,4,0,-4
18598,1,0,11,0,-11
18599,1,0,15,0,-15
18600,0,0,7,0,-7
18601,0,0,32,0,-32
18602,1,0,5,0,-5
18603,1,1,443,1592,1149
18604,0,0,53,0,-53
18605,0,0,10,0,-10
18606,1,0,68,0,-68
18607,0,0,12,0,-12
18608,1,0,68,0,-68
18609,1,1,401,1388,987
18610,1,1,1633,1588,-45
18611,1,1,269,1419,1150
18612,1,1,990,1403,413
18613,0,0,72,0,-72
18614,1,1,95,1299,1204
18615,0,0,7,0,-7
18616,1,1,31,1478,1447
18617,0,0,30,0,-30
18618,1,0,15,0,-15
18619,1,0,48,0,-48
18620,1,1,303,1410,1107
18621,0,0,34,0,-34
18622,0,0,159,0,-159
18623,1,0,49,0,-49
18624,0,0,45,0,-45
18625,1,0,32,0,-32
18626,1,1,287,1464,1177
18627,1,1,124,1285,1161
18628,1,0,1,0,-1
18629,0,0,45,0,-45
18630,0,0,50,0,-50
18631,1,1,177,1347,1170
18632,1,0,22,0,-22
18633,1,1,191,1331,1140
18634,0,0,5,0,-5
18635,1,0,10,0,-10
18636,1,0,49,0,-49
18637,1,1,395,1234,839
18638,0,0,35,0,-35
18639,0,0,28,0,-28
18640,0,0,139,0,-139
18641,0,0,32,0,-32
18642,0,0,25,0,-25
18643,0,0,16,0,-16
18644,1,0,72,0,-72
18645,1,1,192,1662,1470
18646,1,1,807,1426,619
18647,1,0,3,0,-3
18648,1,1,942,1712,770
18649,0,0,104,0,-104
18650,0,0,3,0,-3
18651,0,0,72,0,-72
18652,0,0,108,0,-108
18653,1,0,32,0,-32
18654,1,0,11,0,-11
18655,0,0,20,0,-20
18656,1,0,22,0,-22
18657,1,1,206,1247,1041
18658,0,0,109,0,-109
18659,1,0,15,0,-15
18660,1,1,657,1339,682
18661,0,0,41,0,-41
18662,1,1,657,1704,1047
18663,0,0,35,0,-35
18664,0,0,9,0,-9
18665,0,0,6,0,-6
18666,0,0,161,0,-161
18667,1,1,113,1627,1514
18668,0,0,49,0,-49
18669,1,0,67,0,-67
18670,1,1,307,1277,970
18671,0,0,74,0,-74
18672,0,0,41,0,-41
18673,1,1,1423,1521,98
18674,0,0,5,0,-5
18675,1,1,298,1478,1180
18676,0,0,97,0,-97
18677,0,0,34,0,-34
18678,0,0,54,0,-54
18679,0,0,20,0,-20
18680,0,0,62,0,-62
18681,1,1,1792,1572,-220
18682,0,0,15,0,-15
18683,1,1,763,3082,2319
18684,1,1,299,1728,1429
18685,1,1,771,1357,586
18686,1,0,27,0,-27
18687,1,0,18,0,-18
18688,0,0,47,0,-47
18689,1,0,39,0,-39
18690,1,0,3,0,-3
18691,1,0,18,0,-18
18692,1,1,123,8896,8773
18693,0,0,144,0,-144
18694,0,0,67,0,-67
18695,1,1,606,1517,911
18696,0,0,35,0,-35
18697,0,0,29,0,-29
18698,0,0,26,0,-26
18699,1,1,291,1481,1190
18700,0,0,12,0,-12
18701,0,0,54,0,-54
18702,0,0,20,0,-20
18703,1,0,102,0,-102
18704,1,0,4,0,-4
18705,1,1,348,1987,1639
18706,1,0,82,0,-82
18707,0,0,44,0,-44
18708,0,0,16,0,-16
18709,1,1,108,1512,1404
18710,1,1,69,1619,1550
18711,0,0,33,0,-33
18712,0,0,46,0,-46
18713,0,0,18,0,-18
18714,1,1,24,1575,1551
18715,1,0,15,0,-15
18716,0,0,0,0,0
18717,1,1,186,1889,1703
18718,0,0,30,0,-30
18719,1,1,581,2452,1871
18720,0,0,24,0,-24
18721,1,1,1259,2212,953
18722,0,0,18,0,-18
18723,0,0,23,0,-23
18724,1,1,153,1469,1316
18725,0,0,102,0,-102
18726,0,0,125,0,-125
18727,1,0,69,0,-69
18728,1,1,204,1246,1042
18729,1,1,172,1242,1070
18730,1,1,417,1653,1236
18731,0,0,9,0,-9
18732,1,0,14,0,-14
18733,1,0,124,0,-124
18734,1,0,83,0,-83
18735,1,1,257,1293,1036
18736,1,0,57,0,-57
18737,1,1,333,1807,1474
18738,1,1,702,1806,1104
18739,1,1,865,1612,747
18740,1,1,273,1641,1368
18741,1,1,105,1274,1169
18742,0,0,45,0,-45
18743,0,0,233,0,-233
18744,0,0,113,0,-113
18745,1,0,14,0,-14
18746,0,0,87,0,-87
18747,1,1,332,1938,1606
18748,0,0,25,0,-25
18749,1,0,0,0,0
18750,1,1,110,1270,1160
18751,0,0,15,0,-15
18752,1,0,87,0,-87
18753,1,0,14,0,-14
18754,1,1,262,1376,1114
18755,0,0,34,0,-34
18756,1,0,22,0,-22
18757,0,0,34,0,-34
18758,1,0,13,0,-13
18759,0,0,7,0,-7
18760,1,1,95,2170,2075
18761,1,1,352,1234,882
18762,0,0,12,0,-12
18763,1,1,201,1251,1050
18764,1,1,350,1451,1101
18765,1,1,1111,1239,128
18766,0,0,8,0,-8
18767,0,0,141,0,-141
18768,0,0,34,0,-34
18769,0,0,24,0,-24
18770,1,0,22,0,-22
18771,1,0,17,0,-17
18772,1,1,138,1296,1158
18773,1,1,527,1253,726
18774,1,1,55,1801,1746
18775,0,0,24,0,-24
18776,1,0,124,0,-124
18777,0,0,35,0,-35
18778,0,0,13,0,-13
18779,1,0,14,0,-14
18780,1,1,148,1303,1155
18781,0,0,61,0,-61
18782,1,0,107,0,-107
18783,0,0,21,0,-21
18784,0,0,135,0,-135
18785,1,1,659,1335,676
18786,1,1,116,1322,1206
18787,1,1,27,1454,1427
18788,1,1,541,1319,778
18789,0,0,4,0,-4
18790,1,1,97,3050,2953
18791,1,0,31,0,-31
18792,0,0,9,0,-9
18793,1,1,512,1237,725
18794,1,1,162,2210,2048
18795,1,1,406,1752,1346
18796,1,1,516,1604,1088
18797,1,0,0,0,0
18798,1,1,214,1331,1117
18799,0,0,32,0,-32
18800,1,1,295,1290,995
18801,1,1,64,1360,1296
18802,1,0,42,0,-42
18803,1,0,50,0,-50
18804,0,0,61,0,-61
18805,1,1,192,1442,1250
18806,0,0,5,0,-5
18807,1,1,1447,1356,-91
18808,1,1,254,1256,1002
18809,0,0,16,0,-16
18810,0,0,70,0,-70
18811,0,0,90,0,-90
18812,1,0,10,0,-10
18813,1,0,37,0,-37
18814,0,0,6,0,-6
18815,1,1,314,1235,921
18816,1,0,17,0,-17
18817,0,0,94,0,-94
18818,1,1,199,1510,1311
18819,1,0,17,0,-17
18820,1,0,76,0,-76
18821,0,0,63,0,-63
18822,0,0,104,0,-104
18823,1,1,412,1446,1034
18824,1,1,211,3219,3008
18825,1,1,575,1298,723
18826,0,0,17,0,-17
18827,1,1,305,2074,1769
18828,1,1,34,1241,1207
18829,0,0,105,0,-105
18830,1,0,14,0,-14
18831,0,0,155,0,-155
18832,1,0,171,0,-171
18833,0,0,26,0,-26
18834,0,0,111,0,-111
18835,0,0,68,0,-68
18836,0,0,7,0,-7
18837,1,0,23,0,-23
18838,0,0,119,0,-119
18839,0,0,27,0,-27
18840,0,0,51,0,-51
18841,1,0,6,0,-6
18842,1,0,16,0,-16
18843,1,1,558,1332,774
18844,0,0,20,0,-20
18845,0,0,83,0,-83
18846,1,1,35,2391,2356
18847,1,0,58,0,-58
18848,0,0,46,0,-46
18849,0,0,7,0,-7
18850,1,1,27,2732,2705
18851,1,0,31,0,-31
18852,1,1,288,1448,1160
18853,1,1,34,1532,1498
18854,0,0,36,0,-36
18855,1,1,115,1730,1615
18856,0,0,11,0,-11
18857,1,0,27,0,-27
18858,0,0,51,0,-51
18859,0,0,8,0,-8
18860,0,0,9,0,-9
18861,1,1,243,1895,1652
18862,1,0,26,0,-26
18863,1,1,713,1505,792
18864,1,1,263,2039,1776
18865,0,0,150,0,-150
18866,0,0,40,0,-40
18867,0,0,47,0,-47
18868,1,0,53,0,-53
18869,1,0,58,0,-58
18870,0,0,57,0,-57
18871,1,1,222,1218,996
18872,1,0,23,0,-23
18873,1,1,556,2768,2212
18874,0,0,4,0,-4
18875,1,1,584,1258,674
18876,1,0,21,0,-21
18877,1,0,82,0,-82
18878,0,0,3,0,-3
18879,0,0,31,0,-31
18880,1,1,1191,1591,400
18881,1,0,3,0,-3
18882,1,0,77,0,-77
18883,1,0,49,0,-49
18884,1,1,327,1956,1629
18885,0,0,49,0,-49
18886,1,1,651,1230,579
18887,1,0,109,0,-109
18888,0,0,44,0,-44
18889,1,0,26,0,-26
18890,0,0,61,0,-61
18891,1,1,359,1428,1069
18892,0,0,68,0,-68
18893,1,0,288,0,-288
18894,0,0,34,0,-34
18895,1,0,45,0,-45
18896,1,0,20,0,-20
18897,0,0,54,0,-54
18898,0,0,16,0,-16
18899,1,1,257,1449,1192
18900,1,1,1437,3821,2384
18901,1,0,10,0,-10
18902,0,0,45,0,-45
18903,1,1,334,1708,1374
18904,0,0,28,0,-28
18905,1,0,27,0,-27
18906,0,0,19,0,-19
18907,1,0,61,0,-61
18908,0,0,124,0,-124
18909,0,0,4,0,-4
18910,1,1,97,2206,2109
18911,1,0,37,0,-37
18912,1,1,725,1422,697
18913,0,0,26,0,-26
18914,1,1,54,1411,1357
18915,0,0,59,0,-59
18916,1,0,35,0,-35
18917,1,1,170,1327,1157
18918,0,0,94,0,-94
18919,1,0,8,0,-8
18920,1,0,0,0,0
18921,0,0,24,0,-24
18922,1,0,89,0,-89
18923,0,0,100,0,-100
18924,1,0,1,0,-1
18925,0,0,132,0,-132
18926,1,0,6,0,-6
18927,1,0,4,0,-4
18928,1,0,179,0,-179
18929,0,0,213,0,-213
18930,1,1,39,2313,2274
18931,0,0,58,0,-58
18932,0,0,93,0,-93
18933,0,0,22,0,-22
18934,0,0,53,0,-53
18935,0,0,27,0,-27
18936,0,0,0,0,0
18937,1,1,260,1323,1063
18938,1,1,135,1277,1142
18939,0,0,37,0,-37
18940,0,0,287,0,-287
18941,1,1,342,1322,980
18942,0,0,69,0,-69
18943,1,0,13,0,-13
18944,1,0,31,0,-31
18945,1,0,50,0,-50
18946,0,0,95,0,-95
18947,0,0,3,0,-3
18948,1,0,44,0,-44
18949,0,0,64,0,-64
18950,1,0,324,0,-324
18951,1,0,138,0,-138
18952,1,1,674,1552,878
18953,0,0,13,0,-13
18954,0,0,44,0,-44
18955,1,1,955,1422,467
18956,1,1,966,1278,312
18957,0,0,43,0,-43
18958,0,0,8,0,-8
18959,1,1,286,1841,1555
18960,0,0,26,0,-26
18961,0,0,10,0,-10
18962,1,0,41,0,-41
18963,1,0,99,0,-99
18964,0,0,14,0,-14
18965,0,0,2,0,-2
18966,0,0,4,0,-4
18967,1,0,125,0,-125
18968,1,1,480,1733,1253
18969,1,0,11,0,-11
18970,0,0,222,0,-222
18971,1,0,31,0,-31
18972,0,0,0,0,0
18973,0,0,34,0,-34
18974,1,1,1908,1288,-620
18975,0,0,73,0,-73
18976,0,0,41,0,-41
18977,1,1,126,1763,1637
18978,1,1,898,1253,355
18979,1,1,1677,3947,2270
18980,0,0,18,0,-18
18981,1,0,39,0,-39
18982,1,1,56,1455,1399
18983,0,0,51,0,-51
18984,0,0,61,0,-61
18985,1,1,355,1268,913
18986,1,0,35,0,-35
18987,0,0,56,0,-56
18988,1,0,55,0,-55
18989,0,0,101,0,-101
18990,1,0,71,0,-71
18991,1,1,451,1969,1518
18992,1,0,99,0,-99
18993,0,0,135,0,-135
18994,1,1,2095,2284,189
18995,1,1,430,2008,1578
18996,1,0,63,0,-63
18997,1,1,219,1560,1341
18998,1,0,45,0,-45
18999,1,1,468,1273,805
19000,0,0,65,0,-65
19001,0,0,46,0,-46
19002,1,1,86,1208,1122
19003,0,0,51,0,-51
19004,0,0,28,0,-28
19005,0,0,1,0,-1
19006,0,0,12,0,-12
19007,0,0,93,0,-93
19008,1,0,46,0,-46
19009,0,0,23,0,-23
19010,0,0,26,0,-26
19011,1,0,150,0,-150
19012,0,0,158,0,-158
19013,0,0,17,0,-17
19014,1,1,1510,1395,-115
19015,0,0,17,0,-17
19016,0,0,60,0,-60
19017,0,0,100,0,-100
19018,1,1,107,1250,1143
19019,1,0,16,0,-16
19020,0,0,5,0,-5
19021,1,1,407,1279,872
19022,0,0,66,0,-66
19023,0,0,35,0,-35
19024,1,1,156,1402,1246
19025,0,0,15,0,-15
19026,1,0,32,0,-32
19027,0,0,36,0,-36
19028,1,0,32,0,-32
19029,0,0,0,0,0
19030,1,1,138,1625,1487
19031,1,1,443,1378,935
19032,1,0,42,0,-42
19033,1,0,8,0,-8
19034,1,1,537,1741,1204
19035,0,0,4,0,-4
19036,1,0,10,0,-10
19037,1,0,46,0,-46
19038,0,0,69,0,-69
19039,0,0,84,0,-84
19040,1,0,129,0,-129
19041,0,0,28,0,-28
19042,1,0,22,0,-22
19043,1,0,37,0,-37
19044,1,0,11,0,-11
19045,0,0,60,0,-60
19046,1,1,369,1244,875
19047,1,1,116,1653,1537
19048,0,0,4,0,-4
19049,1,1,1428,1328,-100
19050,1,1,643,1499,856
19051,0,0,73,0,-73
19052,1,1,685,2220,1535
19053,0,0,110,0,-110
19054,0,0,75,0,-75
19055,1,1,949,1313,364
19056,1,0,137,0,-137
19057,1,1,126,1559,1433
19058,0,0,117,0,-117
19059,1,0,114,0,-114
19060,1,0,88,0,-88
19061,1,1,521,1226,705
19062,0,0,10,0,-10
19063,0,0,91,0,-91
19064,1,0,129,0,-129
19065,0,0,222,0,-222
19066,0,0,53,0,-53
19067,0,0,24,0,-24
19068,1,0,30,0,-30
19069,0,0,7,0,-7
19070,1,1,980,1600,620
19071,1,0,51,0,-51
19072,0,0,6,0,-6
19073,0,0,167,0,-167
19074,1,0,61,0,-61
19075,1,1,652,1203,551
19076,0,0,62,0,-62
19077,1,1,933,1218,285
19078,1,0,39,0,-39
19079,0,0,56,0,-56
19080,0,0,112,0,-112
19081,1,1,170,2348,2178
19082,1,1,205,1737,1532
19083,1,0,11,0,-11
19084,1,1,931,1340,409
19085,0,0,15,0,-15
19086,1,1,489,1342,853
19087,0,0,261,0,-261
19088,1,1,336,1236,900
19089,1,0,44,0,-44
19090,0,0,6,0,-6
19091,1,0,136,0,-136
19092,1,1,640,3222,2582
19093,1,1,1041,1518,477
19094,1,0,214,0,-214
19095,1,0,73,0,-73
19096,1,1,501,1403,902
19097,0,0,4,0,-4
19098,0,0,49,0,-49
19099,1,1,58,1396,1338
19100,1,1,228,2143,1915
19101,1,0,27,0,-27
19102,0,0,119,0,-119
19103,1,0,139,0,-139
19104,1,1,754,1206,452
19105,1,1,110,1258,1148
19106,1,1,143,1480,1337
19107,1,1,724,1204,480
19108,1,0,8,0,-8
19109,1,0,91,0,-91
19110,1,0,33,0,-33
19111,0,0,1,0,-1
19112,0,0,3,0,-3
19113,1,0,106,0,-106
19114,1,0,55,0,-55
19115,0,0,72,0,-72
19116,1,0,18,0,-18
19117,0,0,16,0,-16
19118,1,0,21,0,-21
19119,1,0,8,0,-8
19120,1,1,1041,1312,271
19121,0,0,10,0,-10
19122,1,1,1563,1313,-250
19123,0,0,0,0,0
19124,0,0,1,0,-1
19125,0,0,30,0,-30
19126,1,1,102,2519,2417
19127,0,0,19,0,-19
19128,1,1,440,1345,905
19129,1,0,8,0,-8
19130,1,0,53,0,-53
19131,0,0,16,0,-16
19132,0,0,59,0,-59
19133,0,0,11,0,-11
19134,1,1,656,1266,610
19135,0,0,28,0,-28
19136,1,0,186,0,-186
19137,1,1,1172,1225,53
19138,1,1,1045,1642,597
19139,1,0,126,0,-126
19140,0,0,70,0,-70
19141,0,0,5,0,-5
19142,0,0,8,0,-8
19143,1,1,100,1258,1158
19144,0,0,5,0,-5
19145,0,0,17,0,-17
19146,1,0,139,0,-139
19147,1,0,0,0,0
19148,0,0,53,0,-53
19149,0,0,53,0,-53
19150,0,0,7,0,-7
19151,1,0,67,0,-67
19152,1,1,403,1301,898
19153,1,0,30,0,-30
19154,1,1,234,2140,1906
19155,0,0,63,0,-63
19156,1,0,20,0,-20
19157,1,1,305,2550,2245
19158,1,1,169,1298,1129
19159,0,0,2,0,-2
19160,1,0,40,0,-40
19161,1,1,85,1392,1307
19162,0,0,31,0,-31
19163,0,0,16,0,-16
19164,0,0,45,0,-45
19165,0,0,50,0,-50
19166,0,0,142,0,-142
19167,1,1,1164,1693,529
19168,0,0,73,0,-73
19169,1,0,35,0,-35
19170,0,0,155,0,-155
19171,0,0,82,0,-82
19172,1,1,2025,1420,-605
19173,1,0,21,0,-21
19174,1,1,749,1989,1240
19175,1,1,640,1495,855
19176,1,0,33,0,-33
19177,0,0,6,0,-6
19178,0,0,8,0,-8
19179,1,1,687,1328,641
19180,0,0,22,0,-22
19181,1,0,47,0,-47
19182,1,1,170,1500,1330
19183,0,0,31,0,-31
19184,1,1,448,1427,979
19185,1,0,4,0,-4
19186,1,1,410,1717,1307
19187,1,0,42,0,-42
19188,0,0,25,0,-25
19189,1,1,22,1411,1389
19190,1,1,1234,1357,123
19191,1,1,255,1616,1361
19192,1,1,1398,1216,-182
19193,0,0,38,0,-38
19194,0,0,20,0,-20
19195,0,0,42,0,-42
19196,0,0,35,0,-35
19197,1,1,114,1214,1100
19198,1,0,66,0,-66
19199,0,0,10,0,-10
19200,1,1,579,2480,1901
19201,1,1,159,1613,1454
19202,0,0,11,0,-11
19203,0,0,25,0,-25
19204,0,0,46,0,-46
19205,1,0,15,0,-15
19206,1,0,28,0,-28
19207,0,0,6,0,-6
19208,0,0,8,0,-8
19209,1,0,41,0,-41
19210,0,0,84,0,-84
19211,0,0,60,0,-60
19212,1,1,241,1401,1160
19213,1,0,70,0,-70
19214,1,0,59,0,-59
19215,1,1,537,2054,1517
19216,1,1,317,1480,1163
19217,0,0,123,0,-123
19218,1,1,508,1240,732
19219,0,0,24,0,-24
19220,0,0,2,0,-2
19221,1,0,158,0,-158
19222,1,1,239,1320,1081
19223,0,0,40,0,-40
19224,1,1,1815,1209,-606
19225,1,0,44,0,-44
19226,1,0,97,0,-97
19227,1,0,44,0,-44
19228,0,0,91,0,-91
19229,0,0,46,0,-46
19230,1,0,131,0,-131
19231,1,0,29,0,-29
19232,0,0,15,0,-15
19233,1,0,1,0,-1
19234,0,0,13,0,-13
19235,1,0,34,0,-34
19236,1,0,80,0,-80
19237,1,0,70,0,-70
19238,0,0,3,0,-3
19239,0,0,63,0,-63
19240,1,0,35,0,-35
19241,0,0,53,0,-53
19242,0,0,2,0,-2
19243,1,0,54,0,-54
19244,0,0,1,0,-1
19245,1,0,19,0,-19
19246,1,1,612,1596,984
19247,1,0,58,0,-58
19248,1,0,7,0,-7
19249,1,0,42,0,-42
19250,1,1,646,1670,1024
19251,1,1,2802,1209,-1593
19252,1,1,884,1271,387
19253,0,0,34,0,-34
19254,0,0,64,0,-64
19255,1,0,47,0,-47
19256,1,1,397,2360,1963
19257,1,0,159,0,-159
19258,0,0,58,0,-58
19259,0,0,26,0,-26
19260,1,1,769,1383,614
19261,0,0,11,0,-11
19262,1,0,59,0,-59
19263,1,1,560,1462,902
19264,0,0,42,0,-42
19265,1,1,213,1518,1305
19266,1,1,1109,2446,1337
19267,1,0,3,0,-3
19268,1,1,382,1584,1202
19269,0,0,52,0,-52
19270,1,0,93,0,-93
19271,1,1,441,1800,1359
19272,0,0,16,0,-16
19273,0,0,47,0,-47
19274,0,0,33,0,-33
19275,1,0,27,0,-27
19276,0,0,22,0,-22
19277,1,0,6,0,-6
19278,0,0,0,0,0
19279,1,0,18,0,-18
19280,0,0,3,0,-3
19281,0,0,39,0,-39
19282,0,0,5,0,-5
19283,0,0,39,0,-39
19284,1,0,10,0,-10
19285,1,0,15,0,-15
19286,1,1,297,1499,1202
19287,0,0,55,0,-55
19288,1,1,33,1211,1178
19289,1,0,33,0,-33
19290,1,1,178,1276,1098
19291,1,1,462,1457,995
19292,1,0,20,0,-20
19293,0,0,6,0,-6
19294,0,0,29,0,-29
19295,0,0,30,0,-30
19296,1,1,75,1964,1889
19297,0,0,10,0,-10
19298,0,0,22,0,-22
19299,1,1,813,1311,498
19300,0,0,34,0,-34
19301,1,0,29,0,-29
19302,1,1,484,1401,917
19303,1,0,39,0,-39
19304,1,0,11,0,-11
19305,1,0,32,0,-32
19306,1,0,30,0,-30
19307,0,0,11,0,-11
19308,1,1,115,1206,1091
19309,0,0,166,0,-166
19310,0,0,4,0,-4
19311,1,0,1,0,-1
19312,0,0,11,0,-11
19313,0,0,2,0,-2
19314,1,0,105,0,-105
19315,1,1,1568,1575,7
19316,1,0,82,0,-82
19317,0,0,72,0,-72
19318,1,0,8,0,-8
19319,1,1,172,1409,1237
19320,1,1,185,1875,1690
19321,1,1,139,3183,3044
19322,1,1,102,1971,1869
19323,1,1,593,1977,1384
19324,0,0,26,0,-26
19325,1,1,766,1966,1200
19326,0,0,45,0,-45
19327,1,0,87,0,-87
19328,1,1,1236,1474,238
19329,1,1,455,1217,762
19330,1,1,751,3527,2776
19331,0,0,78,0,-78
19332,1,0,102,0,-102
19333,1,0,3,0,-3
19334,1,0,54,0,-54
19335,1,0,25,0,-25
19336,1,0,78,0,-78
19337,1,0,10,0,-10
19338,0,0,32,0,-32
19339,1,1,371,2922,2551
19340,1,1,445,1706,1261
19341,1,1,7,1416,1409
19342,1,0,75,0,-75
19343,0,0,38,0,-38
19344,1,0,175,0,-175
19345,1,1,494,1288,794
19346,1,0,7,0,-7
19347,0,0,36,0,-36
19348,1,1,117,1835,1718
19349,1,0,43,0,-43
19350,0,0,25,0,-25
19351,0,0,24,0,-24
19352,0,0,55,0,-55
19353,1,1,587,1543,956
19354,1,0,14,0,-14
19355,1,1,103,2448,2345
19356,1,1,119,2142,2023
19357,0,0,121,0,-121
19358,0,0,44,0,-44
19359,1,1,252,1927,1675
19360,1,0,15,0,-15
19361,1,1,383,1419,1036
19362,1,0,7,0,-7
19363,0,0,13,0,-13
19364,0,0,30,0,-30
19365,1,1,437,2066,1629
19366,1,1,93,1868,1775
19367,0,0,50,0,-50
19368,1,0,11,0,-11
19369,1,0,35,0,-35
19370,1,0,37,0,-37
19371,1,0,0,0,0
19372,1,1,552,1511,959
19373,1,0,76,0,-76
19374,1,0,33,0,-33
19375,0,0,69,0,-69
19376,1,1,1814,1234,-580
19377,1,0,74,0,-74
19378,1,1,890,1756,866
19379,1,0,20,0,-20
19380,1,1,544,1296,752
19381,0,0,18,0,-18
19382,1,1,196,1945,1749
19383,0,0,131,0,-131
19384,0,0,77,0,-77
19385,1,1,942,1222,280
19386,0,0,5,0,-5
19387,0,0,3,0,-3
19388,1,1,262,1290,1028
19389,1,0,45,0,-45
19390,0,0,59,0,-59
19391,0,0,33,0,-33
19392,0,0,89,0,-89
19393,0,0,1,0,-1
19394,1,1,598,1305,707
19395,1,0,130,0,-130
19396,1,1,793,1310,517
19397,1,0,8,0,-8
19398,1,1,569,1416,847
19399,1,1,283,1358,1075
19400,1,1,448,1475,1027
19401,1,0,63,0,-63
19402,1,1,57,1225,1168
19403,0,0,103,0,-103
19404,0,0,19,0,-19
19405,0,0,10,0,-10
19406,1,0,53,0,-53
19407,1,1,636,1493,857
19408,1,1,604,1699,1095
19409,1,1,353,1334,981
19410,0,0,56,0,-56
19411,1,0,12,0,-12
19412,0,0,66,0,-66
19413,1,0,32,0,-32
19414,1,1,2066,1352,-714
19415,0,0,54,0,-54
19416,0,0,32,0,-32
19417,0,0,107,0,-107
19418,0,0,15,0,-15
19419,0,0,46,0,-46
19420,1,1,913,1479,566
19421,1,0,2,0,-2
19422,1,1,567,1254,687
19423,0,0,6,0,-6
19424,0,0,27,0,-27
19425,1,0,50,0,-50
19426,1,0,108,0,-108
19427,1,1,275,1432,1157
19428,1,1,1086,1441,355
19429,1,1,848,1485,637
19430,1,1,368,1761,1393
19431,1,1,524,1726,1202
19432,0,0,69,0,-69
19433,0,0,45,0,-45
19434,1,0,54,0,-54
19435,0,0,27,0,-27
19436,1,0,22,0,-22
19437,0,0,10,0,-10
19438,1,1,699,1206,507
19439,1,1,680,1470,790
19440,0,0,8,0,-8
19441,0,0,14,0,-14
19442,1,1,285,1312,1027
19443,1,0,4,0,-4
19444,1,1,790,2570,1780
19445,0,0,227,0,-227
19446,0,0,78,0,-78
19447,1,0,36,0,-36
19448,1,1,459,1654,1195
19449,0,0,8,0,-8
19450,0,0,7,0,-7
19451,0,0,2,0,-2
19452,0,0,46,0,-46
19453,1,1,313,1434,1121
19454,1,0,15,0,-15
19455,0,0,18,0,-18
19456,1,0,1,0,-1
19457,1,1,228,1406,1178
19458,1,1,201,2607,2406
19459,1,1,409,1480,1071
19460,1,1,112,1287,1175
19461,0,0,36,0,-36
19462,0,0,49,0,-49
19463,1,0,49,0,-49
19464,1,0,50,0,-50
19465,0,0,67,0,-67
19466,1,0,2,0,-2
19467,0,0,139,0,-139
19468,1,0,171,0,-171
19469,1,1,293,1482,1189
19470,0,0,110,0,-110
19471,1,1,935,1204,269
19472,0,0,156,0,-156
19473,1,1,456,1386,930
19474,1,0,8,0,-8
19475,1,0,23,0,-23
19476,1,1,95,1239,1144
19477,1,1,99,1390,1291
19478,1,1,480,1787,1307
19479,0,0,27,0,-27
19480,0,0,5,0,-5
19481,1,1,1471,3385,1914
19482,1,1,517,1369,852
19483,0,0,11,0,-11
19484,1,0,4,0,-4
19485,0,0,10,0,-10
19486,1,0,77,0,-77
19487,0,0,2,0,-2
19488,0,0,18,0,-18
19489,0,0,0,0,0
19490,1,1,339,2317,1978
19491,1,1,840,1438,598
19492,1,1,116,1574,1458
19493,1,0,82,0,-82
19494,1,0,10,0,-10
19495,0,0,50,0,-50
19496,1,0,106,0,-106
19497,1,1,298,1249,951
19498,1,0,38,0,-38
19499,1,1,550,1550,1000
19500,1,0,88,0,-88
19501,1,0,59,0,-59
19502,1,1,615,1779,1164
19503,1,1,249,1431,1182
19504,1,1,163,1218,1055
19505,0,0,179,0,-179
19506,1,1,482,1329,847
19507,0,0,9,0,-9
19508,1,1,226,1456,1230
19509,1,0,107,0,-107
19510,1,0,105,0,-105
19511,1,1,3809,1500,-2309
19512,1,1,769,1302,533
19513,0,0,0,0,0
19514,0,0,27,0,-27
19515,1,1,45,1521,1476
19516,1,1,443,2550,2107
19517,1,1,539,1358,819
19518,0,0,5,0,-5
19519,1,0,21,0,-21
19520,0,0,36,0,-36
19521,1,1,1417,1673,256
19522,1,1,77,2957,2880
19523,1,0,47,0,-47
19524,0,0,37,0,-37
19525,0,0,34,0,-34
19526,1,1,975,1381,406
19527,0,0,32,0,-32
19528,1,1,102,1303,1201
19529,1,0,20,0,-20
19530,0,0,35,0,-35
19531,1,0,44,0,-44
19532,0,0,27,0,-27
19533,0,0,6,0,-6
19534,0,0,73,0,-73
19535,0,0,70,0,-70
19536,0,0,72,0,-72
19537,0,0,33,0,-33
19538,1,0,25,0,-25
19539,1,1,546,1210,664
19540,1,0,27,0,-27
19541,1,1,250,1389,1139
19542,0,0,46,0,-46
19543,1,0,58,0,-58
19544,0,0,11,0,-11
19545,0,0,6,0,-6
19546,1,1,374,1730,1356
19547,1,0,10,0,-10
19548,0,0,30,0,-30
19549,1,1,1467,1783,316
19550,0,0,30,0,-30
19551,0,0,45,0,-45
19552,1,1,1320,1892,572
19553,0,0,37,0,-37
19554,0,0,1,0,-1
19555,1,0,108,0,-108
19556,0,0,5,0,-5
19557,0,0,39,0,-39
19558,1,0,142,0,-142
19559,0,0,68,0,-68
19560,1,1,1390,1214,-176
19561,0,0,20,0,-20
19562,1,1,374,1347,973
19563,0,0,98,0,-98
19564,0,0,31,0,-31
19565,1,1,1057,1476,419
19566,0,0,7,0,-7
19567,0,0,26,0,-26
19568,0,0,26,0,-26
19569,0,0,29,0,-29
19570,0,0,13,0,-13
19571,1,0,84,0,-84
19572,0,0,12,0,-12
19573,0,0,80,0,-80
19574,1,0,4,0,-4
19575,0,0,59,0,-59
19576,0,0,74,0,-74
19577,1,1,1259,2243,984
19578,0,0,12,0,-12
19579,1,0,21,0,-21
19580,0,0,99,0,-99
19581,1,0,64,0,-64
19582,1,1,264,1295,1031
19583,0,0,164,0,-164
19584,1,1,1269,1532,263
19585,0,0,74,0,-74
19586,0,0,11,0,-11
19587,1,0,101,0,-101
19588,1,1,101,1236,1135
19589,0,0,16,0,-16
19590,1,1,1418,1445,27
19591,0,0,51,0,-51
19592,1,1,257,1601,1344
19593,1,1,1493,1583,90
19594,0,0,43,0,-43
19595,1,1,146,2226,2080
19596,1,1,146,1614,1468
19597,1,0,37,0,-37
19598,1,0,21,0,-21
19599,0,0,63,0,-63
19600,1,0,40,0,-40
19601,1,0,21,0,-21
19602,0,0,32,0,-32
19603,1,1,1461,1825,364
19604,1,1,641,1213,572
19605,0,0,50,0,-50
19606,1,1,83,1481,1398
19607,0,0,48,0,-48
19608,0,0,13,0,-13
19609,1,0,87,0,-87
19610,0,0,14,0,-14
19611,1,0,64,0,-64
19612,0,0,49,0,-49
19613,1,0,13,0,-13
19614,1,1,54,1515,1461
19615,0,0,22,0,-22
19616,1,0,5,0,-5
19617,0,0,33,0,-33
19618,1,1,351,1534,1183
19619,1,1,268,2020,1752
19620,1,0,75,0,-75
19621,1,0,27,0,-27
19622,1,0,132,0,-132
19623,1,0,30,0,-30
19624,1,1,382,1455,1073
19625,1,1,81,1298,1217
19626,0,0,20,0,-20
19627,1,0,11,0,-11
19628,1,1,78,2070,1992
19629,0,0,63,0,-63
19630,0,0,3,0,-3
19631,0,0,37,0,-37
19632,1,1,584,1426,842
19633,1,0,69,0,-69
19634,1,1,803,1307,504
19635,0,0,85,0,-85
19636,1,0,25,0,-25
19637,0,0,25,0,-25
19638,0,0,19,0,-19
19639,1,1,1031,1350,319
19640,0,0,19,0,-19
19641,1,0,33,0,-33
19642,0,0,26,0,-26
19643,0,0,13,0,-13
19644,1,0,94,0,-94
19645,0,0,18,0,-18
19646,0,0,12,0,-12
19647,1,0,53,0,-53
19648,1,1,287,1319,1032
19649,1,1,304,1311,1007
19650,0,0,93,0,-93
19651,1,0,127,0,-127
19652,0,0,34,0,-34
19653,0,0,33,0,-33
19654,0,0,16,0,-16
19655,0,0,28,0,-28
19656,1,1,92,1215,1123
19657,1,0,32,0,-32
19658,1,0,12,0,-12
19659,1,0,6,0,-6
19660,1,1,645,2166,1521
19661,0,0,14,0,-14
19662,1,1,63,1357,1294
19663,1,0,337,0,-337
19664,1,1,212,1440,1228
19665,1,0,148,0,-148
19666,0,0,63,0,-63
19667,1,1,257,1335,1078
19668,0,0,3,0,-3
19669,1,0,7,0,-7
19670,0,0,9,0,-9
19671,0,0,40,0,-40
19672,0,0,8,0,-8
19673,1,0,12,0,-12
19674,0,0,6,0,-6
19675,1,0,28,0,-28
19676,1,1,858,1962,1104
19677,0,0,26,0,-26
19678,0,0,10,0,-10
19679,0,0,73,0,-73
19680,1,0,22,0,-22
19681,1,0,22,0,-22
19682,1,0,144,0,-144
19683,0,0,12,0,-12
19684,1,0,4,0,-4
19685,1,0,7,0,-7
19686,1,1,793,1437,644
19687,0,0,191,0,-191
19688,1,1,1238,2036,798
19689,0,0,119,0,-119
19690,1,0,40,0,-40
19691,0,0,55,0,-55
19692,1,1,961,2445,1484
19693,1,0,31,0,-31
19694,1,1,421,1390,969
19695,1,0,4,0,-4
19696,0,0,5,0,-5
19697,1,0,98,0,-98
19698,0,0,30,0,-30
19699,1,1,2,1562,1560
19700,0,0,112,0,-112
19701,1,1,1487,1545,58
19702,1,1,384,1256,872
19703,0,0,72,0,-72
19704,0,0,89,0,-89
19705,1,1,175,1223,1048
19706,1,1,144,1210,1066
19707,1,1,112,2265,2153
19708,1,1,426,1282,856
19709,1,0,7,0,-7
19710,0,0,21,0,-21
19711,1,0,121,0,-121
19712,0,0,29,0,-29
19713,0,0,27,0,-27
19714,1,1,651,1644,993
19715,1,0,28,0,-28
19716,0,0,45,0,-45
19717,1,0,6,0,-6
19718,0,0,2,0,-2
19719,1,0,187,0,-187
19720,0,0,75,0,-75
19721,1,1,114,1225,1111
19722,1,0,115,0,-115
19723,0,0,75,0,-75
19724,1,0,38,0,-38
19725,1,0,8,0,-8
19726,0,0,5,0,-5
19727,0,0,108,0,-108
19728,0,0,50,0,-50
19729,0,0,101,0,-101
19730,1,1,1004,1740,736
19731,1,1,1282,1412,130
19732,0,0,32,0,-32
19733,0,0,22,0,-22
19734,1,1,36,1467,1431
19735,1,1,476,2484,2008
19736,1,1,103,1213,1110
19737,0,0,24,0,-24
19738,1,1,55,1246,1191
19739,0,0,51,0,-51
19740,1,0,82,0,-82
19741,1,1,105,1208,1103
19742,1,1,731,1586,855
19743,1,1,152,2181,2029
19744,1,0,10,0,-10
19745,1,0,24,0,-24
19746,0,0,53,0,-53
19747,0,0,131,0,-131
19748,1,1,375,1529,1154
19749,1,1,131,1829,1698
19750,0,0,3,0,-3
19751,0,0,64,0,-64
19752,0,0,107,0,-107
19753,0,0,8,0,-8
19754,1,1,407,1229,822
19755,0,0,2,0,-2
19756,0,0,9,0,-9
19757,1,1,221,1671,1450
19758,1,0,42,0,-42
19759,0,0,59,0,-59
19760,0,0,146,0,-146
19761,0,0,8,0,-8
19762,0,0,9,0,-9
19763,1,1,259,1469,1210
19764,1,1,309,1696,1387
19765,0,0,10,0,-10
19766,0,0,41,0,-41
19767,1,1,239,1321,1082
19768,0,0,28,0,-28
19769,1,0,179,0,-179
19770,1,0,16,0,-16
19771,1,0,17,0,-17
19772,1,0,16,0,-16
19773,1,0,27,0,-27
19774,1,0,37,0,-37
19775,1,1,763,1221,458
19776,0,0,94,0,-94
19777,0,0,7,0,-7
19778,0,0,37,0,-37
19779,1,0,28,0,-28
19780,1,1,236,1426,1190
19781,1,1,534,1710,1176
19782,1,0,47,0,-47
19783,0,0,105,0,-105
19784,0,0,54,0,-54
19785,1,1,418,1385,967
19786,0,0,24,0,-24
19787,1,0,49,0,-49
19788,1,1,307,2072,1765
19789,1,0,130,0,-130
19790,1,0,69,0,-69
19791,1,0,74,0,-74
19792,0,0,15,0,-15
19793,0,0,1,0,-1
19794,0,0,29,0,-29
19795,0,0,16,0,-16
19796,1,0,40,0,-40
19797,0,0,219,0,-219
19798,0,0,2,0,-2
19799,0,0,29,0,-29
19800,1,1,812,1333,521
19801,1,0,16,0,-16
19802,1,0,34,0,-34
19803,1,0,6,0,-6
19804,0,0,23,0,-23
19805,1,1,772,1505,733
19806,1,1,54,1448,1394
19807,1,0,11,0,-11
19808,1,1,708,1298,590
19809,0,0,1,0,-1
19810,0,0,24,0,-24
19811,1,0,85,0,-85
19812,0,0,50,0,-50
19813,1,1,659,1250,591
19814,0,0,35,0,-35
19815,0,0,57,0,-57
19816,1,0,36,0,-36
19817,1,1,199,1763,1564
19818,0,0,14,0,-14
19819,1,1,493,3968,3475
19820,1,0,22,0,-22
19821,1,1,98,1693,1595
19822,0,0,48,0,-48
19823,1,0,1,0,-1
19824,1,0,59,0,-59
19825,0,0,113,0,-113
19826,0,0,8,0,-8
19827,0,0,0,0,0
19828,1,1,140,1347,1207
19829,0,0,28,0,-28
19830,1,1,137,1833,1696
19831,1,0,16,0,-16
19832,0,0,0,0,0
19833,1,0,14,0,-14
19834,1,1,281,1714,1433
19835,0,0,29,0,-29
19836,1,1,636,1265,629
19837,0,0,33,0,-33
19838,1,1,125,1292,1167
19839,1,1,1438,1445,7
19840,0,0,106,0,-106
19841,1,0,18,0,-18
19842,1,0,31,0,-31
19843,1,0,20,0,-20
19844,0,0,91,0,-91
19845,0,0,21,0,-21
19846,0,0,56,0,-56
19847,0,0,22,0,-22
19848,1,0,49,0,-49
19849,0,0,7,0,-7
19850,0,0,38,0,-38
19851,1,1,86,1203,1117
19852,0,0,56,0,-56
19853,0,0,34,0,-34
19854,0,0,25,0,-25
19855,0,0,52,0,-52
19856,1,0,8,0,-8
19857,0,0,45,0,-45
19858,0,0,16,0,-16
19859,0,0,20,0,-20
19860,1,1,1042,1206,164
19861,0,0,11,0,-11
19862,0,0,40,0,-40
19863,1,1,2386,1765,-621
19864,1,0,60,0,-60
19865,1,1,532,1235,703
19866,1,1,973,2066,1093
19867,1,0,16,0,-16
19868,1,0,46,0,-46
19869,1,1,16,1610,1594
19870,0,0,103,0,-103
19871,1,1,160,1438,1278
19872,0,0,38,0,-38
19873,1,1,70,1450,1380
19874,1,1,397,1940,1543
19875,1,1,327,1395,1068
19876,1,0,74,0,-74
19877,0,0,29,0,-29
19878,1,0,4,0,-4
19879,1,1,756,1393,637
19880,0,0,103,0,-103
19881,1,0,92,0,-92
19882,0,0,21,0,-21
19883,0,0,1,0,-1
19884,0,0,22,0,-22
19885,0,0,21,0,-21
19886,0,0,14,0,-14
19887,1,0,59,0,-59
19888,1,0,139,0,-139
19889,1,1,110,1401,1291
19890,1,0,36,0,-36
19891,1,0,3,0,-3
19892,0,0,27,0,-27
19893,1,0,33,0,-33
19894,1,0,142,0,-142
19895,1,0,28,0,-28
19896,1,0,45,0,-45
19897,1,0,27,0,-27
19898,0,0,62,0,-62
19899,0,0,50,0,-50
19900,1,1,242,1469,1227
19901,0,0,6,0,-6
19902,1,1,535,1299,764
19903,0,0,39,0,-39
19904,0,0,38,0,-38
19905,1,1,135,1245,1110
19906,0,0,96,0,-96
19907,0,0,27,0,-27
19908,0,0,41,0,-41
19909,1,1,97,1425,1328
19910,1,0,62,0,-62
19911,1,0,21,0,-21
19912,0,0,96,0,-96
19913,0,0,31,0,-31
19914,1,0,104,0,-104
19915,1,1,237,1241,1004
19916,1,1,142,1220,1078
19917,1,1,265,1348,1083
19918,0,0,5,0,-5
19919,1,1,586,2289,1703
19920,0,0,119,0,-119
19921,1,1,1512,1242,-270
19922,1,0,38,0,-38
19923,0,0,133,0,-133
19924,1,1,90,1872,1782
19925,1,0,17,0,-17
19926,0,0,31,0,-31
19927,1,1,284,1250,966
19928,1,0,47,0,-47
19929,0,0,2,0,-2
19930,0,0,10,0,-10
19931,0,0,13,0,-13
19932,1,1,104,1237,1133
19933,0,0,17,0,-17
19934,1,0,25,0,-25
19935,0,0,31,0,-31
19936,0,0,63,0,-63
19937,0,0,98,0,-98
19938,0,0,40,0,-40
19939,0,0,21,0,-21
19940,1,1,176,1369,1193
19941,1,1,172,1316,1144
19942,1,1,1860,1590,-270
19943,0,0,151,0,-151
19944,1,1,738,1849,1111
19945,1,1,263,1894,1631
19946,0,0,42,0,-42
19947,0,0,118,0,-118
19948,0,0,32,0,-32
19949,1,0,19,0,-19
19950,0,0,14,0,-14
19951,1,1,101,1263,1162
19952,0,0,43,0,-43
19953,1,1,965,1812,847
19954,1,0,2,0,-2
19955,1,0,89,0,-89
19956,0,0,45,0,-45
19957,0,0,15,0,-15
19958,1,1,220,1822,1602
19959,1,1,189,1695,1506
19960,1,1,1193,1267,74
19961,1,1,150,1430,1280
19962,1,0,51,0,-51
19963,1,0,56,0,-56
19964,1,1,417,1225,808
19965,0,0,212,0,-212
19966,0,0,52,0,-52
19967,1,0,14,0,-14
19968,1,1,232,1892,1660
19969,0,0,1,0,-1
19970,0,0,28,0,-28
19971,1,0,69,0,-69
19972,0,0,104,0,-104
19973,1,1,1655,1447,-208
19974,1,1,295,2388,2093
19975,1,1,257,3127,2870
19976,1,0,21,0,-21
19977,1,0,31,0,-31
19978,0,0,76,0,-76
19979,1,0,8,0,-8
19980,1,0,92,0,-92
19981,1,1,146,1269,1123
19982,1,1,197,1980,1783
19983,1,0,19,0,-19
19984,1,0,0,0,0
19985,0,0,72,0,-72
19986,1,0,18,0,-18
19987,0,0,36,0,-36
19988,1,0,24,0,-24
19989,1,0,63,0,-63
19990,1,0,12,0,-12
19991,0,0,17,0,-17
19992,1,0,65,0,-65
19993,1,1,185,2749,2564
19994,1,1,1489,1425,-64
19995,0,0,139,0,-139
19996,1,0,6,0,-6
19997,1,0,23,0,-23
19998,0,0,7,0,-7
19999,1,1,329,1267,938
20000,1,0,31,0,-31
20001,1,1,1162,1405,243
20002,1,0,239,0,-239
20003,0,0,44,0,-44
20004,1,1,359,1755,1396
20005,0,0,80,0,-80
20006,1,0,65,0,-65
20007,1,0,30,0,-30
20008,0,0,50,0,-50
20009,1,1,111,1231,1120
20010,0,0,73,0,-73
20011,1,0,12,0,-12
20012,0,0,49,0,-49
20013,1,0,45,0,-45
20014,0,0,44,0,-44
20015,0,0,18,0,-18
20016,1,0,22,0,-22
20017,0,0,12,0,-12
20018,0,0,15,0,-15
20019,0,0,3,0,-3
20020,1,1,75,1686,1611
20021,0,0,21,0,-21
20022,1,1,293,1200,907
20023,1,0,246,0,-246
20024,1,1,185,3459,3274
20025,1,1,606,2766,2160
20026,1,0,81,0,-81
20027,0,0,16,0,-16
20028,0,0,7,0,-7
20029,0,0,83,0,-83
20030,0,0,69,0,-69
20031,1,0,329,0,-329
20032,0,0,79,0,-79
20033,0,0,39,0,-39
20034,1,0,83,0,-83
20035,1,1,215,1730,1515
20036,0,0,1,0,-1
20037,1,1,216,1241,1025
20038,1,0,25,0,-25
20039,1,0,5,0,-5
20040,0,0,22,0,-22
20041,0,0,41,0,-41
20042,1,0,158,0,-158
20043,1,1,775,1260,485
20044,1,1,814,1760,946
20045,1,0,73,0,-73
20046,0,0,62,0,-62
20047,1,0,24,0,-24
20048,1,1,689,2085,1396
20049,0,0,116,0,-116
20050,0,0,3,0,-3
20051,1,1,33,1445,1412
20052,0,0,32,0,-32
20053,0,0,39,0,-39
20054,0,0,51,0,-51
20055,1,0,72,0,-72
20056,0,0,1,0,-1
20057,0,0,51,0,-51
20058,0,0,89,0,-89
20059,1,1,660,1490,830
20060,1,0,14,0,-14
20061,0,0,5,0,-5
20062,0,0,20,0,-20
20063,0,0,11,0,-11
20064,1,1,181,1642,1461
20065,1,1,211,1753,1542
20066,0,0,37,0,-37
20067,1,0,48,0,-48
20068,0,0,5,0,-5
20069,0,0,2,0,-2
20070,1,0,15,0,-15
20071,0,0,2,0,-2
20072,1,0,2,0,-2
20073,0,0,30,0,-30
20074,0,0,40,0,-40
20075,1,0,13,0,-13
20076,0,0,30,0,-30
20077,0,0,11,0,-11
20078,0,0,32,0,-32
20079,1,0,78,0,-78
20080,1,0,4,0,-4
20081,0,0,31,0,-31
20082,1,1,450,1389,939
20083,0,0,77,0,-77
20084,1,1,327,2030,1703
20085,1,0,53,0,-53
20086,1,1,266,3001,2735
20087,1,1,320,1670,1350
20088,1,1,310,1336,1026
20089,0,0,11,0,-11
20090,1,0,66,0,-66
20091,1,0,31,0,-31
20092,0,0,111,0,-111
20093,1,0,216,0,-216
20094,1,1,66,2704,2638
20095,1,1,710,1438,728
20096,0,0,44,0,-44
20097,1,0,33,0,-33
20098,1,0,87,0,-87
20099,0,0,22,0,-22
20100,1,1,343,1945,1602
20101,1,0,14,0,-14
20102,0,0,57,0,-57
20103,1,0,99,0,-99
20104,0,0,7,0,-7
20105,0,0,39,0,-39
20106,1,0,4,0,-4
20107,0,0,4,0,-4
20108,0,0,99,0,-99
20109,0,0,224,0,-224
20110,1,1,483,1622,1139
20111,0,0,10,0,-10
20112,1,0,19,0,-19
20113,0,0,13,0,-13
20114,1,0,55,0,-55
20115,0,0,223,0,-223
20116,1,1,455,1787,1332
20117,0,0,109,0,-109
20118,0,0,53,0,-53
20119,1,1,156,1334,1178
20120,1,0,22,0,-22
20121,1,1,361,1703,1342
20122,0,0,99,0,-99
20123,1,0,3,0,-3
20124,1,1,142,1206,1064
20125,1,1,751,2275,1524
20126,1,0,25,0,-25
20127,0,0,4,0,-4
20128,1,1,222,1366,1144
20129,0,0,62,0,-62
20130,0,0,11,0,-11
20131,1,0,76,0,-76
20132,0,0,132,0,-132
20133,1,1,168,1742,1574
20134,1,0,10,0,-10
20135,1,0,80,0,-80
20136,1,0,12,0,-12
20137,0,0,23,0,-23
20138,0,0,65,0,-65
20139,1,1,571,1215,644
20140,1,0,59,0,-59
20141,0,0,124,0,-124
20142,0,0,19,0,-19
20143,1,1,202,1230,1028
20144,1,0,1,0,-1
20145,1,0,35,0,-35
20146,1,0,4,0,-4
20147,1,1,1975,1555,-420
20148,1,1,337,1551,1214
20149,1,0,48,0,-48
20150,1,0,48,0,-48
20151,0,0,16,0,-16
20152,1,0,19,0,-19
20153,0,0,45,0,-45
20154,1,0,53,0,-53
20155,0,0,2,0,-2
20156,1,1,431,1662,1231
20157,1,0,30,0,-30
20158,0,0,102,0,-102
20159,0,0,28,0,-28
20160,1,0,9,0,-9
20161,1,1,403,1854,1451
20162,1,1,1029,1345,316
20163,1,0,141,0,-141
20164,1,1,791,1446,655
20165,1,1,912,1284,372
20166,1,0,54,0,-54
20167,1,0,6,0,-6
20168,1,1,1718,2999,1281
20169,1,1,110,1625,1515
20170,1,0,112,0,-112
20171,1,1,80,2628,2548
20172,0,0,6,0,-6
20173,1,0,6,0,-6
20174,1,0,19,0,-19
20175,1,1,812,1611,799
20176,1,1,73,1667,1594
20177,1,1,842,1284,442
20178,1,1,190,1250,1060
20179,0,0,0,0,0
20180,0,0,21,0,-21
20181,0,0,55,0,-55
20182,0,0,184,0,-184
20183,1,1,392,1580,1188
20184,0,0,46,0,-46
20185,1,0,5,0,-5
20186,0,0,47,0,-47
20187,0,0,39,0,-39
20188,0,0,29,0,-29
20189,1,1,1747,1256,-491
20190,1,0,10,0,-10
20191,1,0,11,0,-11
20192,1,0,66,0,-66
20193,0,0,6,0,-6
20194,1,0,265,0,-265
20195,1,1,276,1490,1214
20196,1,0,32,0,-32
20197,0,0,23,0,-23
20198,1,0,5,0,-5
20199,0,0,24,0,-24
20200,0,0,16,0,-16
20201,1,0,140,0,-140
20202,0,0,11,0,-11
20203,1,0,86,0,-86
20204,1,0,41,0,-41
20205,0,0,55,0,-55
20206,1,1,822,1494,672
20207,0,0,99,0,-99
20208,1,0,59,0,-59
20209,0,0,4,0,-4
20210,1,1,745,1222,477
20211,1,0,35,0,-35
20212,0,0,168,0,-168
20213,1,0,388,0,-388
20214,1,1,233,1227,994
20215,0,0,21,0,-21
20216,0,0,293,0,-293
20217,1,1,421,1314,893
20218,0,0,25,0,-25
20219,1,0,279,0,-279
20220,1,0,16,0,-16
20221,1,0,76,0,-76
20222,1,1,354,1314,960
20223,0,0,13,0,-13
20224,1,1,363,1806,1443
20225,0,0,16,0,-16
20226,1,0,99,0,-99
20227,1,0,220,0,-220
20228,1,1,160,1222,1062
20229,1,0,19,0,-19
20230,1,1,276,1305,1029
20231,0,0,27,0,-27
20232,1,1,598,1374,776
20233,0,0,44,0,-44
20234,1,0,56,0,-56
20235,1,1,124,1370,1246
20236,1,0,88,0,-88
20237,1,0,82,0,-82
20238,1,0,113,0,-113
20239,1,0,19,0,-19
20240,0,0,45,0,-45
20241,0,0,132,0,-132
20242,0,0,64,0,-64
20243,1,1,351,1257,906
20244,1,0,74,0,-74
20245,0,0,52,0,-52
20246,1,1,563,1722,1159
20247,1,0,19,0,-19
20248,1,0,20,0,-20
20249,1,1,687,1474,787
20250,0,0,57,0,-57
20251,1,0,1,0,-1
20252,1,0,82,0,-82
20253,1,0,18,0,-18
20254,1,0,10,0,-10
20255,0,0,56,0,-56
20256,1,1,151,1610,1459
20257,1,0,2,0,-2
20258,1,1,179,1464,1285
20259,1,1,591,2056,1465
20260,1,0,9,0,-9
20261,0,0,1,0,-1
20262,0,0,71,0,-71
20263,1,0,148,0,-148
20264,1,0,96,0,-96
20265,1,0,32,0,-32
20266,0,0,108,0,-108
20267,0,0,65,0,-65
20268,1,0,186,0,-186
20269,0,0,2,0,-2
20270,1,0,14,0,-14
20271,0,0,45,0,-45
20272,0,0,8,0,-8
20273,0,0,104,0,-104
20274,1,1,385,1237,852
20275,1,1,1555,1355,-200
20276,0,0,97,0,-97
20277,1,1,99,1454,1355
20278,0,0,105,0,-105
20279,1,0,20,0,-20
20280,1,1,940,1277,337
20281,1,1,820,1502,682
20282,1,1,231,1368,1137
20283,1,1,395,1519,1124
20284,0,0,14,0,-14
20285,1,0,0,0,0
20286,1,1,464,1200,736
20287,0,0,14,0,-14
20288,0,0,29,0,-29
20289,0,0,70,0,-70
20290,0,0,11,0,-11
20291,1,1,735,1301,566
20292,0,0,4,0,-4
20293,1,1,212,1749,1537
20294,1,0,65,0,-65
20295,0,0,126,0,-126
20296,1,0,88,0,-88
20297,1,1,677,1249,572
20298,1,0,57,0,-57
20299,0,0,5,0,-5
20300,0,0,3,0,-3
20301,1,1,132,1480,1348
20302,1,1,374,1337,963
20303,0,0,13,0,-13
20304,1,1,556,1399,843
20305,0,0,165,0,-165
20306,0,0,33,0,-33
20307,0,0,13,0,-13
20308,0,0,81,0,-81
20309,1,1,271,1261,990
20310,0,0,13,0,-13
20311,1,1,1035,1287,252
20312,0,0,24,0,-24
20313,1,0,140,0,-140
20314,1,0,43,0,-43
20315,0,0,11,0,-11
20316,0,0,22,0,-22
20317,1,0,80,0,-80
20318,1,0,70,0,-70
20319,1,1,280,1592,1312
20320,1,0,45,0,-45
20321,0,0,103,0,-103
20322,1,0,114,0,-114
20323,0,0,26,0,-26
20324,0,0,31,0,-31
20325,0,0,21,0,-21
20326,0,0,35,0,-35
20327,1,0,14,0,-14
20328,1,1,488,1460,972
20329,0,0,60,0,-60
20330,1,0,74,0,-74
20331,0,0,92,0,-92
20332,1,0,16,0,-16
20333,1,0,40,0,-40
20334,0,0,36,0,-36
20335,1,0,0,0,0
20336,1,1,516,1585,1069
20337,1,1,1775,1599,-176
20338,1,1,315,1636,1321
20339,0,0,41,0,-41
20340,0,0,13,0,-13
20341,0,0,18,0,-18
20342,1,0,58,0,-58
20343,0,0,30,0,-30
20344,1,1,744,1302,558
20345,1,1,40,1919,1879
20346,1,1,783,1207,424
20347,1,1,837,1674,837
20348,1,0,87,0,-87
20349,1,0,3,0,-3
20350,1,1,496,1328,832
20351,0,0,55,0,-55
20352,1,0,0,0,0
20353,1,0,32,0,-32
20354,0,0,3,0,-3
20355,0,0,3,0,-3
20356,1,1,382,1288,906
20357,0,0,21,0,-21
20358,1,1,130,1351,1221
20359,0,0,110,0,-110
20360,0,0,111,0,-111
20361,0,0,15,0,-15
20362,0,0,27,0,-27
20363,1,0,46,0,-46
20364,1,0,1,0,-1
20365,1,1,166,1309,1143
20366,1,1,1181,1309,128
20367,1,0,33,0,-33
20368,0,0,19,0,-19
20369,1,0,16,0,-16
20370,0,0,30,0,-30
20371,1,1,1386,1221,-165
20372,1,1,526,1490,964
20373,0,0,57,0,-57
20374,1,1,497,1306,809
20375,1,0,1,0,-1
20376,1,1,229,2262,2033
20377,1,1,152,1274,1122
20378,0,0,18,0,-18
20379,1,1,160,1500,1340
20380,1,1,111,1342,1231
20381,1,1,627,1892,1265
20382,1,0,34,0,-34
20383,1,1,766,1969,1203
20384,0,0,4,0,-4
20385,0,0,46,0,-46
20386,0,0,8,0,-8
20387,0,0,79,0,-79
20388,0,0,15,0,-15
20389,1,1,567,2053,1486
20390,0,0,25,0,-25
20391,1,0,14,0,-14
20392,0,0,43,0,-43
20393,0,0,67,0,-67
20394,1,1,439,1523,1084
20395,1,1,660,1383,723
20396,0,0,44,0,-44
20397,0,0,59,0,-59
20398,0,0,44,0,-44
20399,0,0,10,0,-10
20400,1,1,1080,1217,137
20401,1,1,347,1338,991
20402,1,1,170,1366,1196
20403,1,1,180,1239,1059
20404,1,0,35,0,-35
20405,1,1,436,1282,846
20406,1,0,44,0,-44
20407,1,1,176,2024,1848
20408,0,0,19,0,-19
20409,0,0,3,0,-3
20410,1,0,10,0,-10
20411,0,0,50,0,-50
20412,0,0,23,0,-23
20413,0,0,112,0,-112
20414,0,0,183,0,-183
20415,1,0,33,0,-33
20416,1,0,147,0,-147
20417,0,0,8,0,-8
20418,1,0,14,0,-14
20419,0,0,129,0,-129
20420,0,0,47,0,-47
20421,1,0,62,0,-62
20422,1,1,474,1380,906
20423,1,1,226,1581,1355
20424,0,0,139,0,-139
20425,1,0,103,0,-103
20426,1,1,469,1741,1272
20427,0,0,38,0,-38
20428,1,0,85,0,-85
20429,1,1,944,1358,414
20430,0,0,16,0,-16
20431,0,0,7,0,-7
20432,0,0,33,0,-33
20433,0,0,79,0,-79
20434,1,0,50,0,-50
20435,0,0,21,0,-21
20436,0,0,38,0,-38
20437,0,0,5,0,-5
20438,1,0,31,0,-31
20439,1,0,18,0,-18
20440,0,0,232,0,-232
20441,1,1,336,1238,902
20442,1,1,2268,2000,-268
20443,0,0,24,0,-24
20444,0,0,8,0,-8
20445,1,0,9,0,-9
20446,1,1,130,2820,2690
20447,0,0,11,0,-11
20448,1,0,41,0,-41
20449,0,0,0,0,0
20450,0,0,78,0,-78
20451,1,1,136,1237,1101
20452,1,0,62,0,-62
20453,0,0,5,0,-5
20454,1,1,133,1665,1532
20455,1,1,249,1230,981
20456,1,1,916,1696,780
20457,0,0,5,0,-5
20458,1,1,859,1500,641
20459,1,0,2,0,-2
20460,0,0,32,0,-32
20461,1,0,50,0,-50
20462,0,0,5,0,-5
20463,1,0,8,0,-8
20464,1,0,34,0,-34
20465,0,0,0,0,0
20466,1,1,197,1370,1173
20467,1,1,640,1253,613
20468,1,0,28,0,-28
20469,0,0,29,0,-29
20470,0,0,3,0,-3
20471,0,0,37,0,-37
20472,1,1,204,1229,1025
20473,0,0,67,0,-67
20474,1,0,1,0,-1
20475,1,1,319,1289,970
20476,1,1,46,1389,1343
20477,1,0,25,0,-25
20478,1,1,254,1364,1110
20479,0,0,71,0,-71
20480,1,0,20,0,-20
20481,1,0,50,0,-50
20482,0,0,9,0,-9
20483,1,0,30,0,-30
20484,0,0,24,0,-24
20485,0,0,21,0,-21
20486,1,0,25,0,-25
20487,1,1,613,1462,849
20488,1,0,4,0,-4
20489,1,0,16,0,-16
20490,0,0,62,0,-62
20491,1,1,842,1484,642
20492,0,0,5,0,-5
20493,1,0,91,0,-91
20494,1,0,14,0,-14
20495,1,0,59,0,-59
20496,0,0,41,0,-41
20497,0,0,111,0,-111
20498,0,0,5,0,-5
20499,0,0,67,0,-67
20500,1,0,41,0,-41
20501,1,0,34,0,-34
20502,1,1,453,1296,843
20503,1,1,218,2178,1960
20504,1,0,31,0,-31
20505,0,0,101,0,-101
20506,1,0,162,0,-162
20507,1,0,129,0,-129
20508,0,0,95,0,-95
20509,1,1,1036,1297,261
20510,0,0,5,0,-5
20511,0,0,84,0,-84
20512,0,0,26,0,-26
20513,0,0,77,0,-77
20514,1,0,18,0,-18
20515,0,0,0,0,0
20516,1,0,18,0,-18
20517,1,1,24,1487,1463
20518,1,1,176,1888,1712
20519,1,0,9,0,-9
20520,1,0,61,0,-61
20521,1,0,13,0,-13
20522,1,1,21,1306,1285
20523,1,1,181,1215,1034
20524,1,1,305,1502,1197
20525,1,0,9,0,-9
20526,0,0,3,0,-3
20527,0,0,4,0,-4
20528,0,0,24,0,-24
20529,1,0,26,0,-26
20530,0,0,90,0,-90
20531,1,1,561,1777,1216
20532,0,0,11,0,-11
20533,0,0,166,0,-166
20534,0,0,1,0,-1
20535,0,0,52,0,-52
20536,1,0,13,0,-13
20537,1,1,264,1310,1046
20538,1,0,18,0,-18
20539,1,0,20,0,-20
20540,0,0,72,0,-72
20541,1,1,354,2282,1928
20542,0,0,3,0,-3
20543,1,1,321,1217,896
20544,1,1,71,1281,1210
20545,1,1,385,1675,1290
20546,1,0,135,0,-135
20547,1,0,44,0,-44
20548,0,0,99,0,-99
20549,0,0,5,0,-5
20550,1,0,47,0,-47
20551,1,1,494,1347,853
20552,0,0,23,0,-23
20553,0,0,32,0,-32
20554,0,0,17,0,-17
20555,0,0,8,0,-8
20556,1,1,344,1953,1609
20557,0,0,28,0,-28
20558,0,0,1,0,-1
20559,1,0,24,0,-24
20560,0,0,90,0,-90
20561,0,0,76,0,-76
20562,1,1,15,1233,1218
20563,1,1,225,1259,1034
20564,1,0,141,0,-141
20565,1,1,499,1713,1214
20566,0,0,222,0,-222
20567,0,0,15,0,-15
20568,1,1,97,1248,1151
20569,1,0,67,0,-67
20570,1,1,168,1439,1271
20571,1,0,22,0,-22
20572,1,0,165,0,-165
20573,1,1,850,1333,483
20574,1,1,815,1861,1046
20575,1,0,6,0,-6
20576,1,1,207,1958,1751
20577,0,0,84,0,-84
20578,0,0,44,0,-44
20579,1,0,147,0,-147
20580,0,0,16,0,-16
20581,1,0,149,0,-149
20582,0,0,52,0,-52
20583,1,0,26,0,-26
20584,1,0,203,0,-203
20585,0,0,92,0,-92
20586,0,0,30,0,-30
20587,1,0,49,0,-49
20588,1,1,132,1524,1392
20589,0,0,19,0,-19
20590,1,1,432,2497,2065
20591,0,0,181,0,-181
20592,1,1,1490,1389,-101
20593,1,0,38,0,-38
20594,1,1,197,1308,1111
20595,1,1,58,1322,1264
20596,1,1,1208,1297,89
20597,1,0,238,0,-238
20598,1,0,32,0,-32
20599,0,0,113,0,-113
20600,0,0,58,0,-58
20601,1,1,113,1335,1222
20602,0,0,31,0,-31
20603,1,0,74,0,-74
20604,1,0,96,0,-96
20605,1,0,56,0,-56
20606,1,1,394,1235,841
20607,1,1,1062,1982,920
20608,1,0,63,0,-63
20609,1,1,533,1382,849
20610,1,1,238,1814,1576
20611,1,1,430,1211,781
20612,0,0,63,0,-63
20613,0,0,20,0,-20
20614,1,0,84,0,-84
20615,0,0,35,0,-35
20616,0,0,74,0,-74
20617,0,0,2,0,-2
20618,1,0,0,0,0
20619,1,0,119,0,-119
20620,1,0,31,0,-31
20621,1,1,138,1571,1433
20622,1,0,55,0,-55
20623,1,0,2,0,-2
20624,1,0,159,0,-159
20625,0,0,9,0,-9
20626,1,0,31,0,-31
20627,1,0,101,0,-101
20628,1,1,947,1311,364
20629,0,0,153,0,-153
20630,1,0,38,0,-38
20631,0,0,36,0,-36
20632,0,0,108,0,-108
20633,1,0,14,0,-14
20634,1,0,0,0,0
20635,1,0,141,0,-141
20636,1,0,10,0,-10
20637,1,0,33,0,-33
20638,1,1,498,1220,722
20639,1,1,2247,1226,-1021
20640,0,0,102,0,-102
20641,0,0,41,0,-41
20642,0,0,8,0,-8
20643,1,1,179,1274,1095
20644,1,0,22,0,-22
20645,0,0,11,0,-11
20646,1,1,121,1355,1234
20647,0,0,7,0,-7
20648,0,0,16,0,-16
20649,0,0,3,0,-3
20650,1,1,1240,1496,256
20651,1,0,30,0,-30
20652,0,0,24,0,-24
20653,1,0,19,0,-19
20654,0,0,39,0,-39
20655,0,0,298,0,-298
20656,1,1,334,1307,973
20657,1,1,465,1221,756
20658,1,0,65,0,-65
20659,1,1,1483,1383,-100
20660,0,0,32,0,-32
20661,1,1,281,1213,932
20662,1,0,52,0,-52
20663,0,0,157,0,-157
20664,1,1,492,1293,801
20665,1,0,65,0,-65
20666,0,0,83,0,-83
20667,1,0,0,0,0
20668,1,1,1243,1230,-13
20669,0,0,46,0,-46
20670,0,0,22,0,-22
20671,0,0,3,0,-3
20672,0,0,16,0,-16
20673,0,0,107,0,-107
20674,1,1,150,1230,1080
20675,1,1,397,1276,879
20676,0,0,10,0,-10
20677,1,1,655,1536,881
20678,1,1,2305,1575,-730
20679,1,0,118,0,-118
20680,0,0,61,0,-61
20681,0,0,92,0,-92
20682,1,0,13,0,-13
20683,1,1,381,1283,902
20684,1,0,70,0,-70
20685,1,1,374,1357,983
20686,1,0,28,0,-28
20687,1,0,5,0,-5
20688,1,1,139,1374,1235
20689,1,0,2,0,-2
20690,0,0,69,0,-69
20691,0,0,61,0,-61
20692,0,0,108,0,-108
20693,0,0,160,0,-160
20694,1,0,19,0,-19
20695,0,0,6,0,-6
20696,0,0,14,0,-14
20697,1,1,259,1462,1203
20698,0,0,0,0,0
20699,1,1,2362,1306,-1056
20700,1,1,960,1304,344
20701,0,0,27,0,-27
20702,0,0,9,0,-9
20703,0,0,95,0,-95
20704,1,1,588,1253,665
20705,0,0,9,0,-9
20706,1,0,90,0,-90
20707,1,0,116,0,-116
20708,1,0,33,0,-33
20709,1,1,531,2095,1564
20710,0,0,47,0,-47
20711,1,1,34,1627,1593
20712,1,1,690,1448,758
20713,1,0,24,0,-24
20714,1,1,179,1245,1066
20715,1,0,35,0,-35
20716,1,1,692,1404,712
20717,0,0,11,0,-11
20718,1,0,151,0,-151
20719,0,0,40,0,-40
20720,0,0,54,0,-54
20721,0,0,134,0,-134
20722,1,1,1146,1330,184
20723,1,1,154,1203,1049
20724,0,0,1,0,-1
20725,0,0,4,0,-4
20726,1,1,309,1271,962
20727,0,0,10,0,-10
20728,1,0,19,0,-19
20729,1,1,33,1281,1248
20730,1,1,77,1651,1574
20731,0,0,2,0,-2
20732,0,0,86,0,-86
20733,1,1,308,1291,983
20734,1,0,61,0,-61
20735,0,0,8,0,-8
20736,1,1,754,1275,521
20737,1,1,241,1486,1245
20738,1,0,33,0,-33
20739,1,1,84,1435,1351
20740,0,0,26,0,-26
20741,1,0,40,0,-40
20742,0,0,58,0,-58
20743,1,0,98,0,-98
20744,1,0,85,0,-85
20745,1,0,145,0,-145
20746,1,1,39,1225,1186
20747,1,0,65,0,-65
20748,1,1,302,2452,2150
20749,0,0,119,0,-119
20750,1,1,102,1305,1203
20751,0,0,2,0,-2
20752,1,0,19,0,-19
20753,1,0,24,0,-24
20754,1,0,489,0,-489
20755,0,0,102,0,-102
20756,1,1,377,3419,3042
20757,0,0,70,0,-70
20758,1,0,33,0,-33
20759,1,0,6,0,-6
20760,0,0,2,0,-2
20761,1,1,910,1486,576
20762,0,0,114,0,-114
20763,1,1,307,1380,1073
20764,0,0,31,0,-31
20765,0,0,78,0,-78
20766,1,0,30,0,-30
20767,1,1,1063,2123,1060
20768,1,1,1287,1265,-22
20769,1,1,192,1360,1168
20770,1,1,220,1334,1114
20771,1,1,53,2386,2333
20772,1,0,15,0,-15
20773,1,1,194,1315,1121
20774,0,0,29,0,-29
20775,1,1,116,1202,1086
20776,0,0,5,0,-5
20777,1,1,460,1357,897
20778,1,0,46,0,-46
20779,1,1,534,2342,1808
20780,1,0,4,0,-4
20781,1,1,118,1362,1244
20782,0,0,41,0,-41
20783,0,0,27,0,-27
20784,1,0,45,0,-45
20785,1,0,17,0,-17
20786,0,0,93,0,-93
20787,1,1,335,1219,884
20788,1,1,648,1504,856
20789,1,0,105,0,-105
20790,1,1,417,2026,1609
20791,1,1,257,1320,1063
20792,0,0,8,0,-8
20793,1,0,137,0,-137
20794,0,0,70,0,-70
20795,1,1,147,1229,1082
20796,0,0,13,0,-13
20797,1,1,188,1285,1097
20798,1,0,182,0,-182
20799,1,0,40,0,-40
20800,1,1,270,1504,1234
20801,1,0,14,0,-14
20802,1,1,180,1483,1303
20803,1,1,214,1519,1305
20804,1,0,0,0,0
20805,1,1,1018,1202,184
20806,1,1,75,1414,1339
20807,0,0,13,0,-13
20808,1,0,19,0,-19
20809,0,0,93,0,-93
20810,1,0,3,0,-3
20811,1,0,29,0,-29
20812,0,0,38,0,-38
20813,0,0,0,0,0
20814,0,0,38,0,-38
20815,1,0,8,0,-8
20816,0,0,8,0,-8
20817,1,0,41,0,-41
20818,0,0,83,0,-83
20819,1,1,700,1239,539
20820,1,1,808,1320,512
20821,1,1,1645,1215,-430
20822,1,0,99,0,-99
20823,0,0,81,0,-81
20824,1,1,714,1249,535
20825,1,0,35,0,-35
20826,0,0,47,0,-47
20827,0,0,30,0,-30
20828,0,0,64,0,-64
20829,0,0,70,0,-70
20830,0,0,92,0,-92
20831,0,0,194,0,-194
20832,1,0,12,0,-12
20833,1,0,37,0,-37
20834,0,0,94,0,-94
20835,0,0,18,0,-18
20836,1,1,97,1277,1180
20837,1,0,24,0,-24
20838,1,0,76,0,-76
20839,0,0,101,0,-101
20840,0,0,22,0,-22
20841,0,0,68,0,-68
20842,1,1,230,1206,976
20843,0,0,14,0,-14
20844,1,1,811,1366,555
20845,1,1,1235,1428,193
20846,1,0,73,0,-73
20847,1,0,75,0,-75
20848,0,0,1,0,-1
20849,1,0,34,0,-34
20850,1,0,2,0,-2
20851,1,0,50,0,-50
20852,1,1,84,1227,1143
20853,1,1,32,1396,1364
20854,1,1,353,1559,1206
20855,1,1,1088,1225,137
20856,0,0,25,0,-25
20857,1,0,53,0,-53
20858,1,0,4,0,-4
20859,0,0,43,0,-43
20860,1,1,528,1203,675
20861,1,1,172,2418,2246
20862,0,0,69,0,-69
20863,1,1,1617,1268,-349
20864,1,0,102,0,-102
20865,1,0,18,0,-18
20866,1,0,13,0,-13
20867,0,0,17,0,-17
20868,1,0,28,0,-28
20869,1,0,84,0,-84
20870,1,0,48,0,-48
20871,1,1,323,1324,1001
20872,1,0,45,0,-45
20873,0,0,18,0,-18
20874,1,1,440,1554,1114
20875,0,0,44,0,-44
20876,1,0,130,0,-130
20877,0,0,15,0,-15
20878,1,0,0,0,0
20879,1,0,27,0,-27
20880,0,0,10,0,-10
20881,1,0,99,0,-99
20882,0,0,51,0,-51
20883,0,0,159,0,-159
20884,0,0,16,0,-16
20885,1,0,12,0,-12
20886,1,0,24,0,-24
20887,1,0,34,0,-34
20888,0,0,38,0,-38
20889,0,0,34,0,-34
20890,1,0,106,0,-106
20891,0,0,45,0,-45
20892,1,1,376,1291,915
20893,0,0,52,0,-52
20894,0,0,20,0,-20
20895,1,1,456,1248,792
20896,1,0,98,0,-98
20897,1,1,371,1261,890
20898,0,0,61,0,-61
20899,0,0,53,0,-53
20900,1,0,110,0,-110
20901,0,0,23,0,-23
20902,0,0,1,0,-1
20903,0,0,12,0,-12
20904,0,0,29,0,-29
20905,1,0,77,0,-77
20906,1,0,35,0,-35
20907,0,0,3,0,-3
20908,0,0,53,0,-53
20909,1,1,6,1233,1227
20910,0,0,93,0,-93
20911,1,1,637,1370,733
20912,1,1,292,1230,938
20913,1,0,84,0,-84
20914,0,0,45,0,-45
20915,1,0,11,0,-11
20916,1,0,3,0,-3
20917,0,0,11,0,-11
20918,1,0,10,0,-10
20919,0,0,10,0,-10
20920,0,0,28,0,-28
20921,0,0,117,0,-117
20922,1,1,446,1468,1022
20923,1,0,11,0,-11
20924,0,0,131,0,-131
20925,1,1,437,1275,838
20926,0,0,2,0,-2
20927,0,0,96,0,-96
20928,1,1,417,1578,1161
20929,0,0,38,0,-38
20930,1,0,33,0,-33
20931,1,0,87,0,-87
20932,0,0,69,0,-69
20933,1,1,596,1619,1023
20934,0,0,4,0,-4
20935,1,0,9,0,-9
20936,1,0,3,0,-3
20937,1,1,270,1424,1154
20938,1,0,10,0,-10
20939,1,1,1396,1324,-72
20940,1,1,589,3092,2503
20941,0,0,18,0,-18
20942,0,0,31,0,-31
20943,0,0,99,0,-99
20944,1,1,323,1639,1316
20945,1,0,36,0,-36
20946,1,1,137,1376,1239
20947,0,0,113,0,-113
20948,0,0,26,0,-26
20949,1,0,13,0,-13
20950,1,1,302,1255,953
20951,0,0,61,0,-61
20952,0,0,12,0,-12
20953,1,1,527,1791,1264
20954,0,0,13,0,-13
20955,0,0,13,0,-13
20956,0,0,4,0,-4
20957,1,0,7,0,-7
20958,0,0,7,0,-7
20959,1,1,453,1227,774
20960,1,0,39,0,-39
20961,1,0,18,0,-18
20962,0,0,162,0,-162
20963,1,1,928,1466,538
20964,1,1,650,1685,1035
20965,0,0,1,0,-1
20966,0,0,0,0,0
20967,1,0,36,0,-36
20968,1,1,240,1575,1335
20969,0,0,10,0,-10
20970,0,0,1,0,-1
20971,1,1,351,1569,1218
20972,0,0,2,0,-2
20973,0,0,24,0,-24
20974,1,1,1487,1261,-226
20975,1,0,86,0,-86
20976,0,0,168,0,-168
20977,1,0,32,0,-32
20978,0,0,15,0,-15
20979,0,0,108,0,-108
20980,1,1,234,1219,985
20981,1,0,37,0,-37
20982,1,1,218,1244,1026
20983,0,0,81,0,-81
20984,0,0,38,0,-38
20985,1,0,79,0,-79
20986,0,0,18,0,-18
20987,0,0,56,0,-56
20988,1,0,45,0,-45
20989,1,1,1284,1232,-52
20990,0,0,19,0,-19
20991,1,1,145,1346,1201
20992,1,1,235,2005,1770
20993,1,1,100,1267,1167
20994,0,0,105,0,-105
20995,1,1,53,1302,1249
20996,0,0,28,0,-28
20997,1,0,44,0,-44
20998,1,0,16,0,-16
20999,1,0,26,0,-26
21000,0,0,194,0,-194
21001,1,1,1365,1601,236
21002,0,0,14,0,-14
21003,1,0,138,0,-138
21004,1,0,112,0,-112
21005,1,1,69,1280,1211
21006,0,0,51,0,-51
21007,1,0,14,0,-14
21008,1,1,571,1937,1366
21009,1,0,12,0,-12
21010,0,0,17,0,-17
21011,0,0,54,0,-54
21012,1,1,141,1965,1824
21013,1,1,289,2019,1730
21014,0,0,21,0,-21
21015,1,1,440,1375,935
21016,1,1,129,2562,2433
21017,1,0,2,0,-2
21018,1,0,68,0,-68
21019,0,0,17,0,-17
21020,0,0,209,0,-209
21021,0,0,4,0,-4
21022,1,0,46,0,-46
21023,1,1,532,1525,993
21024,1,1,290,1224,934
21025,0,0,16,0,-16
21026,1,0,39,0,-39
21027,0,0,65,0,-65
21028,1,0,28,0,-28
21029,1,1,234,1369,1135
21030,1,0,18,0,-18
21031,0,0,19,0,-19
21032,1,1,1347,1345,-2
21033,1,0,101,0,-101
21034,1,1,214,1394,1180
21035,0,0,5,0,-5
21036,1,1,471,1242,771
21037,1,0,145,0,-145
21038,1,0,29,0,-29
21039,1,0,97,0,-97
21040,0,0,33,0,-33
21041,1,1,203,2465,2262
21042,1,0,17,0,-17
21043,1,1,230,1314,1084
21044,1,1,724,1326,602
21045,1,1,277,1614,1337
21046,1,1,115,1261,1146
21047,1,1,781,1531,750
21048,0,0,80,0,-80
21049,1,0,17,0,-17
21050,0,0,100,0,-100
21051,1,1,345,1250,905
21052,1,1,50,1271,1221
21053,1,0,49,0,-49
21054,0,0,15,0,-15
21055,1,0,43,0,-43
21056,1,1,112,1352,1240
21057,0,0,91,0,-91
21058,0,0,23,0,-23
21059,0,0,26,0,-26
21060,1,1,31,1380,1349
21061,0,0,10,0,-10
21062,1,0,11,0,-11
21063,1,0,3,0,-3
21064,1,1,298,1222,924
21065,1,1,580,1896,1316
21066,1,0,10,0,-10
21067,0,0,17,0,-17
21068,0,0,48,0,-48
21069,0,0,51,0,-51
21070,0,0,15,0,-15
21071,1,0,65,0,-65
21072,1,0,8,0,-8
21073,1,0,50,0,-50
21074,0,0,12,0,-12
21075,0,0,118,0,-118
21076,1,1,372,1629,1257
21077,1,1,514,1829,1315
21078,0,0,63,0,-63
21079,1,1,133,1867,1734
21080,0,0,31,0,-31
21081,1,0,36,0,-36
21082,0,0,36,0,-36
21083,0,0,1,0,-1
21084,1,0,43,0,-43
21085,1,0,46,0,-46
21086,0,0,29,0,-29
21087,1,1,558,1290,732
21088,1,1,130,1246,1116
21089,1,0,44,0,-44
21090,0,0,12,0,-12
21091,1,0,9,0,-9
21092,0,0,3,0,-3
21093,0,0,142,0,-142
21094,1,1,357,1394,1037
21095,0,0,32,0,-32
21096,1,1,227,1243,1016
21097,1,0,74,0,-74
21098,0,0,75,0,-75
21099,0,0,51,0,-51
21100,0,0,76,0,-76
21101,0,0,32,0,-32
21102,1,1,56,1982,1926
21103,1,0,22,0,-22
21104,0,0,2,0,-2
21105,0,0,2,0,-2
21106,0,0,50,0,-50
21107,0,0,9,0,-9
21108,1,0,24,0,-24
21109,1,0,45,0,-45
21110,1,0,0,0,0
21111,1,0,80,0,-80
21112,1,0,106,0,-106
21113,1,1,180,1590,1410
21114,1,0,57,0,-57
21115,0,0,10,0,-10
21116,1,1,962,1205,243
21117,1,1,834,1259,425
21118,1,1,466,1729,1263
21119,1,0,0,0,0
21120,1,0,44,0,-44
21121,0,0,22,0,-22
21122,0,0,79,0,-79
21123,1,0,82,0,-82
21124,1,1,617,1273,656
21125,1,1,258,2602,2344
21126,1,1,657,2248,1591
21127,1,0,113,0,-113
21128,1,0,60,0,-60
21129,1,1,511,1264,753
21130,1,1,821,1787,966
21131,1,1,488,1287,799
21132,1,0,150,0,-150
21133,0,0,1,0,-1
21134,1,1,164,1264,1100
21135,0,0,12,0,-12
21136,1,0,97,0,-97
21137,0,0,9,0,-9
21138,0,0,10,0,-10
21139,1,1,2227,1322,-905
21140,1,1,94,1467,1373
21141,0,0,36,0,-36
21142,1,1,103,1335,1232
21143,0,0,155,0,-155
21144,0,0,7,0,-7
21145,0,0,54,0,-54
21146,1,1,798,1363,565
21147,0,0,3,0,-3
21148,1,1,92,2237,2145
21149,0,0,7,0,-7
21150,1,1,735,1834,1099
21151,0,0,58,0,-58
21152,1,0,144,0,-144
21153,0,0,86,0,-86
21154,1,1,318,1284,966
21155,1,1,105,1362,1257
21156,0,0,36,0,-36
21157,1,0,64,0,-64
21158,1,0,109,0,-109
21159,1,1,607,1238,631
21160,1,0,10,0,-10
21161,1,1,1113,1297,184
21162,1,0,17,0,-17
21163,0,0,1,0,-1
21164,1,0,33,0,-33
21165,0,0,1,0,-1
21166,0,0,92,0,-92
21167,0,0,0,0,0
21168,0,0,32,0,-32
21169,0,0,59,0,-59
21170,1,1,610,2290,1680
21171,1,1,339,1301,962
21172,0,0,5,0,-5
21173,0,0,5,0,-5
21174,1,0,32,0,-32
21175,1,0,27,0,-27
21176,0,0,71,0,-71
21177,0,0,23,0,-23
21178,1,0,130,0,-130
21179,0,0,34,0,-34
21180,1,0,23,0,-23
21181,1,0,20,0,-20
21182,0,0,99,0,-99
21183,0,0,9,0,-9
21184,1,0,56,0,-56
21185,0,0,5,0,-5
21186,1,1,403,1409,1006
21187,1,0,65,0,-65
21188,1,0,18,0,-18
21189,0,0,19,0,-19
21190,1,0,176,0,-176
21191,1,1,57,1279,1222
21192,1,1,92,1365,1273
21193,1,1,927,1635,708
21194,1,0,60,0,-60
21195,1,0,20,0,-20
21196,1,0,98,0,-98
21197,1,1,127,1336,1209
21198,0,0,17,0,-17
21199,0,0,33,0,-33
21200,1,1,355,1241,886
21201,0,0,5,0,-5
21202,0,0,15,0,-15
21203,0,0,41,0,-41
21204,1,1,743,2345,1602
21205,1,0,0,0,0
21206,1,0,119,0,-119
21207,0,0,61,0,-61
21208,0,0,11,0,-11
21209,1,1,642,1315,673
21210,0,0,75,0,-75
21211,1,0,57,0,-57
21212,1,1,87,1368,1281
21213,1,1,701,1733,1032
21214,0,0,7,0,-7
21215,1,1,1603,1719,116
21216,1,0,65,0,-65
21217,1,0,60,0,-60
21218,0,0,179,0,-179
21219,0,0,53,0,-53
21220,1,0,46,0,-46
21221,0,0,145,0,-145
21222,1,0,8,0,-8
21223,1,1,66,1573,1507
21224,1,1,1043,1258,215
21225,1,0,10,0,-10
21226,0,0,97,0,-97
21227,1,1,402,1342,940
21228,1,0,41,0,-41
21229,0,0,2,0,-2
21230,1,1,331,1410,1079
21231,1,0,65,0,-65
21232,0,0,48,0,-48
21233,1,0,75,0,-75
21234,1,0,16,0,-16
21235,0,0,24,0,-24
21236,0,0,17,0,-17
21237,1,1,114,1265,1151
21238,1,1,242,2066,1824
21239,1,0,5,0,-5
21240,0,0,18,0,-18
21241,1,0,162,0,-162
21242,0,0,46,0,-46
21243,1,0,14,0,-14
21244,1,0,46,0,-46
21245,1,1,913,1575,662
21246,1,1,231,1263,1032
21247,1,0,1,0,-1
21248,1,0,56,0,-56
21249,1,0,21,0,-21
21250,0,0,57,0,-57
21251,1,0,25,0,-25
21252,1,1,2678,2265,-413
21253,1,0,98,0,-98
21254,0,0,352,0,-352
21255,0,0,110,0,-110
21256,1,0,2,0,-2
21257,0,0,9,0,-9
21258,1,1,832,2409,1577
21259,1,1,779,2062,1283
21260,1,0,123,0,-123
21261,1,1,33,1337,1304
21262,0,0,16,0,-16
21263,1,1,1213,1430,217
21264,1,0,38,0,-38
21265,1,1,1127,1530,403
21266,1,0,41,0,-41
21267,1,1,329,1860,1531
21268,1,0,82,0,-82
21269,1,1,30,1223,1193
21270,1,1,302,1658,1356
21271,1,1,665,1726,1061
21272,1,0,21,0,-21
21273,0,0,88,0,-88
21274,0,0,41,0,-41
21275,0,0,13,0,-13
21276,1,0,160,0,-160
21277,1,0,6,0,-6
21278,1,1,676,1516,840
21279,1,0,14,0,-14
21280,0,0,18,0,-18
21281,1,1,1187,1288,101
21282,1,0,12,0,-12
21283,0,0,0,0,0
21284,1,0,34,0,-34
21285,1,1,219,2025,1806
21286,1,0,50,0,-50
21287,0,0,3,0,-3
21288,1,1,427,1766,1339
21289,1,0,75,0,-75
21290,1,0,46,0,-46
21291,1,0,22,0,-22
21292,1,1,1763,1529,-234
21293,1,0,6,0,-6
21294,1,0,69,0,-69
21295,1,0,66,0,-66
21296,0,0,225,0,-225
21297,1,1,221,2853,2632
21298,1,1,263,1252,989
21299,1,0,96,0,-96
21300,1,0,73,0,-73
21301,1,0,19,0,-19
21302,0,0,170,0,-170
21303,1,0,11,0,-11
21304,1,0,23,0,-23
21305,1,1,34,1284,1250
21306,1,1,1053,1729,676
21307,1,1,170,1759,1589
21308,1,1,521,1516,995
21309,1,1,250,1276,1026
21310,1,1,1353,1620,267
21311,1,1,118,1505,1387
21312,1,0,90,0,-90
21313,0,0,52,0,-52
21314,0,0,52,0,-52
21315,1,1,246,1319,1073
21316,0,0,28,0,-28
21317,1,0,81,0,-81
21318,1,0,6,0,-6
21319,0,0,6,0,-6
21320,0,0,100,0,-100
21321,0,0,9,0,-9
21322,1,1,1750,1249,-501
21323,0,0,3,0,-3
21324,1,1,166,1301,1135
21325,1,0,79,0,-79
21326,1,1,101,2142,2041
21327,1,0,0,0,0
21328,1,1,239,1792,1553
21329,1,1,203,1571,1368
21330,1,1,969,1233,264
21331,0,0,4,0,-4
21332,1,0,55,0,-55
21333,1,1,268,1783,1515
21334,0,0,31,0,-31
21335,0,0,4,0,-4
21336,0,0,79,0,-79
21337,0,0,70,0,-70
21338,1,1,638,1467,829
21339,0,0,16,0,-16
21340,1,0,26,0,-26
21341,1,0,42,0,-42
21342,0,0,15,0,-15
21343,1,0,44,0,-44
21344,0,0,149,0,-149
21345,1,0,13,0,-13
21346,1,1,161,1560,1399
21347,1,0,7,0,-7
21348,1,1,324,1213,889
21349,0,0,43,0,-43
21350,0,0,21,0,-21
21351,1,0,99,0,-99
21352,1,1,108,1393,1285
21353,1,0,29,0,-29
21354,1,0,77,0,-77
21355,1,1,199,1651,1452
21356,0,0,68,0,-68
21357,1,1,745,1227,482
21358,0,0,222,0,-222
21359,0,0,11,0,-11
21360,1,0,24,0,-24
21361,1,1,537,1718,1181
21362,0,0,33,0,-33
21363,0,0,125,0,-125
21364,1,1,231,1591,1360
21365,0,0,81,0,-81
21366,0,0,129,0,-129
21367,1,1,229,1518,1289
21368,0,0,139,0,-139
21369,1,0,86,0,-86
21370,1,1,182,1454,1272
21371,0,0,175,0,-175
21372,1,1,808,1308,500
21373,1,0,6,0,-6
21374,1,1,466,1336,870
21375,0,0,49,0,-49
21376,0,0,66,0,-66
21377,0,0,154,0,-154
21378,0,0,14,0,-14
21379,0,0,33,0,-33
21380,1,1,52,1429,1377
21381,1,0,22,0,-22
21382,1,1,570,1253,683
21383,0,0,9,0,-9
21384,1,0,30,0,-30
21385,1,1,342,1437,1095
21386,1,0,18,0,-18
21387,0,0,6,0,-6
21388,0,0,42,0,-42
21389,0,0,212,0,-212
21390,1,0,43,0,-43
21391,0,0,47,0,-47
21392,0,0,17,0,-17
21393,1,0,1,0,-1
21394,0,0,148,0,-148
21395,0,0,27,0,-27
21396,1,0,25,0,-25
21397,0,0,89,0,-89
21398,0,0,18,0,-18
21399,0,0,30,0,-30
21400,1,0,7,0,-7
21401,0,0,0,0,0
21402,0,0,12,0,-12
21403,1,0,58,0,-58
21404,0,0,8,0,-8
21405,1,0,29,0,-29
21406,0,0,71,0,-71
21407,1,1,350,1276,926
21408,1,1,384,1228,844
21409,1,0,21,0,-21
21410,1,1,75,1263,1188
21411,0,0,36,0,-36
21412,0,0,3,0,-3
21413,1,1,805,1411,606
21414,0,0,5,0,-5
21415,0,0,57,0,-57
21416,0,0,93,0,-93
21417,1,0,31,0,-31
21418,0,0,9,0,-9
21419,1,0,54,0,-54
21420,1,1,197,1759,1562
21421,1,1,1711,1433,-278
21422,1,1,1252,1230,-22
21423,0,0,263,0,-263
21424,1,1,1299,2323,1024
21425,1,1,271,1221,950
21426,1,1,198,1628,1430
21427,0,0,32,0,-32
21428,1,1,204,1456,1252
21429,0,0,43,0,-43
21430,0,0,46,0,-46
21431,1,0,73,0,-73
21432,1,0,52,0,-52
21433,1,0,118,0,-118
21434,1,1,227,2625,2398
21435,1,0,42,0,-42
21436,0,0,66,0,-66
21437,0,0,38,0,-38
21438,0,0,48,0,-48
21439,1,1,174,1262,1088
21440,1,0,13,0,-13
21441,1,0,54,0,-54
21442,1,1,124,1598,1474
21443,1,1,350,1269,919
21444,0,0,13,0,-13
21445,1,0,21,0,-21
21446,0,0,5,0,-5
21447,1,0,27,0,-27
21448,0,0,16,0,-16
21449,1,0,1,0,-1
21450,0,0,0,0,0
21451,1,0,30,0,-30
21452,1,0,171,0,-171
21453,0,0,26,0,-26
21454,0,0,50,0,-50
21455,1,1,145,1383,1238
21456,1,0,172,0,-172
21457,1,0,8,0,-8
21458,1,1,907,1221,314
21459,1,0,177,0,-177
21460,0,0,147,0,-147
21461,1,0,9,0,-9
21462,0,0,43,0,-43
21463,1,0,212,0,-212
21464,0,0,9,0,-9
21465,1,0,3,0,-3
21466,1,0,37,0,-37
21467,1,1,330,1895,1565
21468,1,1,160,1450,1290
21469,1,1,439,1667,1228
21470,1,1,308,2007,1699
21471,0,0,5,0,-5
21472,1,0,20,0,-20
21473,1,1,484,1414,930
21474,1,1,253,1460,1207
21475,0,0,11,0,-11
21476,1,0,37,0,-37
21477,0,0,28,0,-28
21478,0,0,87,0,-87
21479,1,1,716,1256,540
21480,1,0,15,0,-15
21481,0,0,14,0,-14
21482,1,1,433,3874,3441
21483,1,0,23,0,-23
21484,1,1,1240,1323,83
21485,1,0,79,0,-79
21486,1,0,42,0,-42
21487,1,0,33,0,-33
21488,1,0,1,0,-1
21489,1,0,20,0,-20
21490,0,0,44,0,-44
21491,1,0,49,0,-49
21492,1,0,123,0,-123
21493,1,1,609,1602,993
21494,1,1,147,1570,1423
21495,1,1,718,1293,575
21496,1,1,51,1374,1323
21497,0,0,67,0,-67
21498,1,1,238,1329,1091
21499,1,0,24,0,-24
21500,0,0,25,0,-25
21501,1,1,115,3288,3173
21502,0,0,148,0,-148
21503,1,0,186,0,-186
21504,1,0,116,0,-116
21505,1,1,845,1338,493
21506,1,0,9,0,-9
21507,0,0,59,0,-59
21508,1,0,58,0,-58
21509,1,0,36,0,-36
21510,1,1,189,1201,1012
21511,1,1,687,1694,1007
21512,1,0,41,0,-41
21513,0,0,0,0,0
21514,0,0,87,0,-87
21515,0,0,4,0,-4
21516,0,0,18,0,-18
21517,0,0,1,0,-1
21518,1,1,103,1639,1536
21519,0,0,20,0,-20
21520,1,0,32,0,-32
21521,1,1,473,1698,1225
21522,1,1,640,1388,748
21523,1,1,1215,1333,118
21524,0,0,21,0,-21
21525,1,0,61,0,-61
21526,1,1,149,2347,2198
21527,1,0,103,0,-103
21528,1,1,324,1228,904
21529,0,0,44,0,-44
21530,1,1,49,1991,1942
21531,0,0,74,0,-74
21532,0,0,2,0,-2
21533,1,1,378,1297,919
21534,0,0,100,0,-100
21535,0,0,119,0,-119
21536,0,0,4,0,-4
21537,0,0,107,0,-107
21538,1,0,7,0,-7
21539,0,0,4,0,-4
21540,1,0,40,0,-40
21541,1,1,1165,1568,403
21542,0,0,0,0,0
21543,1,0,68,0,-68
21544,1,0,39,0,-39
21545,1,1,72,1749,1677
21546,0,0,24,0,-24
21547,1,0,43,0,-43
21548,0,0,5,0,-5
21549,1,0,144,0,-144
21550,0,0,45,0,-45
21551,1,1,107,1451,1344
21552,1,0,2,0,-2
21553,1,0,2,0,-2
21554,0,0,1,0,-1
21555,0,0,114,0,-114
21556,0,0,3,0,-3
21557,1,1,175,1578,1403
21558,1,0,36,0,-36
21559,1,1,973,1251,278
21560,1,0,32,0,-32
21561,0,0,107,0,-107
21562,1,0,6,0,-6
21563,0,0,204,0,-204
21564,1,0,16,0,-16
21565,0,0,85,0,-85
21566,1,0,35,0,-35
21567,1,0,42,0,-42
21568,1,1,952,1242,290
21569,0,0,0,0,0
21570,1,0,30,0,-30
21571,0,0,3,0,-3
21572,1,0,42,0,-42
21573,0,0,10,0,-10
21574,0,0,7,0,-7
21575,1,0,126,0,-126
21576,1,0,42,0,-42
21577,1,1,31,1475,1444
21578,0,0,66,0,-66
21579,0,0,166,0,-166
21580,1,1,156,1592,1436
21581,1,0,104,0,-104
21582,0,0,9,0,-9
21583,1,1,562,1375,813
21584,1,0,6,0,-6
21585,0,0,64,0,-64
21586,0,0,74,0,-74
21587,0,0,55,0,-55
21588,0,0,248,0,-248
21589,1,0,8,0,-8
21590,1,1,727,1433,706
21591,0,0,59,0,-59
21592,1,0,4,0,-4
21593,1,1,426,1234,808
21594,0,0,48,0,-48
21595,1,1,243,3749,3506
21596,0,0,77,0,-77
21597,1,0,22,0,-22
21598,1,0,18,0,-18
21599,1,1,655,1341,686
21600,0,0,140,0,-140
21601,0,0,145,0,-145
21602,1,1,284,2720,2436
21603,0,0,80,0,-80
21604,1,1,118,1652,1534
21605,1,0,11,0,-11
21606,0,0,17,0,-17
21607,0,0,111,0,-111
21608,1,1,115,2193,2078
21609,1,1,455,1970,1515
21610,1,0,37,0,-37
21611,0,0,43,0,-43
21612,1,1,953,1243,290
21613,0,0,47,0,-47
21614,1,0,26,0,-26
21615,0,0,29,0,-29
21616,1,0,56,0,-56
21617,0,0,89,0,-89
21618,1,1,65,1471,1406
21619,1,0,105,0,-105
21620,0,0,43,0,-43
21621,1,1,65,1464,1399
21622,0,0,3,0,-3
21623,1,1,1099,1806,707
21624,1,1,851,1215,364
21625,0,0,80,0,-80
21626,0,0,129,0,-129
21627,1,0,44,0,-44
21628,0,0,308,0,-308
21629,0,0,33,0,-33
21630,1,1,227,1910,1683
21631,1,0,68,0,-68
21632,0,0,16,0,-16
21633,0,0,63,0,-63
21634,0,0,53,0,-53
21635,1,0,2,0,-2
21636,1,0,33,0,-33
21637,1,0,31,0,-31
21638,1,1,128,1306,1178
21639,1,1,1010,1378,368
21640,1,0,107,0,-107
21641,1,0,36,0,-36
21642,1,0,62,0,-62
21643,1,0,12,0,-12
21644,1,1,66,1895,1829
21645,0,0,64,0,-64
21646,1,0,99,0,-99
21647,0,0,25,0,-25
21648,1,1,279,1220,941
21649,1,1,164,1263,1099
21650,1,0,76,0,-76
21651,1,0,13,0,-13
21652,0,0,1,0,-1
21653,1,1,37,1273,1236
21654,1,0,129,0,-129
21655,1,0,17,0,-17
21656,1,1,155,1285,1130
21657,1,1,564,1511,947
21658,0,0,64,0,-64
21659,1,0,35,0,-35
21660,1,0,5,0,-5
21661,1,0,48,0,-48
21662,0,0,28,0,-28
21663,1,1,572,1458,886
21664,0,0,54,0,-54
21665,0,0,25,0,-25
21666,1,1,387,2289,1902
21667,0,0,28,0,-28
21668,0,0,38,0,-38
21669,0,0,26,0,-26
21670,0,0,170,0,-170
21671,1,1,493,1257,764
21672,0,0,16,0,-16
21673,1,1,703,1467,764
21674,1,0,41,0,-41
21675,1,0,42,0,-42
21676,1,0,65,0,-65
21677,0,0,64,0,-64
21678,0,0,29,0,-29
21679,0,0,276,0,-276
21680,0,0,26,0,-26
21681,1,0,4,0,-4
21682,0,0,7,0,-7
21683,1,0,8,0,-8
21684,0,0,12,0,-12
21685,1,1,296,1241,945
21686,0,0,7,0,-7
21687,0,0,35,0,-35
21688,1,1,157,1693,1536
21689,0,0,11,0,-11
21690,1,0,78,0,-78
21691,0,0,48,0,-48
21692,1,1,619,1260,641
21693,1,0,16,0,-16
21694,1,0,31,0,-31
21695,0,0,15,0,-15
21696,1,1,119,1304,1185
21697,1,1,982,1542,560
21698,1,1,666,2379,1713
21699,1,0,122,0,-122
21700,1,1,411,1243,832
21701,0,0,74,0,-74
21702,0,0,141,0,-141
21703,0,0,31,0,-31
21704,0,0,17,0,-17
21705,1,0,18,0,-18
21706,0,0,27,0,-27
21707,1,0,85,0,-85
21708,1,0,119,0,-119
21709,0,0,88,0,-88
21710,1,1,689,3580,2891
21711,0,0,24,0,-24
21712,0,0,28,0,-28
21713,0,0,56,0,-56
21714,1,0,46,0,-46
21715,1,1,381,1300,919
21716,0,0,30,0,-30
21717,1,1,31,1208,1177
21718,0,0,23,0,-23
21719,1,1,298,1374,1076
21720,0,0,47,0,-47
21721,1,0,77,0,-77
21722,0,0,104,0,-104
21723,1,0,40,0,-40
21724,1,1,111,2008,1897
21725,1,0,22,0,-22
21726,1,0,103,0,-103
21727,0,0,49,0,-49
21728,0,0,13,0,-13
21729,0,0,6,0,-6
21730,1,0,0,0,0
21731,0,0,17,0,-17
21732,1,1,686,1213,527
21733,1,0,10,0,-10
21734,0,0,113,0,-113
21735,0,0,151,0,-151
21736,0,0,1,0,-1
21737,0,0,68,0,-68
21738,1,1,427,1620,1193
21739,0,0,7,0,-7
21740,1,1,210,1531,1321
21741,0,0,42,0,-42
21742,0,0,172,0,-172
21743,1,1,446,1485,1039
21744,1,1,128,1395,1267
21745,1,1,518,1235,717
21746,1,1,70,1551,1481
21747,1,1,534,1293,759
21748,1,0,202,0,-202
21749,1,1,170,1476,1306
21750,0,0,17,0,-17
21751,1,0,11,0,-11
21752,1,0,80,0,-80
21753,0,0,26,0,-26
21754,0,0,117,0,-117
21755,1,1,181,1667,1486
21756,1,1,120,1542,1422
21757,1,0,13,0,-13
21758,0,0,19,0,-19
21759,0,0,32,0,-32
21760,0,0,41,0,-41
21761,0,0,37,0,-37
21762,0,0,91,0,-91
21763,1,0,40,0,-40
21764,1,1,1644,1417,-227
21765,0,0,22,0,-22
21766,0,0,13,0,-13
21767,1,1,249,1572,1323
21768,1,1,980,1318,338
21769,0,0,1,0,-1
21770,0,0,54,0,-54
21771,1,0,24,0,-24
21772,1,0,39,0,-39
21773,0,0,6,0,-6
21774,0,0,55,0,-55
21775,0,0,69,0,-69
21776,0,0,66,0,-66
21777,1,1,189,1276,1087
21778,1,0,27,0,-27
21779,1,0,45,0,-45
21780,1,0,51,0,-51
21781,1,1,799,1813,1014
21782,0,0,6,0,-6
21783,0,0,1,0,-1
21784,1,0,91,0,-91
21785,1,0,3,0,-3
21786,0,0,157,0,-157
21787,1,1,1270,1417,147
21788,1,0,21,0,-21
21789,1,0,4,0,-4
21790,1,0,45,0,-45
21791,1,0,30,0,-30
21792,1,0,124,0,-124
21793,1,1,224,1223,999
21794,0,0,224,0,-224
21795,0,0,14,0,-14
21796,0,0,12,0,-12
21797,0,0,51,0,-51
21798,1,1,716,1335,619
21799,1,1,318,1294,976
21800,0,0,61,0,-61
21801,0,0,23,0,-23
21802,0,0,86,0,-86
21803,1,1,173,1481,1308
21804,0,0,111,0,-111
21805,0,0,139,0,-139
21806,0,0,4,0,-4
21807,1,0,39,0,-39
21808,1,0,119,0,-119
21809,0,0,112,0,-112
21810,1,1,696,1934,1238
21811,0,0,87,0,-87
21812,1,1,245,1218,973
21813,1,0,18,0,-18
21814,1,0,2,0,-2
21815,1,1,1028,1340,312
21816,1,1,281,1941,1660
21817,1,1,399,1218,819
21818,0,0,3,0,-3
21819,1,0,3,0,-3
21820,1,1,464,1863,1399
21821,1,1,1375,1509,134
21822,0,0,32,0,-32
21823,1,0,63,0,-63
21824,1,0,15,0,-15
21825,1,0,2,0,-2
21826,0,0,13,0,-13
21827,0,0,11,0,-11
21828,0,0,25,0,-25
21829,1,0,182,0,-182
21830,1,0,4,0,-4
21831,1,1,346,1217,871
21832,0,0,119,0,-119
21833,0,0,46,0,-46
21834,1,0,13,0,-13
21835,0,0,23,0,-23
21836,1,1,144,1881,1737
21837,0,0,127,0,-127
21838,0,0,23,0,-23
21839,0,0,29,0,-29
21840,0,0,3,0,-3
21841,0,0,0,0,0
21842,0,0,57,0,-57
21843,0,0,3,0,-3
21844,1,1,455,1616,1161
21845,1,1,838,1369,531
21846,0,0,1,0,-1
21847,1,1,188,1441,1253
21848,1,0,12,0,-12
21849,1,0,160,0,-160
21850,1,1,620,1222,602
21851,1,1,198,2056,1858
21852,1,1,1253,1464,211
21853,0,0,7,0,-7
21854,0,0,83,0,-83
21855,1,1,499,1354,855
21856,0,0,111,0,-111
21857,1,0,3,0,-3
21858,0,0,12,0,-12
21859,1,0,0,0,0
21860,0,0,3,0,-3
21861,1,1,1382,1537,155
21862,1,0,60,0,-60
21863,0,0,11,0,-11
21864,0,0,37,0,-37
21865,1,1,449,1490,1041
21866,1,0,5,0,-5
21867,1,1,285,1324,1039
21868,1,0,38,0,-38
21869,1,0,87,0,-87
21870,0,0,18,0,-18
21871,1,0,35,0,-35
21872,0,0,5,0,-5
21873,0,0,30,0,-30
21874,1,0,49,0,-49
21875,1,0,67,0,-67
21876,0,0,97,0,-97
21877,0,0,13,0,-13
21878,1,0,43,0,-43
21879,0,0,44,0,-44
21880,1,0,192,0,-192
21881,1,0,29,0,-29
21882,0,0,31,0,-31
21883,1,0,6,0,-6
21884,1,0,114,0,-114
21885,1,1,198,1572,1374
21886,1,0,36,0,-36
21887,1,1,186,3879,3693
21888,1,0,35,0,-35
21889,0,0,39,0,-39
21890,1,0,48,0,-48
21891,1,1,1974,2069,95
21892,1,1,481,1663,1182
21893,1,0,29,0,-29
21894,0,0,9,0,-9
21895,1,0,21,0,-21
21896,1,0,33,0,-33
21897,1,0,58,0,-58
21898,1,0,33,0,-33
21899,1,0,50,0,-50
21900,1,1,2160,1431,-729
21901,0,0,28,0,-28
21902,0,0,156,0,-156
21903,1,1,328,1561,1233
21904,1,0,80,0,-80
21905,1,0,57,0,-57
21906,1,1,142,1739,1597
21907,0,0,97,0,-97
21908,1,1,193,1577,1384
21909,1,1,153,1259,1106
21910,0,0,31,0,-31
21911,1,1,997,2345,1348
21912,0,0,9,0,-9
21913,0,0,0,0,0
21914,0,0,88,0,-88
21915,0,0,80,0,-80
21916,1,0,2,0,-2
21917,1,0,36,0,-36
21918,0,0,45,0,-45
21919,0,0,96,0,-96
21920,1,1,174,1845,1671
21921,1,0,32,0,-32
21922,1,1,1468,1271,-197
21923,1,1,78,1853,1775
21924,1,0,9,0,-9
21925,1,1,269,1659,1390
21926,1,0,45,0,-45
21927,0,0,108,0,-108
21928,1,1,313,1738,1425
21929,1,1,885,1221,336
21930,0,0,8,0,-8
21931,0,0,15,0,-15
21932,0,0,8,0,-8
21933,1,0,39,0,-39
21934,0,0,54,0,-54
21935,0,0,28,0,-28
21936,0,0,43,0,-43
21937,0,0,8,0,-8
21938,0,0,19,0,-19
21939,1,1,596,1510,914
21940,1,0,41,0,-41
21941,1,1,388,1223,835
21942,0,0,93,0,-93
21943,0,0,34,0,-34
21944,0,0,37,0,-37
21945,1,1,453,1594,1141
21946,1,0,62,0,-62
21947,1,1,240,1476,1236
21948,1,0,24,0,-24
21949,1,1,124,1418,1294
21950,0,0,24,0,-24
21951,0,0,58,0,-58
21952,0,0,39,0,-39
21953,0,0,72,0,-72
21954,0,0,20,0,-20
21955,1,0,53,0,-53
21956,1,0,7,0,-7
21957,1,0,128,0,-128
21958,0,0,39,0,-39
21959,1,1,69,1595,1526
21960,1,0,85,0,-85
21961,1,1,526,1339,813
21962,1,1,1800,1240,-560
21963,0,0,79,0,-79
21964,0,0,167,0,-167
21965,1,1,881,1446,565
21966,1,1,554,1222,668
21967,0,0,64,0,-64
21968,1,0,97,0,-97
21969,1,1,471,1247,776
21970,1,1,75,1736,1661
21971,0,0,121,0,-121
21972,1,0,158,0,-158
21973,0,0,3,0,-3
21974,1,1,277,2450,2173
21975,1,0,19,0,-19
21976,1,0,30,0,-30
21977,1,0,44,0,-44
21978,0,0,66,0,-66
21979,0,0,0,0,0
21980,0,0,29,0,-29
21981,1,0,9,0,-9
21982,1,1,1405,1225,-180
21983,1,0,30,0,-30
21984,1,0,85,0,-85
21985,1,0,24,0,-24
21986,1,1,303,1783,1480
21987,1,0,3,0,-3
21988,1,1,405,1947,1542
21989,1,1,620,3939,3319
21990,0,0,3,0,-3
21991,0,0,16,0,-16
21992,1,0,46,0,-46
21993,0,0,63,0,-63
21994,0,0,53,0,-53
21995,0,0,1,0,-1
21996,0,0,8,0,-8
21997,0,0,1,0,-1
21998,1,1,521,2110,1589
21999,0,0,12,0,-12
22000,1,1,558,1630,1072
22001,0,0,10,0,-10
22002,1,0,21,0,-21
22003,0,0,33,0,-33
22004,0,0,100,0,-100
22005,1,0,63,0,-63
22006,1,1,495,1516,1021
22007,0,0,20,0,-20
22008,0,0,29,0,-29
22009,0,0,24,0,-24
22010,1,0,95,0,-95
22011,0,0,51,0,-51
22012,1,1,343,2163,1820
22013,1,0,125,0,-125
22014,0,0,55,0,-55
22015,1,1,1658,1518,-140
22016,1,0,1,0,-1
22017,1,1,686,1510,824
22018,1,0,18,0,-18
22019,0,0,30,0,-30
22020,1,0,16,0,-16
22021,1,1,664,1249,585
22022,0,0,17,0,-17
22023,1,1,789,1258,469
22024,0,0,35,0,-35
22025,1,1,805,1443,638
22026,0,0,64,0,-64
22027,0,0,0,0,0
22028,0,0,285,0,-285
22029,0,0,60,0,-60
22030,0,0,45,0,-45
22031,1,1,317,1603,1286
22032,0,0,45,0,-45
22033,0,0,13,0,-13
22034,0,0,105,0,-105
22035,1,1,2752,1525,-1227
22036,1,0,7,0,-7
22037,0,0,99,0,-99
22038,0,0,97,0,-97
22039,1,1,267,1202,935
22040,1,1,390,2358,1968
22041,0,0,42,0,-42
22042,1,0,22,0,-22
22043,1,1,474,1526,1052
22044,1,1,57,2403,2346
22045,1,0,25,0,-25
22046,1,1,958,1358,400
22047,0,0,44,0,-44
22048,0,0,101,0,-101
22049,1,0,66,0,-66
22050,1,0,32,0,-32
22051,0,0,8,0,-8
22052,0,0,10,0,-10
22053,1,0,18,0,-18
22054,1,1,750,1267,517
22055,1,0,37,0,-37
22056,1,0,104,0,-104
22057,1,1,430,1369,939
22058,0,0,54,0,-54
22059,1,0,131,0,-131
22060,1,0,1,0,-1
22061,0,0,76,0,-76
22062,1,0,87,0,-87
22063,0,0,20,0,-20
22064,1,1,84,1347,1263
22065,1,1,320,1649,1329
22066,1,1,442,1715,1273
22067,1,0,71,0,-71
22068,1,1,109,1527,1418
22069,0,0,50,0,-50
22070,0,0,22,0,-22
22071,1,1,327,1426,1099
22072,0,0,35,0,-35
22073,1,0,37,0,-37
22074,0,0,7,0,-7
22075,0,0,11,0,-11
22076,1,1,1177,1228,51
22077,1,1,392,1244,852
22078,1,0,207,0,-207
22079,1,1,138,1446,1308
22080,1,1,256,1697,1441
22081,0,0,20,0,-20
22082,1,1,281,1459,1178
22083,1,0,36,0,-36
22084,1,0,8,0,-8
22085,0,0,7,0,-7
22086,1,0,23,0,-23
22087,1,1,306,1285,979
22088,1,1,179,1577,1398
22089,1,0,39,0,-39
22090,1,1,620,1425,805
22091,0,0,89,0,-89
22092,1,1,713,1282,569
22093,1,0,137,0,-137
22094,0,0,19,0,-19
22095,1,0,136,0,-136
22096,0,0,5,0,-5
22097,0,0,78,0,-78
22098,1,1,188,1206,1018
22099,1,0,9,0,-9
22100,1,0,8,0,-8
22101,1,1,894,2105,1211
22102,0,0,12,0,-12
22103,0,0,17,0,-17
22104,1,0,114,0,-114
22105,1,0,34,0,-34
22106,1,1,29,1523,1494
22107,0,0,42,0,-42
22108,1,0,30,0,-30
22109,1,1,408,1426,1018
22110,0,0,118,0,-118
22111,1,1,295,1719,1424
22112,1,0,29,0,-29
22113,1,1,322,2109,1787
22114,1,0,32,0,-32
22115,1,0,76,0,-76
22116,0,0,13,0,-13
22117,1,0,5,0,-5
22118,0,0,74,0,-74
22119,1,0,96,0,-96
22120,1,1,466,1250,784
22121,0,0,16,0,-16
22122,0,0,50,0,-50
22123,1,0,30,0,-30
22124,0,0,18,0,-18
22125,1,0,34,0,-34
22126,1,0,31,0,-31
22127,0,0,4,0,-4
22128,0,0,167,0,-167
22129,0,0,2,0,-2
22130,0,0,5,0,-5
22131,1,0,22,0,-22
22132,1,1,872,1270,398
22133,0,0,0,0,0
22134,1,0,78,0,-78
22135,1,0,10,0,-10
22136,1,0,20,0,-20
22137,1,0,5,0,-5
22138,0,0,36,0,-36
22139,0,0,26,0,-26
22140,0,0,1,0,-1
22141,1,0,17,0,-17
22142,0,0,105,0,-105
22143,1,1,735,1247,512
22144,1,0,25,0,-25
22145,1,1,1106,1704,598
22146,1,1,295,1291,996
22147,1,1,944,1355,411
22148,1,1,264,1399,1135
22149,1,0,21,0,-21
22150,1,1,366,1302,936
22151,1,1,86,1384,1298
22152,1,0,17,0,-17
22153,1,1,349,1416,1067
22154,0,0,12,0,-12
22155,0,0,18,0,-18
22156,1,0,99,0,-99
22157,1,0,78,0,-78
22158,1,0,8,0,-8
22159,1,0,49,0,-49
22160,1,1,717,2799,2082
22161,0,0,0,0,0
22162,1,0,34,0,-34
22163,0,0,20,0,-20
22164,1,1,118,1585,1467
22165,1,0,9,0,-9
22166,1,1,129,2032,1903
22167,1,1,626,1622,996
22168,1,1,173,4188,4015
22169,0,0,82,0,-82
22170,0,0,53,0,-53
22171,1,0,8,0,-8
22172,1,0,17,0,-17
22173,1,1,1164,1264,100
22174,1,1,289,1547,1258
22175,1,1,160,2175,2015
22176,1,1,164,1274,1110
22177,1,1,139,1331,1192
22178,0,0,73,0,-73
22179,1,1,663,9967,9304
22180,1,1,1546,1364,-182
22181,0,0,47,0,-47
22182,1,0,4,0,-4
22183,1,1,137,1613,1476
22184,1,0,53,0,-53
22185,1,0,3,0,-3
22186,1,1,359,1285,926
22187,0,0,213,0,-213
22188,0,0,41,0,-41
22189,0,0,24,0,-24
22190,1,1,496,1435,939
22191,0,0,16,0,-16
22192,1,0,5,0,-5
22193,1,1,377,1243,866
22194,1,1,616,1422,806
22195,0,0,42,0,-42
22196,0,0,19,0,-19
22197,0,0,49,0,-49
22198,1,1,988,1355,367
22199,1,1,1307,1341,34
22200,1,1,1171,1555,384
22201,1,0,10,0,-10
22202,1,0,7,0,-7
22203,1,0,50,0,-50
22204,0,0,83,0,-83
22205,1,0,103,0,-103
22206,0,0,58,0,-58
22207,0,0,9,0,-9
22208,1,1,279,1383,1104
22209,1,1,342,1547,1205
22210,1,0,23,0,-23
22211,1,0,53,0,-53
22212,1,0,2,0,-2
22213,1,1,341,1245,904
22214,1,1,743,1272,529
22215,0,0,5,0,-5
22216,1,0,32,0,-32
22217,0,0,62,0,-62
22218,1,0,38,0,-38
22219,1,1,552,2192,1640
22220,1,0,56,0,-56
22221,1,0,56,0,-56
22222,0,0,42,0,-42
22223,1,1,373,1394,1021
22224,1,0,36,0,-36
22225,1,1,890,1535,645
22226,1,1,378,1343,965
22227,0,0,6,0,-6
22228,0,0,39,0,-39
22229,1,1,1114,1278,164
22230,1,1,290,1967,1677
22231,0,0,22,0,-22
22232,0,0,3,0,-3
22233,1,1,594,1585,991
22234,0,0,33,0,-33
22235,1,1,938,1617,679
22236,0,0,24,0,-24
22237,1,0,13,0,-13
22238,0,0,96,0,-96
22239,0,0,119,0,-119
22240,1,0,14,0,-14
22241,0,0,33,0,-33
22242,1,0,17,0,-17
22243,1,0,46,0,-46
22244,1,0,23,0,-23
22245,1,1,477,1788,1311
22246,1,0,73,0,-73
22247,1,0,46,0,-46
22248,1,0,14,0,-14
22249,0,0,78,0,-78
22250,0,0,13,0,-13
22251,0,0,12,0,-12
22252,1,0,14,0,-14
22253,1,0,23,0,-23
22254,0,0,19,0,-19
22255,1,0,76,0,-76
22256,1,1,692,2043,1351
22257,0,0,15,0,-15
22258,0,0,29,0,-29
22259,1,1,202,1269,1067
22260,0,0,2,0,-2
22261,1,0,84,0,-84
22262,1,0,14,0,-14
22263,1,0,74,0,-74
22264,1,1,429,1251,822
22265,1,1,717,1279,562
22266,0,0,34,0,-34
22267,1,0,9,0,-9
22268,1,1,664,1264,600
22269,1,1,1493,1424,-69
22270,0,0,13,0,-13
22271,1,1,277,1361,1084
22272,1,1,846,1641,795
22273,0,0,8,0,-8
22274,0,0,25,0,-25
22275,1,0,70,0,-70
22276,1,1,77,1595,1518
22277,0,0,57,0,-57
22278,1,0,8,0,-8
22279,0,0,83,0,-83
22280,1,0,4,0,-4
22281,1,0,47,0,-47
22282,1,0,5,0,-5
22283,0,0,37,0,-37
22284,0,0,41,0,-41
22285,1,1,131,1613,1482
22286,1,1,1654,1478,-176
22287,0,0,46,0,-46
22288,1,0,14,0,-14
22289,1,0,6,0,-6
22290,1,0,25,0,-25
22291,1,0,51,0,-51
22292,1,0,22,0,-22
22293,1,1,154,1393,1239
22294,0,0,172,0,-172
22295,0,0,65,0,-65
22296,1,0,52,0,-52
22297,0,0,31,0,-31
22298,1,1,881,1202,321
22299,0,0,81,0,-81
22300,1,0,32,0,-32
22301,1,1,211,1227,1016
22302,1,0,52,0,-52
22303,1,1,1088,1311,223
22304,1,1,183,1647,1464
22305,1,1,1457,1250,-207
22306,0,0,3,0,-3
22307,1,1,394,1286,892
22308,0,0,74,0,-74
22309,1,1,530,1315,785
22310,0,0,14,0,-14
22311,0,0,82,0,-82
22312,1,0,4,0,-4
22313,1,1,959,3985,3026
22314,1,1,1341,1282,-59
22315,0,0,62,0,-62
22316,0,0,19,0,-19
22317,1,0,28,0,-28
22318,0,0,31,0,-31
22319,0,0,74,0,-74
22320,0,0,19,0,-19
22321,1,0,7,0,-7
22322,0,0,158,0,-158
22323,1,1,181,1232,1051
22324,0,0,55,0,-55
22325,1,0,11,0,-11
22326,0,0,20,0,-20
22327,1,0,15,0,-15
22328,1,0,4,0,-4
22329,1,1,178,1697,1519
22330,1,1,581,1237,656
22331,1,0,28,0,-28
22332,1,1,2226,1616,-610
22333,0,0,62,0,-62
22334,1,1,17,1571,1554
22335,0,0,26,0,-26
22336,0,0,1,0,-1
22337,1,0,132,0,-132
22338,1,1,272,1497,1225
22339,1,0,54,0,-54
22340,1,0,18,0,-18
22341,1,0,13,0,-13
22342,0,0,22,0,-22
22343,1,0,26,0,-26
22344,0,0,9,0,-9
22345,1,1,2745,2085,-660
22346,1,0,39,0,-39
22347,1,1,922,1273,351
22348,1,0,51,0,-51
22349,1,0,17,0,-17
22350,1,0,5,0,-5
22351,1,0,5,0,-5
22352,0,0,4,0,-4
22353,1,1,217,1222,1005
22354,1,0,10,0,-10
22355,0,0,9,0,-9
22356,1,1,629,1717,1088
22357,0,0,55,0,-55
22358,1,1,1333,1621,288
22359,0,0,50,0,-50
22360,1,0,63,0,-63
22361,0,0,186,0,-186
22362,1,1,613,1299,686
22363,1,0,27,0,-27
22364,1,0,95,0,-95
22365,0,0,86,0,-86
22366,0,0,32,0,-32
22367,0,0,42,0,-42
22368,0,0,14,0,-14
22369,0,0,31,0,-31
22370,0,0,14,0,-14
22371,1,0,67,0,-67
22372,0,0,70,0,-70
22373,1,1,244,1494,1250
22374,1,1,286,1291,1005
22375,0,0,58,0,-58
22376,1,0,71,0,-71
22377,1,1,327,1319,992
22378,1,0,39,0,-39
22379,1,1,620,1413,793
22380,1,1,141,1285,1144
22381,0,0,45,0,-45
22382,0,0,63,0,-63
22383,1,0,73,0,-73
22384,1,1,155,1645,1490
22385,1,0,160,0,-160
22386,0,0,23,0,-23
22387,0,0,101,0,-101
22388,1,0,39,0,-39
22389,1,0,97,0,-97
22390,1,0,29,0,-29
22391,0,0,68,0,-68
22392,1,0,1,0,-1
22393,1,1,24,1453,1429
22394,0,0,8,0,-8
22395,1,0,35,0,-35
22396,0,0,53,0,-53
22397,1,1,167,1221,1054
22398,1,1,80,1275,1195
22399,1,0,72,0,-72
22400,1,1,1568,1340,-228
22401,1,0,4,0,-4
22402,0,0,25,0,-25
22403,1,0,50,0,-50
22404,0,0,77,0,-77
22405,1,1,874,1931,1057
22406,0,0,65,0,-65
22407,1,1,1584,1298,-286
22408,0,0,74,0,-74
22409,1,0,17,0,-17
22410,1,0,31,0,-31
22411,0,0,81,0,-81
22412,1,0,25,0,-25
22413,1,1,155,1217,1062
22414,1,1,591,1723,1132
22415,1,0,52,0,-52
22416,0,0,85,0,-85
22417,0,0,28,0,-28
22418,1,0,30,0,-30
22419,0,0,88,0,-88
22420,0,0,14,0,-14
22421,0,0,104,0,-104
22422,1,1,359,1371,1012
22423,1,0,9,0,-9
22424,0,0,192,0,-192
22425,1,1,323,1427,1104
22426,1,1,827,1331,504
22427,1,0,7,0,-7
22428,1,1,210,1644,1434
22429,1,0,65,0,-65
22430,1,1,633,1297,664
22431,0,0,17,0,-17
22432,1,1,1485,1337,-148
22433,1,0,7,0,-7
22434,0,0,42,0,-42
22435,0,0,33,0,-33
22436,0,0,27,0,-27
22437,1,1,1012,1407,395
22438,1,0,15,0,-15
22439,0,0,12,0,-12
22440,1,1,247,1449,1202
22441,0,0,40,0,-40
22442,1,0,69,0,-69
22443,1,0,19,0,-19
22444,0,0,60,0,-60
22445,1,1,458,1230,772
22446,1,0,5,0,-5
22447,1,0,67,0,-67
22448,0,0,114,0,-114
22449,0,0,29,0,-29
22450,1,1,298,1202,904
22451,0,0,20,0,-20
22452,1,0,22,0,-22
22453,0,0,28,0,-28
22454,0,0,43,0,-43
22455,0,0,23,0,-23
22456,0,0,12,0,-12
22457,0,0,122,0,-122
22458,1,0,145,0,-145
22459,1,0,56,0,-56
22460,1,0,53,0,-53
22461,0,0,9,0,-9
22462,1,0,96,0,-96
22463,1,0,19,0,-19
22464,0,0,16,0,-16
22465,1,0,14,0,-14
22466,0,0,112,0,-112
22467,0,0,50,0,-50
22468,0,0,103,0,-103
22469,1,1,364,1810,1446
22470,0,0,64,0,-64
22471,1,0,55,0,-55
22472,0,0,81,0,-81
22473,1,1,565,1340,775
22474,1,0,9,0,-9
22475,1,0,22,0,-22
22476,1,0,0,0,0
22477,0,0,103,0,-103
22478,1,0,11,0,-11
22479,0,0,9,0,-9
22480,1,1,39,2090,2051
22481,1,0,17,0,-17
22482,0,0,105,0,-105
22483,1,1,82,1975,1893
22484,1,0,77,0,-77
22485,0,0,66,0,-66
22486,0,0,50,0,-50
22487,0,0,2,0,-2
22488,1,0,13,0,-13
22489,1,0,62,0,-62
22490,0,0,84,0,-84
22491,0,0,3,0,-3
22492,1,1,215,1626,1411
22493,1,1,1704,2020,316
22494,1,1,245,1216,971
22495,1,1,561,2308,1747
22496,1,0,4,0,-4
22497,1,0,47,0,-47
22498,1,1,565,3180,2615
22499,0,0,92,0,-92
22500,0,0,22,0,-22
22501,0,0,67,0,-67
22502,1,0,109,0,-109
22503,1,0,50,0,-50
22504,1,1,532,1234,702
22505,1,1,579,1379,800
22506,1,0,24,0,-24
22507,1,0,114,0,-114
22508,0,0,58,0,-58
22509,1,1,231,2263,2032
22510,1,0,136,0,-136
22511,0,0,0,0,0
22512,1,1,319,1799,1480
22513,1,1,1889,1233,-656
22514,1,0,14,0,-14
22515,1,0,15,0,-15
22516,1,1,645,1271,626
22517,1,0,79,0,-79
22518,1,0,1,0,-1
22519,1,0,129,0,-129
22520,1,1,988,1412,424
22521,1,1,66,1454,1388
22522,1,0,36,0,-36
22523,1,0,1,0,-1
22524,1,0,23,0,-23
22525,0,0,2,0,-2
22526,1,0,48,0,-48
22527,0,0,20,0,-20
22528,1,1,1715,1389,-326
22529,1,0,57,0,-57
22530,0,0,6,0,-6
